k,w,tool,damage_level,read_length,subsampling_rate,mito_correct,mito_incorrect,mito_mapped,mito_unmapped,bacteria_mapped,bacteria_unmapped,numt_mapped,numt_unmapped,precision,sensitivity,specificity,f1,accuracy,TP,FP,TN,FN
10,10,giraffe,High,125,0.15,44505,93,44505,362,0,14956,9,51,0.9997978164173069,0.9898798932384342,0.9994006393180608,0.9948141359501084,0.9922635720955049,44505,9,15007,455
10,10,safari,High,125,0.15,44538,93,44538,329,0,14956,9,51,0.9997979661930096,0.9906138790035587,0.9994006393180608,0.9951847341548706,0.99281379218354,44538,9,15007,422
10,10,giraffe,High,125,0.1,29665,58,29665,231,0,10014,6,27,0.9997977823463988,0.9903518728717366,0.9994028068080024,0.9950524109014675,0.9926251843703907,29665,6,10041,289
10,10,safari,High,125,0.1,29683,58,29683,213,0,10014,6,27,0.9997979049479605,0.9909527942845697,0.9994028068080024,0.9953556997468269,0.993075173120672,29683,6,10041,271
10,10,giraffe,High,125,0.25,74262,158,74262,579,1,24985,17,91,0.9997576736672051,0.9901732023093641,0.9992826970590579,0.9949423562590853,0.9924570149760723,74262,18,25076,737
10,10,safari,High,125,0.25,74312,158,74312,529,1,24985,17,91,0.9997578366742903,0.9908398778650382,0.9992826970590579,0.9952788808603821,0.9929565504081205,74312,18,25076,687
10,10,giraffe,High,125,0.2,59407,125,59407,460,0,19910,12,73,0.9997980443965735,0.9902486998266435,0.9993998499624906,0.9950004605940826,0.9925362871466613,59407,12,19983,585
10,10,safari,High,125,0.2,59450,125,59450,417,0,19910,12,73,0.9997981904409539,0.9909654620616082,0.9993998499624906,0.9953622314865973,0.993073874504607,59450,12,19983,542
10,10,giraffe,High,125,0.35,103960,216,103960,768,3,35007,27,122,0.9997115107221848,0.9906235706662601,0.9991467334110754,0.9951467927670938,0.9927624676131133,103960,30,35129,984
10,10,safari,High,125,0.35,104019,216,104019,709,4,35006,27,122,0.9997020663142719,0.9911857752706206,0.9991182911914446,0.9954257060011292,0.9931764487555584,104019,31,35128,925
10,10,giraffe,High,125,0.3,88928,192,88928,679,1,29884,22,112,0.9997414306753156,0.9903005601398679,0.999233818581565,0.9949986013986014,0.9925386836702332,88928,23,29996,871
10,10,safari,High,125,0.3,88981,192,88981,626,1,29884,22,112,0.999741584647881,0.9908907671577635,0.999233818581565,0.9952964994994492,0.9929810212155102,88981,23,29996,818
10,10,giraffe,High,125,0.45,134068,279,134068,997,4,45251,37,148,0.9996942785346248,0.9905721716514955,0.9990977112676056,0.995112320144886,0.9927150632799363,134068,41,45399,1276
10,10,safari,High,125,0.45,134148,279,134148,917,5,45250,37,148,0.9996870109546165,0.9911632580683296,0.9990757042253521,0.9954068874427716,0.9931520488538809,134148,42,45398,1196
10,10,giraffe,High,125,0.4,118819,245,118819,879,4,40038,32,133,0.9996971099238569,0.9906288820523081,0.9991046335215261,0.9951423378755265,0.9927567905088979,118819,36,40171,1124
10,10,safari,High,125,0.4,118887,245,118887,811,5,40037,32,133,0.9996888769298039,0.9911958180135564,0.9990797622304574,0.9954242318947364,0.9931751482984702,118887,37,40170,1056
10,10,giraffe,High,125,0.55,163861,336,163861,1236,5,55333,47,177,0.9996827585365408,0.9904976637067574,0.9990641085634067,0.9950690155641787,0.9926514174528835,163861,52,55510,1572
10,10,safari,High,125,0.55,163952,336,163952,1145,6,55332,47,177,0.9996768391207586,0.9910477353369642,0.9990461106511644,0.9953435851358982,0.9930586664856671,163952,53,55509,1481
10,10,giraffe,High,125,0.5,149042,305,149042,1116,5,50376,44,165,0.9996713416638161,0.9905558177093372,0.9990314291361929,0.9950927044873379,0.9926884950734384,149042,49,50541,1421
10,10,safari,High,125,0.5,149125,305,149125,1033,6,50375,44,165,0.999664823194235,0.991107448342782,0.9990116623838703,0.995367743744118,0.9930963477292057,149125,50,50540,1338
10,10,giraffe,High,125,0.65,193830,402,193830,1461,5,65457,53,222,0.9997008582274303,0.9904799865094817,0.9991176962745486,0.9950690613761963,0.9926519527215698,193830,58,65679,1863
10,10,safari,High,125,0.65,193940,402,193940,1351,6,65456,53,222,0.9996958747210037,0.9910420914391419,0.9991024841413512,0.9953501739835563,0.9930688903339326,193940,59,65678,1753
10,10,giraffe,High,125,0.6,178830,376,178830,1355,5,60353,48,197,0.9997037169546575,0.9904132121554489,0.9991254558355197,0.9950367790253837,0.9926025443266823,178830,53,60550,1731
10,10,safari,High,125,0.6,178929,376,178929,1256,6,60352,48,197,0.9996982953688339,0.9909615033146693,0.9991089550022276,0.9953107269207663,0.9930089068020103,178929,54,60549,1632
10,10,giraffe,High,125,0.75,223464,454,223464,1649,6,75407,60,260,0.9997047376191115,0.9906768277274601,0.9991285172910092,0.995170308418894,0.9928011948224361,223464,66,75667,2103
10,10,safari,High,125,0.75,223587,454,223587,1526,7,75406,60,260,0.9997004301286809,0.9912221202569524,0.9991153130075396,0.99544322282351,0.993206106870229,223587,67,75666,1980
10,10,giraffe,High,125,0.7,208730,423,208730,1558,6,70483,57,240,0.999698265746457,0.9905984974680961,0.9991099935015398,0.9951275792364316,0.9927388213728743,208730,63,70723,1981
10,10,safari,High,125,0.7,208848,423,208848,1440,7,70482,57,240,0.9996936509152179,0.9911585062004357,0.9990958664142627,0.9954077827001856,0.9931544563529985,208848,64,70722,1863
10,10,giraffe,High,125,0.85,253251,518,253251,1877,6,85281,74,299,0.9996842076177017,0.9906315764768469,0.9990660751809479,0.9951373048290983,0.9927484427463918,253251,80,85580,2395
10,10,safari,High,125,0.85,253394,518,253394,1734,7,85280,74,299,0.9996804418581714,0.9911909437268723,0.9990544011207098,0.9954175922815991,0.993164491687811,253394,81,85579,2252
10,10,giraffe,High,125,0.8,238227,481,238227,1766,6,80291,65,279,0.9997020537310426,0.9906559544898825,0.9991195545690158,0.9951584470269774,0.9927814023013563,238227,71,80570,2247
10,10,safari,High,125,0.8,238361,481,238361,1632,7,80290,65,279,0.9996980283769444,0.9912131872884387,0.9991071539291427,0.9954375275366617,0.9931955841365243,238361,72,80569,2113
10,10,giraffe,High,125,0.95,282883,591,282883,2112,6,95209,78,327,0.999703145596483,0.990535250327397,0.9991215226939971,0.9950980823247788,0.992688992303374,282883,84,95536,2703
10,10,safari,High,125,0.95,283046,591,283046,1949,8,95207,78,327,0.9996962547504344,0.991106006596962,0.9991006065676636,0.9953825973505322,0.9931113361279728,283046,86,95534,2540
10,10,giraffe,High,125,0.9,267990,559,267990,1996,6,90229,77,313,0.9996903828434792,0.9905560997246299,0.9990841379310345,0.9951022802802729,0.9926959603510812,267990,83,90542,2555
10,10,safari,High,125,0.9,268141,559,268141,1845,7,90228,77,313,0.9996868300866809,0.991114232382783,0.9990731034482758,0.9953820739833324,0.9931112772378659,268141,84,90541,2404
10,10,giraffe,Mid,125,0.15,44871,86,44871,2,2,14954,15,52,0.9996212796292996,0.9980426610912164,0.9988684017839313,0.9988313466225918,0.9982494748424527,44871,17,15006,88
10,10,safari,Mid,125,0.15,44871,86,44871,2,2,14954,15,52,0.9996212796292996,0.9980426610912164,0.9988684017839313,0.9988313466225918,0.9982494748424527,44871,17,15006,88
10,10,giraffe,Mid,125,0.1,29890,61,29890,2,0,10014,13,33,0.999565261010601,0.9978967048375789,0.9987077534791252,0.9987302860197808,0.9981006172993777,29890,13,10047,63
10,10,safari,Mid,125,0.1,29890,61,29890,2,0,10014,13,33,0.999565261010601,0.9978967048375789,0.9987077534791252,0.9987302860197808,0.9981006172993777,29890,13,10047,63
10,10,giraffe,Mid,125,0.25,74844,150,74844,3,4,24982,27,86,0.9995859766277129,0.9979599183967359,0.9987648910315152,0.9987722856837834,0.9981617647058824,74844,31,25068,153
10,10,safari,Mid,125,0.25,74844,150,74844,3,4,24982,27,86,0.9995859766277129,0.9979599183967359,0.9987648910315152,0.9987722856837834,0.9981617647058824,74844,31,25068,153
10,10,giraffe,Mid,125,0.2,59873,114,59873,3,2,19908,20,71,0.9996326905417815,0.9980496749458243,0.9989000549972501,0.9988405555323854,0.9982623045092572,59873,22,19979,117
10,10,safari,Mid,125,0.2,59873,114,59873,3,2,19908,20,71,0.9996326905417815,0.9980496749458243,0.9989000549972501,0.9988405555323854,0.9982623045092572,59873,22,19979,117
10,10,giraffe,Mid,125,0.35,104740,200,104740,3,5,35005,35,119,0.9996182477572055,0.9980656165728062,0.9988624729837333,0.9988413288003699,0.9982656112828053,104740,40,35124,203
10,10,safari,Mid,125,0.35,104740,200,104740,3,5,35005,35,119,0.9996182477572055,0.9980656165728062,0.9988624729837333,0.9988413288003699,0.9982656112828053,104740,40,35124,203
10,10,giraffe,Mid,125,0.3,89614,180,89614,3,4,29881,33,104,0.9995872884853487,0.9979620700023386,0.9987675704483379,0.998774018099951,0.9981638972116276,89614,37,29985,183
10,10,safari,Mid,125,0.3,89614,180,89614,3,4,29881,33,104,0.9995872884853487,0.9979620700023386,0.9987675704483379,0.998774018099951,0.9981638972116276,89614,37,29985,183
10,10,giraffe,Mid,125,0.45,135067,269,135067,6,6,45251,44,152,0.9996299503393355,0.9979681104165743,0.9988999625987284,0.9987983391197927,0.9982023839154844,135067,50,45403,275
10,10,safari,Mid,125,0.45,135067,269,135067,6,6,45251,44,152,0.9996299503393355,0.9979681104165743,0.9988999625987284,0.9987983391197927,0.9982023839154844,135067,50,45403,275
10,10,giraffe,Mid,125,0.4,119699,236,119699,6,6,40036,38,136,0.9996325463701428,0.9979823413178146,0.9989059080962801,0.9988067622369453,0.998214252264965,119699,44,40172,242
10,10,safari,Mid,125,0.4,119699,236,119699,6,6,40036,38,136,0.9996325463701428,0.9979823413178146,0.9989059080962801,0.9988067622369453,0.998214252264965,119699,44,40172,242
10,10,giraffe,Mid,125,0.55,165091,332,165091,8,6,55334,54,185,0.9996366961144649,0.9979447624689447,0.9989204555677504,0.9987900127653653,0.9981901271435681,165091,60,55519,340
10,10,safari,Mid,125,0.55,165091,332,165091,8,6,55334,54,185,0.9996366961144649,0.9979447624689447,0.9989204555677504,0.9987900127653653,0.9981901271435681,165091,60,55519,340
10,10,giraffe,Mid,125,0.5,150160,294,150160,7,6,50377,50,170,0.9996272034936359,0.9979994815932368,0.9988933462442938,0.9988126793868504,0.998224445947559,150160,56,50547,301
10,10,safari,Mid,125,0.5,150160,294,150160,7,6,50377,50,170,0.9996272034936359,0.9979994815932368,0.9988933462442938,0.9988126793868504,0.998224445947559,150160,56,50547,301
10,10,giraffe,Mid,125,0.65,195294,389,195294,10,7,65455,64,223,0.9996365776879175,0.9979610921187779,0.9989201356674626,0.9987981322463676,0.9982022781343471,195294,71,65678,399
10,10,safari,Mid,125,0.65,195294,389,195294,10,7,65455,64,223,0.9996365776879175,0.9979610921187779,0.9989201356674626,0.9987981322463676,0.9982022781343471,195294,71,65678,399
10,10,giraffe,Mid,125,0.6,180192,358,180192,10,6,60354,58,202,0.9996449494052903,0.9979618963225521,0.9989442428241504,0.9988027138486099,0.9982088067003898,180192,64,60556,368
10,10,safari,Mid,125,0.6,180192,358,180192,10,6,60354,58,202,0.9996449494052903,0.9979618963225521,0.9989442428241504,0.9988027138486099,0.9982088067003898,180192,64,60556,368
10,10,giraffe,Mid,125,0.75,225105,444,225105,13,7,75406,74,255,0.9996402973541872,0.9979739495127725,0.9989305801272742,0.9988064284256392,0.9982144279531636,225105,81,75661,457
10,10,safari,Mid,125,0.75,225105,444,225105,13,7,75406,74,255,0.9996402973541872,0.9979739495127725,0.9989305801272742,0.9988064284256392,0.9982144279531636,225105,81,75661,457
10,10,giraffe,Mid,125,0.7,210271,422,210271,13,7,70482,68,238,0.9996434446103087,0.9979355120404735,0.9989406031499399,0.9987887481831224,0.9981882835229715,210271,75,70720,435
10,10,safari,Mid,125,0.7,210271,422,210271,13,7,70482,68,238,0.9996434446103087,0.9979355120404735,0.9989406031499399,0.9987887481831224,0.9981882835229715,210271,75,70720,435
10,10,giraffe,Mid,125,0.85,255127,496,255127,15,9,85278,80,282,0.9996512757820827,0.9980010796516949,0.9989608751999439,0.9988254961300098,0.9982419488582923,255127,89,85560,511
10,10,safari,Mid,125,0.85,255127,496,255127,15,9,85278,80,282,0.9996512757820827,0.9980010796516949,0.9989608751999439,0.9988254961300098,0.9982419488582923,255127,89,85560,511
10,10,giraffe,Mid,125,0.8,239986,467,239986,15,8,80289,76,272,0.9996501020535677,0.9979955752948417,0.9989583979167959,0.9988221535029488,0.9982373806105639,239986,84,80561,482
10,10,safari,Mid,125,0.8,239986,467,239986,15,8,80289,76,272,0.9996501020535677,0.9979955752948417,0.9989583979167959,0.9988221535029488,0.9982373806105639,239986,84,80561,482
10,10,giraffe,Mid,125,0.95,285002,555,285002,20,9,95204,88,313,0.9996597673088997,0.9979865325288801,0.998985504214864,0.998822449165551,0.9982371042338355,285002,97,95517,575
10,10,safari,Mid,125,0.95,285002,555,285002,20,9,95204,88,313,0.9996597673088997,0.9979865325288801,0.998985504214864,0.998822449165551,0.9982371042338355,285002,97,95517,575
10,10,giraffe,Mid,125,0.9,269987,531,269987,18,9,90226,85,298,0.9996519562649724,0.9979706952124671,0.998962678496546,0.9988106182380503,0.9982195960725896,269987,94,90524,549
10,10,safari,Mid,125,0.9,269987,531,269987,18,9,90226,85,298,0.9996519562649724,0.9979706952124671,0.998962678496546,0.9988106182380503,0.9982195960725896,269987,94,90524,549
10,10,giraffe,None,125,0.15,44879,82,44879,0,0,14958,11,49,0.9997549565604812,0.9981761971486399,0.9992675456119323,0.9989649530890029,0.9984494573100585,44879,11,15007,82
10,10,safari,None,125,0.15,44879,82,44879,0,0,14958,11,49,0.9997549565604812,0.9981761971486399,0.9992675456119323,0.9989649530890029,0.9984494573100585,44879,11,15007,82
10,10,giraffe,None,125,0.1,29905,50,29905,0,0,10014,7,26,0.999765980208612,0.9983308295776999,0.9993032746093361,0.9990478894883659,0.9985750712464376,29905,7,10040,50
10,10,safari,None,125,0.1,29905,50,29905,0,0,10014,7,26,0.999765980208612,0.9983308295776999,0.9993032746093361,0.9990478894883659,0.9985750712464376,29905,7,10040,50
10,10,giraffe,None,125,0.25,74863,137,74863,0,0,24988,20,88,0.9997329166833594,0.9981733333333334,0.9992030602486452,0.9989525162960443,0.9984315057544757,74863,20,25076,137
10,10,safari,None,125,0.25,74863,137,74863,0,0,24988,20,88,0.9997329166833594,0.9981733333333334,0.9992030602486452,0.9989525162960443,0.9984315057544757,74863,20,25076,137
10,10,giraffe,None,125,0.2,59885,108,59885,0,0,19912,15,70,0.9997495826377295,0.9981997899754972,0.9992498874831225,0.9989740852259932,0.9984623077884736,59885,15,19982,108
10,10,safari,None,125,0.2,59885,108,59885,0,0,19912,15,70,0.9997495826377295,0.9981997899754972,0.9992498874831225,0.9989740852259932,0.9984623077884736,59885,15,19982,108
10,10,giraffe,None,125,0.35,104751,195,104751,0,0,35012,31,118,0.9997041476589491,0.9981419015493682,0.9991183413441028,0.9989224137931034,0.9983869471189877,104751,31,35130,195
10,10,safari,None,125,0.35,104751,195,104751,0,0,35012,31,118,0.9997041476589491,0.9981419015493682,0.9991183413441028,0.9989224137931034,0.9983869471189877,104751,31,35130,195
10,10,giraffe,None,125,0.3,89632,168,89632,0,0,29887,25,109,0.9997211595302096,0.9981291759465479,0.9991672495919524,0.9989245334536964,0.9983892639854449,89632,25,29996,168
10,10,safari,None,125,0.3,89632,168,89632,0,0,29887,25,109,0.9997211595302096,0.9981291759465479,0.9991672495919524,0.9989245334536964,0.9983892639854449,89632,25,29996,168
10,10,giraffe,None,125,0.45,135088,258,135088,0,3,45254,41,144,0.9996743924459047,0.9980937744743102,0.9990317327582413,0.9988834581740473,0.998329535146138,135088,44,45398,258
10,10,safari,None,125,0.45,135088,258,135088,0,3,45254,41,144,0.9996743924459047,0.9980937744743102,0.9990317327582413,0.9988834581740473,0.998329535146138,135088,44,45398,258
10,10,giraffe,None,125,0.4,119726,219,119726,0,2,40042,36,129,0.9996827093283458,0.9981741631581141,0.9990549379492154,0.9989278667050464,0.9983952945290159,119726,38,40171,219
10,10,safari,None,125,0.4,119726,219,119726,0,2,40042,36,129,0.9996827093283458,0.9981741631581141,0.9990549379492154,0.9989278667050464,0.9983952945290159,119726,38,40171,219
10,10,giraffe,None,125,0.55,165117,318,165117,0,5,55335,55,169,0.9996367533010044,0.9980777949043431,0.9989201641350515,0.9988566658197525,0.9982895850207467,165117,60,55504,318
10,10,safari,None,125,0.55,165117,318,165117,0,5,55335,55,169,0.9996367533010044,0.9980777949043431,0.9989201641350515,0.9988566658197525,0.9982895850207467,165117,60,55504,318
10,10,giraffe,None,125,0.5,150179,286,150179,0,4,50379,51,158,0.9996339044424032,0.9980992257335592,0.998912871600253,0.9988659756101617,0.9983039635526244,150179,55,50537,286
10,10,safari,None,125,0.5,150179,286,150179,0,4,50379,51,158,0.9996339044424032,0.9980992257335592,0.998912871600253,0.9988659756101617,0.9983039635526244,150179,55,50537,286
10,10,giraffe,None,125,0.65,195306,389,195306,0,5,65459,65,210,0.9996417164851363,0.9980122128822914,0.9989351830724532,0.9988263000836166,0.9982442987522664,195306,70,65669,389
10,10,safari,None,125,0.65,195306,389,195306,0,5,65459,65,210,0.9996417164851363,0.9980122128822914,0.9989351830724532,0.9988263000836166,0.9982442987522664,195306,70,65669,389
10,10,giraffe,None,125,0.6,180211,352,180211,0,5,60355,58,187,0.9996505319680042,0.998050541916118,0.9989604818084317,0.9988498962135258,0.9982792078551052,180211,63,60542,352
10,10,safari,None,125,0.6,180211,352,180211,0,5,60355,58,187,0.9996505319680042,0.998050541916118,0.9989604818084317,0.9988498962135258,0.9982792078551052,180211,63,60542,352
10,10,giraffe,None,125,0.75,225134,433,225134,0,5,75410,75,245,0.9996447822959497,0.9980803929652831,0.998943685218195,0.9988619751054282,0.9982973893303064,225134,80,75655,433
10,10,safari,None,125,0.75,225134,433,225134,0,5,75410,75,245,0.9996447822959497,0.9980803929652831,0.998943685218195,0.9988619751054282,0.9982973893303064,225134,80,75655,433
10,10,giraffe,None,125,0.7,210297,414,210297,0,5,70486,71,226,0.9996387369101548,0.9980352236000968,0.9989263717014183,0.9988363366929163,0.998259318860813,210297,76,70712,414
10,10,safari,None,125,0.7,210297,414,210297,0,5,70486,71,226,0.9996387369101548,0.9980352236000968,0.9989263717014183,0.9988363366929163,0.998259318860813,210297,76,70712,414
10,10,giraffe,None,125,0.85,255159,485,255159,0,6,85285,90,283,0.9996239055062585,0.9981028304986622,0.9988793425476279,0.99886278892697,0.9982977252217938,255159,96,85568,485
10,10,safari,None,125,0.85,255159,485,255159,0,6,85285,90,283,0.9996239055062585,0.9981028304986622,0.9988793425476279,0.99886278892697,0.9982977252217938,255159,96,85568,485
10,10,giraffe,None,125,0.8,240015,457,240015,0,5,80294,81,263,0.9996418174018434,0.9980995708440068,0.9989335714197141,0.9988700988195343,0.998309017018825,240015,86,80557,457
10,10,safari,None,125,0.8,240015,457,240015,0,5,80294,81,263,0.9996418174018434,0.9980995708440068,0.9989335714197141,0.9988700988195343,0.998309017018825,240015,86,80557,457
10,10,giraffe,None,125,0.95,285032,552,285032,0,6,95212,95,310,0.9996457793380633,0.9980671186060843,0.9989437687585623,0.9988558252163506,0.9982870199130656,285032,101,95522,552
10,10,safari,None,125,0.95,285032,552,285032,0,6,95212,95,310,0.9996457793380633,0.9980671186060843,0.9989437687585623,0.9988558252163506,0.9982870199130656,285032,101,95522,552
10,10,giraffe,None,125,0.9,270021,522,270021,0,6,90232,94,296,0.9996297955360746,0.9980705470110112,0.9988965882508717,0.9988495627598656,0.9982778240777914,270021,100,90528,522
10,10,safari,None,125,0.9,270021,522,270021,0,6,90232,94,296,0.9996297955360746,0.9980705470110112,0.9988965882508717,0.9988495627598656,0.9982778240777914,270021,100,90528,522
10,10,giraffe,Single-stranded,125,0.15,44867,94,44867,0,0,14958,11,49,0.999754891037925,0.9979092991703922,0.9992675456119323,0.9988312425561282,0.9982493872855499,44867,11,15007,94
10,10,safari,Single-stranded,125,0.15,44867,94,44867,0,0,14958,11,49,0.999754891037925,0.9979092991703922,0.9992675456119323,0.9988312425561282,0.9982493872855499,44867,11,15007,94
10,10,giraffe,Single-stranded,125,0.1,29888,67,29888,0,0,10014,7,26,0.9997658471316274,0.9977633116341178,0.9993032746093361,0.998763575605681,0.9981500924953752,29888,7,10040,67
10,10,safari,Single-stranded,125,0.1,29888,67,29888,0,0,10014,7,26,0.9997658471316274,0.9977633116341178,0.9993032746093361,0.998763575605681,0.9981500924953752,29888,7,10040,67
10,10,giraffe,Single-stranded,125,0.25,74846,154,74846,0,0,24987,20,88,0.9997328560361178,0.9979466666666666,0.9992030284917314,0.9988389628067741,0.9982616514311404,74846,20,25075,154
10,10,safari,Single-stranded,125,0.25,74846,154,74846,0,0,24987,20,88,0.9997328560361178,0.9979466666666666,0.9992030284917314,0.9988389628067741,0.9982616514311404,74846,20,25075,154
10,10,giraffe,Single-stranded,125,0.2,59882,111,59882,0,0,19911,15,70,0.9997495700953303,0.9981497841414831,0.999249849969994,0.9989490366168987,0.9984247834077186,59882,15,19981,111
10,10,safari,Single-stranded,125,0.2,59882,111,59882,0,0,19911,15,70,0.9997495700953303,0.9981497841414831,0.999249849969994,0.9989490366168987,0.9984247834077186,59882,15,19981,111
10,10,giraffe,Single-stranded,125,0.35,104737,209,104737,0,2,35008,31,118,0.9996850243390284,0.9980084996093229,0.9990614067521829,0.998846058479086,0.9982727240284073,104737,33,35126,209
10,10,safari,Single-stranded,125,0.35,104737,209,104737,0,2,35008,31,118,0.9996850243390284,0.9980084996093229,0.9990614067521829,0.998846058479086,0.9982727240284073,104737,33,35126,209
10,10,giraffe,Single-stranded,125,0.3,89613,187,89613,0,1,29884,25,109,0.9997099476790237,0.9979175946547885,0.9991338818748127,0.998812967080735,0.9982223186639848,89613,26,29993,187
10,10,safari,Single-stranded,125,0.3,89613,187,89613,0,1,29884,25,109,0.9997099476790237,0.9979175946547885,0.9991338818748127,0.998812967080735,0.9982223186639848,89613,26,29993,187
10,10,giraffe,Single-stranded,125,0.45,135092,254,135092,0,4,45251,41,144,0.9996670045953366,0.9981233283584295,0.9990096830985915,0.998894570083887,0.998346110871417,135092,45,45395,254
10,10,safari,Single-stranded,125,0.45,135092,254,135092,0,4,45251,41,144,0.9996670045953366,0.9981233283584295,0.9990096830985915,0.998894570083887,0.998346110871417,135092,45,45395,254
10,10,giraffe,Single-stranded,125,0.4,119711,234,119711,0,4,40038,36,129,0.9996659735618074,0.9980491058401767,0.9990051483572512,0.9988568853881583,0.9982891253309356,119711,40,40167,234
10,10,safari,Single-stranded,125,0.4,119711,234,119711,0,4,40038,36,129,0.9996659735618074,0.9980491058401767,0.9990051483572512,0.9988568853881583,0.9982891253309356,119711,40,40167,234
10,10,giraffe,Single-stranded,125,0.55,165114,318,165114,1,4,55335,55,169,0.9996427987625096,0.9980717269226816,0.9989381422889333,0.9988566450699625,0.9982895618020236,165114,59,55504,319
10,10,safari,Single-stranded,125,0.55,165114,318,165114,1,4,55335,55,169,0.9996427987625096,0.9980717269226816,0.9989381422889333,0.9988566450699625,0.9982895618020236,165114,59,55504,319
10,10,giraffe,Single-stranded,125,0.5,150182,283,150182,0,4,50377,51,158,0.999633911752764,0.9981191639251653,0.9989128286222574,0.9988759635785596,0.9983188679714506,150182,55,50535,283
10,10,safari,Single-stranded,125,0.5,150182,283,150182,0,4,50377,51,158,0.999633911752764,0.9981191639251653,0.9989128286222574,0.9988759635785596,0.9983188679714506,150182,55,50535,283
10,10,giraffe,Single-stranded,125,0.65,195314,379,195314,1,4,65459,65,210,0.9996468474739358,0.998058192892986,0.9989503787763546,0.9988518885027757,0.9982825361853178,195314,69,65669,380
10,10,safari,Single-stranded,125,0.65,195314,379,195314,1,4,65459,65,210,0.9996468474739358,0.998058192892986,0.9989503787763546,0.9988518885027757,0.9982825361853178,195314,69,65669,380
10,10,giraffe,Single-stranded,125,0.6,180213,348,180213,1,4,60355,58,187,0.9996560809873803,0.9980671459110998,0.9989769652168173,0.9988609815512267,0.9982957796704345,180213,62,60542,349
10,10,safari,Single-stranded,125,0.6,180213,348,180213,1,4,60355,58,187,0.9996560809873803,0.9980671459110998,0.9989769652168173,0.9988609815512267,0.9982957796704345,180213,62,60542,349
10,10,giraffe,Single-stranded,125,0.75,225115,450,225115,1,6,75408,75,245,0.9996403133270573,0.9980005851945772,0.9989304671613807,0.9988197762899268,0.9982343179555261,225115,81,75653,451
10,10,safari,Single-stranded,125,0.75,225115,450,225115,1,6,75408,75,245,0.9996403133270573,0.9980005851945772,0.9989304671613807,0.9988197762899268,0.9982343179555261,225115,81,75653,451
10,10,giraffe,Single-stranded,125,0.7,210296,413,210296,1,4,70486,71,226,0.9996434869825214,0.9980352142755445,0.9989404834220973,0.998838703242369,0.9982628589292248,210296,75,70712,414
10,10,safari,Single-stranded,125,0.7,210296,413,210296,1,4,70486,71,226,0.9996434869825214,0.9980352142755445,0.9989404834220973,0.998838703242369,0.9982628589292248,210296,75,70712,414
10,10,giraffe,Single-stranded,125,0.85,255143,499,255143,1,6,85286,90,283,0.9996238819302693,0.998044147502572,0.9988793556294869,0.9988333900979091,0.9982537766474856,255143,96,85569,500
10,10,safari,Single-stranded,125,0.85,255143,499,255143,1,6,85286,90,283,0.9996238819302693,0.998044147502572,0.9988793556294869,0.9988333900979091,0.9982537766474856,255143,96,85569,500
10,10,giraffe,Single-stranded,125,0.8,240000,470,240000,1,6,80294,81,263,0.9996376313586325,0.9980413438626695,0.9989211844650563,0.9988388498370645,0.998262304781776,240000,87,80557,471
10,10,safari,Single-stranded,125,0.8,240000,470,240000,1,6,80294,81,263,0.9996376313586325,0.9980413438626695,0.9989211844650563,0.9988388498370645,0.998262304781776,240000,87,80557,471
10,10,giraffe,Single-stranded,125,0.95,285027,554,285027,1,7,95212,95,310,0.9996422671843271,0.9980566002058954,0.9989333221785326,0.9988488043861079,0.9982765224052087,285027,102,95522,555
10,10,safari,Single-stranded,125,0.95,285027,554,285027,1,7,95212,95,310,0.9996422671843271,0.9980566002058954,0.9989333221785326,0.9988488043861079,0.9982765224052087,285027,102,95522,555
10,10,giraffe,Single-stranded,125,0.9,270010,530,270010,1,6,90233,94,296,0.9996297804598127,0.9980372660705771,0.9988966004259122,0.9988328884992352,0.9982529002962593,270010,100,90529,531
10,10,safari,Single-stranded,125,0.9,270010,530,270010,1,6,90233,94,296,0.9996297804598127,0.9980372660705771,0.9988966004259122,0.9988328884992352,0.9982529002962593,270010,100,90529,531
10,7,giraffe,High,125,0.15,44713,93,44713,154,0,14956,10,50,0.9997764014041992,0.9945062277580071,0.9993340436867342,0.9971343509918267,0.9957149526477258,44713,10,15006,247
10,7,safari,High,125,0.15,44743,93,44743,124,0,14956,10,50,0.9997765512926508,0.995173487544484,0.9993340436867342,0.9974697089607972,0.9962151527277577,44743,10,15006,217
10,7,giraffe,High,125,0.1,29801,58,29801,95,0,10014,6,27,0.9997987050021807,0.9948921679909194,0.9994028068080024,0.9973394019511052,0.9960250993725157,29801,6,10041,153
10,7,safari,High,125,0.1,29818,58,29818,78,0,10014,6,27,0.9997988197424893,0.9954597048808173,0.9994028068080024,0.997624544146676,0.9964500887477813,29818,6,10041,136
10,7,giraffe,High,125,0.25,74604,158,74604,237,1,24985,19,89,0.9997319897084048,0.9947332631101748,0.9992029967322866,0.9972263622571396,0.995853855914,74604,20,25074,395
10,7,safari,High,125,0.25,74643,158,74643,198,1,24985,19,89,0.9997321297027979,0.9952532700436005,0.9992029967322866,0.9974876722214056,0.9962434935509976,74643,20,25074,356
10,7,giraffe,High,125,0.2,59674,125,59674,193,0,19910,14,71,0.99976544699102,0.9946992932390986,0.999299824956239,0.997225935828877,0.9958493255153963,59674,14,19981,318
10,7,safari,High,125,0.2,59710,125,59710,157,0,19910,14,71,0.9997655883731833,0.9952993732497666,0.999299824956239,0.9975274817067058,0.996299398652281,59710,14,19981,282
10,7,giraffe,High,125,0.35,104417,216,104417,311,3,35007,29,120,0.9996936303842067,0.9949782741271536,0.9990898489718137,0.9973303787614676,0.9960100782995368,104417,32,35127,527
10,7,safari,High,125,0.35,104463,216,104463,265,4,35006,30,119,0.9996746318076117,0.9954166031407227,0.9990329645325521,0.9975410736197784,0.9963241329593228,104463,34,35125,481
10,7,giraffe,High,125,0.3,89334,192,89334,273,1,29884,24,110,0.9997202296355152,0.994821768616577,0.9991671941103968,0.9972649839806205,0.9959104642040428,89334,25,29994,465
10,7,safari,High,125,0.3,89374,192,89374,233,1,29884,25,109,0.9997091722595078,0.995267207875366,0.9991338818748127,0.997483244884179,0.9962359578694353,89374,26,29993,425
10,7,giraffe,High,125,0.45,134659,278,134659,407,4,45251,39,146,0.9996807768258823,0.9949388225558576,0.9990536971830986,0.9973041629944528,0.9959730949641561,134659,43,45397,685
10,7,safari,High,125,0.45,134715,278,134715,351,5,45250,40,145,0.9996660730186999,0.9953525830476415,0.9990096830985915,0.9975046648698279,0.9962717939640676,134715,45,45395,629
10,7,giraffe,High,125,0.4,119333,245,119333,365,4,40038,34,131,0.9996816647259384,0.9949142509358612,0.9990548909393887,0.9972922603775792,0.9959537933187637,119333,38,40169,610
10,7,safari,High,125,0.4,119385,245,119385,313,5,40037,35,130,0.9996650617542391,0.9953477902003451,0.9990051483572512,0.9975017546205006,0.9962660006244146,119385,40,40167,558
10,7,giraffe,High,125,0.55,164591,336,164591,506,5,55333,49,175,0.9996720216222782,0.9949103262347899,0.9990281127389223,0.9972854900962803,0.9959456096291771,164591,54,55508,842
10,7,safari,High,125,0.55,164653,336,164653,444,6,55332,50,174,0.9996600064355925,0.9952851003125133,0.9989921169144379,0.9974677562988047,0.9962171089843662,164653,56,55506,780
10,7,giraffe,High,125,0.5,149697,305,149697,461,5,50376,46,163,0.9996594278387692,0.9949090474070037,0.9989918956315478,0.9972785807315522,0.9959363948809518,149697,51,50539,766
10,7,safari,High,125,0.5,149756,305,149756,402,6,50375,47,162,0.9996462161819384,0.9953011703874042,0.9989523621269025,0.9974689614749294,0.9962199022148389,149756,53,50537,707
10,7,giraffe,High,125,0.65,194689,402,194689,602,5,65457,57,218,0.9996816447669075,0.9948695150056466,0.9990568477417588,0.9972697749229082,0.9959224266534062,194689,62,65675,1004
10,7,safari,High,125,0.65,194762,402,194762,529,6,65456,58,217,0.9996715017502797,0.9952425482771484,0.999026423475364,0.9974521086041909,0.9961940098687986,194762,64,65673,931
10,7,giraffe,High,125,0.6,179629,376,179629,556,5,60353,50,195,0.9996939070813206,0.9948383094909754,0.9990924541689356,0.9972601979208594,0.9959073493556252,179629,55,60548,932
10,7,safari,High,125,0.6,179695,376,179695,490,6,60352,51,194,0.9996828964350883,0.9952038369304557,0.9990594525023514,0.9974383383336155,0.9961727289313497,179695,57,60546,866
10,7,giraffe,High,125,0.75,224426,452,224426,689,6,75407,66,254,0.9996792844479684,0.994941635966254,0.9990492915901918,0.9973048337462366,0.995974112180551,224426,72,75661,1141
10,7,safari,High,125,0.75,224515,452,224515,600,7,75406,67,253,0.9996705092413253,0.9953361972274313,0.9990228830232527,0.9974986449142076,0.9962628609359443,224515,74,75659,1052
10,7,giraffe,High,125,0.7,209638,423,209638,650,6,70483,61,236,0.9996805035645311,0.9949077172050819,0.9990534851524313,0.997288400060892,0.9959502232705855,209638,67,70719,1073
10,7,safari,High,125,0.7,209721,423,209721,567,7,70482,62,235,0.9996710996710997,0.9953016216524054,0.999025230977877,0.9974815755491664,0.9962379705645176,209721,69,70717,990
10,7,giraffe,High,125,0.85,254346,516,254346,784,7,85280,82,291,0.9996502053569674,0.9949148431815871,0.9989610086388045,0.997276903080099,0.9959303381716114,254346,89,85571,1300
10,7,safari,High,125,0.85,254441,516,254441,689,8,85279,83,290,0.9996424811025726,0.9952864507952403,0.9989376605183283,0.9974597101403823,0.9962028209290197,254441,91,85569,1205
10,7,giraffe,High,125,0.8,239261,479,239261,734,7,80290,71,273,0.9996741024237588,0.9949557956369504,0.9990327500899047,0.9973093684414552,0.9959796334646466,239261,78,80563,1213
10,7,safari,High,125,0.8,239354,479,239354,641,8,80289,72,272,0.9996658786972611,0.9953425318329633,0.9990079488101586,0.9974995207414754,0.9962630210360774,239354,80,80561,1120
10,7,giraffe,High,125,0.95,284114,588,284114,884,7,95208,87,318,0.9996692563193155,0.9948456857128851,0.99901694206233,0.9972516383113899,0.9958919849110455,284114,94,95526,1472
10,7,safari,High,125,0.95,284224,588,284224,774,9,95206,88,317,0.9996588363152915,0.9952308586555363,0.99898556787283,0.9974399331820807,0.9961726730429217,284224,97,95523,1362
10,7,giraffe,High,125,0.9,269158,557,269158,830,7,90228,85,305,0.9996583101207057,0.9948733112790848,0.9989848275862069,0.9972600709528618,0.9959049754963036,269158,92,90533,1387
10,7,safari,High,125,0.9,269257,557,269257,731,8,90227,86,304,0.9996510129904845,0.9952392393132381,0.9989627586206896,0.9974402477514188,0.996173547083091,269257,94,90531,1288
10,7,giraffe,Mid,125,0.15,44873,86,44873,0,3,14953,16,51,0.9995767620065936,0.998087146066416,0.9987352725820409,0.9988313986488743,0.9982494748424527,44873,19,15004,86
10,7,safari,Mid,125,0.15,44873,86,44873,0,3,14953,16,51,0.9995767620065936,0.998087146066416,0.9987352725820409,0.9988313986488743,0.9982494748424527,44873,19,15004,86
10,7,giraffe,Mid,125,0.1,29892,61,29892,0,1,10013,13,33,0.9995318665150806,0.9979634761125764,0.9986083499005964,0.9987470555806145,0.9981256091770174,29892,14,10046,61
10,7,safari,Mid,125,0.1,29892,61,29892,0,1,10013,13,33,0.9995318665150806,0.9979634761125764,0.9986083499005964,0.9987470555806145,0.9981256091770174,29892,14,10046,61
10,7,giraffe,Mid,125,0.25,74846,150,74846,1,5,24981,29,84,0.9995459401709401,0.9979865861301118,0.9986453643571457,0.9987656545033594,0.9981517742966752,74846,34,25065,151
10,7,safari,Mid,125,0.25,74846,150,74846,1,5,24981,29,84,0.9995459401709401,0.9979865861301118,0.9986453643571457,0.9987656545033594,0.9981517742966752,74846,34,25065,151
10,7,giraffe,Mid,125,0.2,59875,114,59875,1,3,19907,22,69,0.9995826377295493,0.9980830138356392,0.9987500624968751,0.9988322629076654,0.998249803102849,59875,25,19976,115
10,7,safari,Mid,125,0.2,59875,114,59875,1,3,19907,22,69,0.9995826377295493,0.9980830138356392,0.9987500624968751,0.9988322629076654,0.998249803102849,59875,25,19976,115
10,7,giraffe,Mid,125,0.35,104742,200,104742,1,7,35003,37,117,0.9995800965777871,0.9980846745376061,0.9987487202821067,0.9988318258323837,0.9982513364785486,104742,44,35120,201
10,7,safari,Mid,125,0.35,104742,200,104742,1,7,35003,37,117,0.9995800965777871,0.9980846745376061,0.9987487202821067,0.9988318258323837,0.9982513364785486,104742,44,35120,201
10,7,giraffe,Mid,125,0.3,89616,180,89616,1,5,29880,35,102,0.9995538502721514,0.9979843424613294,0.9986676437279328,0.998768479769076,0.9981555512898622,89616,40,29982,181
10,7,safari,Mid,125,0.3,89616,180,89616,1,5,29880,35,102,0.9995538502721514,0.9979843424613294,0.9986676437279328,0.998768479769076,0.9981555512898622,89616,40,29982,181
10,7,giraffe,Mid,125,0.45,135072,269,135072,1,8,45249,47,149,0.9995929754971249,0.9980050538635457,0.9987899588586012,0.9987983835485766,0.9982023839154844,135072,55,45398,270
10,7,safari,Mid,125,0.45,135072,269,135072,1,8,45249,47,149,0.9995929754971249,0.9980050538635457,0.9987899588586012,0.9987983835485766,0.9982023839154844,135072,55,45398,270
10,7,giraffe,Mid,125,0.4,119704,236,119704,1,8,40034,41,133,0.9995908244469867,0.9980240284806696,0.9987815794708573,0.9988068120186571,0.998214252264965,119704,49,40167,237
10,7,safari,Mid,125,0.4,119704,236,119704,1,8,40034,41,133,0.9995908244469867,0.9980240284806696,0.9987815794708573,0.9988068120186571,0.998214252264965,119704,49,40167,237
10,7,giraffe,Mid,125,0.55,165098,332,165098,1,8,55332,60,179,0.9995882929900827,0.9979870761828195,0.9987765163101171,0.9987870428346295,0.9981856024614271,165098,68,55511,333
10,7,safari,Mid,125,0.55,165098,332,165098,1,8,55332,60,179,0.9995882929900827,0.9979870761828195,0.9987765163101171,0.9987870428346295,0.9981856024614271,165098,68,55511,333
10,7,giraffe,Mid,125,0.5,150166,294,150166,1,8,50375,55,165,0.9995806402225935,0.9980393590365609,0.9987550145248305,0.9988094050350861,0.9982194724067959,150166,63,50540,295
10,7,safari,Mid,125,0.5,150166,294,150166,1,8,50375,55,165,0.9995806402225935,0.9980393590365609,0.9987550145248305,0.9988094050350861,0.9982194724067959,150166,63,50540,295
10,7,giraffe,Mid,125,0.65,195302,389,195302,2,10,65452,72,215,0.9995803136387831,0.9980019724772986,0.9987528327427033,0.9987905195140598,0.9981908033139282,195302,82,65667,391
10,7,safari,Mid,125,0.65,195302,389,195302,2,10,65452,72,215,0.9995803136387831,0.9980019724772986,0.9987528327427033,0.9987905195140598,0.9981908033139282,195302,82,65667,391
10,7,giraffe,Mid,125,0.6,180200,358,180200,2,9,60351,65,195,0.9995895137401954,0.9980062029242357,0.998779280765424,0.9987972308596196,0.9982005141388175,180200,74,60546,360
10,7,safari,Mid,125,0.6,180200,358,180200,2,9,60351,65,195,0.9995895137401954,0.9980062029242357,0.998779280765424,0.9987972308596196,0.9982005141388175,180200,74,60546,360
10,7,giraffe,Mid,125,0.75,225115,444,225115,3,10,75403,82,247,0.9995914869431234,0.9980182832214646,0.9987853502680151,0.9988042655994533,0.9982111090460133,225115,92,75650,447
10,7,safari,Mid,125,0.75,225115,444,225115,3,10,75403,82,247,0.9995914869431234,0.9980182832214646,0.9987853502680151,0.9988042655994533,0.9982111090460133,225115,92,75650,447
10,7,giraffe,Mid,125,0.7,210281,422,210281,3,10,70479,76,230,0.9995911906335119,0.9979829715337959,0.9987852249452644,0.9987864337062695,0.9981847311377224,210281,86,70709,425
10,7,safari,Mid,125,0.7,210281,422,210281,3,10,70479,76,230,0.9995911906335119,0.9979829715337959,0.9987852249452644,0.9987864337062695,0.9981847311377224,210281,86,70709,425
10,7,giraffe,Mid,125,0.85,255139,496,255139,3,12,85275,91,271,0.9995964613974189,0.9980480210297373,0.9987974173662273,0.998821641089884,0.9982360886878199,255139,103,85546,499
10,7,safari,Mid,125,0.85,255139,496,255139,3,12,85275,91,271,0.9995964613974189,0.9980480210297373,0.9987974173662273,0.998821641089884,0.9982360886878199,255139,103,85546,499
10,7,giraffe,Mid,125,0.8,239998,467,239998,3,11,80286,86,262,0.9995959932526708,0.9980454779845968,0.9987971975943952,0.9988201338846311,0.9982342664420313,239998,97,80548,470
10,7,safari,Mid,125,0.8,239998,467,239998,3,11,80286,86,262,0.9995959932526708,0.9980454779845968,0.9987971975943952,0.9988201338846311,0.9982342664420313,239998,97,80548,470
10,7,giraffe,Mid,125,0.95,285018,555,285018,4,12,95201,99,302,0.9996107025241207,0.9980425594498157,0.9988390821427824,0.9988260154965953,0.9982423509474253,285018,111,95503,559
10,7,safari,Mid,125,0.95,285018,555,285018,4,12,95201,99,302,0.9996107025241207,0.9980425594498157,0.9988390821427824,0.9988260154965953,0.9982423509474253,285018,111,95503,559
10,7,giraffe,Mid,125,0.9,270001,531,270001,4,12,90223,96,287,0.9996001614163171,0.998022444332732,0.9988081838045422,0.9988106798361216,0.9982195960725896,270001,108,90510,535
10,7,safari,Mid,125,0.9,270001,531,270001,4,12,90223,96,287,0.9996001614163171,0.998022444332732,0.9988081838045422,0.9988106798361216,0.9982195960725896,270001,108,90510,535
10,7,giraffe,None,125,0.15,44879,82,44879,0,1,14957,15,45,0.9996436128744849,0.9981761971486399,0.9989346117991743,0.9989093660968661,0.9983660947998466,44879,16,15002,82
10,7,safari,None,125,0.15,44879,82,44879,0,1,14957,15,45,0.9996436128744849,0.9981761971486399,0.9989346117991743,0.9989093660968661,0.9983660947998466,44879,16,15002,82
10,7,giraffe,None,125,0.1,29905,50,29905,0,0,10014,7,26,0.999765980208612,0.9983308295776999,0.9993032746093361,0.9990478894883659,0.9985750712464376,29905,7,10040,50
10,7,safari,None,125,0.1,29905,50,29905,0,0,10014,7,26,0.999765980208612,0.9983308295776999,0.9993032746093361,0.9990478894883659,0.9985750712464376,29905,7,10040,50
10,7,giraffe,None,125,0.25,74863,137,74863,0,2,24986,25,83,0.9996394712244625,0.9981733333333334,0.998924131335671,0.998905864300487,0.9983615728900256,74863,27,25069,137
10,7,safari,None,125,0.25,74863,137,74863,0,2,24986,25,83,0.9996394712244625,0.9981733333333334,0.998924131335671,0.998905864300487,0.9983615728900256,74863,27,25069,137
10,7,giraffe,None,125,0.2,59885,108,59885,0,1,19911,20,65,0.9996494508062631,0.9981997899754972,0.9989498424763714,0.9989240944461588,0.9983872984123016,59885,21,19976,108
10,7,safari,None,125,0.2,59885,108,59885,0,1,19911,20,65,0.9996494508062631,0.9981997899754972,0.9989498424763714,0.9989240944461588,0.9983872984123016,59885,21,19976,108
10,7,giraffe,None,125,0.35,104751,195,104751,0,3,35009,37,112,0.9996182878300618,0.9981419015493682,0.9988623759278746,0.9988795491496494,0.9983227104998322,104751,40,35121,195
10,7,safari,None,125,0.35,104751,195,104751,0,3,35009,37,112,0.9996182878300618,0.9981419015493682,0.9988623759278746,0.9988795491496494,0.9983227104998322,104751,40,35121,195
10,7,giraffe,None,125,0.3,89632,168,89632,0,2,29885,31,103,0.9996319634193944,0.9981291759465479,0.9989007694613771,0.9988800044576936,0.9983224977257743,89632,33,29988,168
10,7,safari,None,125,0.3,89632,168,89632,0,2,29885,31,103,0.9996319634193944,0.9981291759465479,0.9989007694613771,0.9988800044576936,0.9983224977257743,89632,33,29988,168
10,7,giraffe,None,125,0.45,135088,258,135088,0,6,45251,47,138,0.9996078170207413,0.9980937744743102,0.9988336780951542,0.9988502220069726,0.9982797530809567,135088,53,45389,258
10,7,safari,None,125,0.45,135088,258,135088,0,6,45251,47,138,0.9996078170207413,0.9980937744743102,0.9988336780951542,0.9988502220069726,0.9982797530809567,135088,53,45389,258
10,7,giraffe,None,125,0.4,119726,219,119726,0,5,40039,42,123,0.9996075910263582,0.9981741631581141,0.9988311074635032,0.9988903628430071,0.9983390986175806,119726,47,40162,219
10,7,safari,None,125,0.4,119726,219,119726,0,5,40039,42,123,0.9996075910263582,0.9981741631581141,0.9988311074635032,0.9988903628430071,0.9983390986175806,119726,47,40162,219
10,7,giraffe,None,125,0.55,165117,318,165117,0,8,55332,61,163,0.9995822890559732,0.9980777949043431,0.9987581887553092,0.998829475441669,0.998248860854574,165117,69,55495,318
10,7,safari,None,125,0.55,165117,318,165117,0,8,55332,61,163,0.9995822890559732,0.9980777949043431,0.9987581887553092,0.998829475441669,0.998248860854574,165117,69,55495,318
10,7,giraffe,None,125,0.5,150179,286,150179,0,7,50376,57,152,0.9995740234154004,0.9980992257335592,0.9987349778621126,0.9988360801840989,0.998259200127327,150179,64,50528,286
10,7,safari,None,125,0.5,150179,286,150179,0,7,50376,57,152,0.9995740234154004,0.9980992257335592,0.9987349778621126,0.9988360801840989,0.998259200127327,150179,64,50528,286
10,7,giraffe,None,125,0.65,195306,389,195306,0,8,65456,74,201,0.9995803222306385,0.9980122128822914,0.9987526430277309,0.9987956520738563,0.998198398066051,195306,82,65657,389
10,7,safari,None,125,0.65,195306,389,195306,0,8,65456,74,201,0.9995803222306385,0.9980122128822914,0.9987526430277309,0.9987956520738563,0.998198398066051,195306,82,65657,389
10,7,giraffe,None,125,0.6,180211,352,180211,0,8,60352,65,180,0.9995950833129951,0.998050541916118,0.9987954789208812,0.9988222155096205,0.9982377429841438,180211,73,60532,352
10,7,safari,None,125,0.6,180211,352,180211,0,8,60352,65,180,0.9995950833129951,0.998050541916118,0.9987954789208812,0.9988222155096205,0.9982377429841438,180211,73,60532,352
10,7,giraffe,None,125,0.75,225134,433,225134,0,8,75407,86,234,0.9995826451418118,0.9980803929652831,0.9987588301313791,0.99883095420313,0.9982509243217769,225134,94,75641,433
10,7,safari,None,125,0.75,225134,433,225134,0,8,75407,86,234,0.9995826451418118,0.9980803929652831,0.9987588301313791,0.99883095420313,0.9982509243217769,225134,94,75641,433
10,7,giraffe,None,125,0.7,210297,414,210297,0,8,70483,81,216,0.9995769680492048,0.9980352236000968,0.9987427247556083,0.9988055008703459,0.9982131375244673,210297,89,70699,414
10,7,safari,None,125,0.7,210297,414,210297,0,8,70483,81,216,0.9995769680492048,0.9980352236000968,0.9987427247556083,0.9988055008703459,0.9982131375244673,210297,89,70699,414
10,7,giraffe,None,125,0.85,255159,485,255159,0,9,85282,103,270,0.9995612505925076,0.9981028304986622,0.9986925663055659,0.9988315081765069,0.9982508467425316,255159,112,85552,485
10,7,safari,None,125,0.85,255159,485,255159,0,9,85282,103,270,0.9995612505925076,0.9981028304986622,0.9986925663055659,0.9988315081765069,0.9982508467425316,255159,112,85552,485
10,7,giraffe,None,125,0.8,240015,457,240015,0,8,80291,92,252,0.99958353289049,0.9980995708440068,0.9987599667671093,0.9988410006929026,0.9982654189309126,240015,100,80543,457
10,7,safari,None,125,0.8,240015,457,240015,0,8,80291,92,252,0.99958353289049,0.9980995708440068,0.9987599667671093,0.9988410006929026,0.9982654189309126,240015,100,80543,457
10,7,giraffe,None,125,0.95,285032,552,285032,0,9,95209,109,296,0.999586182710854,0.9980671186060843,0.9987659872624787,0.9988260730918431,0.9982424247193782,285032,118,95505,552
10,7,safari,None,125,0.95,285032,552,285032,0,9,95209,109,296,0.999586182710854,0.9980671186060843,0.9987659872624787,0.9988260730918431,0.9982424247193782,285032,118,95505,552
10,7,giraffe,None,125,0.9,270021,522,270021,0,9,90229,107,283,0.9995705882570696,0.9980705470110112,0.9987200423710112,0.9988200044388548,0.9982335237325256,270021,116,90512,522
10,7,safari,None,125,0.9,270021,522,270021,0,9,90229,107,283,0.9995705882570696,0.9980705470110112,0.9987200423710112,0.9988200044388548,0.9982335237325256,270021,116,90512,522
10,7,giraffe,Single-stranded,125,0.15,44867,94,44867,0,1,14957,15,45,0.9996435175901789,0.9979092991703922,0.9989346117991743,0.9987756555807845,0.998166024775338,44867,16,15002,94
10,7,safari,Single-stranded,125,0.15,44867,94,44867,0,1,14957,15,45,0.9996435175901789,0.9979092991703922,0.9989346117991743,0.9987756555807845,0.998166024775338,44867,16,15002,94
10,7,giraffe,Single-stranded,125,0.1,29888,67,29888,0,1,10013,7,26,0.9997324056729997,0.9977633116341178,0.9992037424106699,0.9987468881054619,0.9981250937453128,29888,8,10039,67
10,7,safari,Single-stranded,125,0.1,29888,67,29888,0,1,10013,7,26,0.9997324056729997,0.9977633116341178,0.9992037424106699,0.9987468881054619,0.9981250937453128,29888,8,10039,67
10,7,giraffe,Single-stranded,125,0.25,74846,154,74846,0,1,24986,25,83,0.9996527406774228,0.9979466666666666,0.9989639370392508,0.9987989751254405,0.9982017083770418,74846,26,25069,154
10,7,safari,Single-stranded,125,0.25,74846,154,74846,0,1,24986,25,83,0.9996527406774228,0.9979466666666666,0.9989639370392508,0.9987989751254405,0.9982017083770418,74846,26,25069,154
10,7,giraffe,Single-stranded,125,0.2,59882,111,59882,0,1,19910,20,65,0.9996494332504215,0.9981497841414831,0.9989497899579916,0.9988990458397278,0.9983497730938004,59882,21,19975,111
10,7,safari,Single-stranded,125,0.2,59882,111,59882,0,1,19910,20,65,0.9996494332504215,0.9981497841414831,0.9989497899579916,0.9988990458397278,0.9983497730938004,59882,21,19975,111
10,7,giraffe,Single-stranded,125,0.35,104737,209,104737,0,4,35006,37,112,0.999608696482086,0.9980084996093229,0.9988338689951364,0.9988079571246018,0.9982156239962885,104737,41,35118,209
10,7,safari,Single-stranded,125,0.35,104737,209,104737,0,4,35006,37,112,0.999608696482086,0.9980084996093229,0.9988338689951364,0.9988079571246018,0.9982156239962885,104737,41,35118,209
10,7,giraffe,Single-stranded,125,0.3,89613,187,89613,0,2,29883,31,103,0.9996318854159695,0.9979175946547885,0.9989006962257237,0.9987740044358748,0.9981638972116276,89613,33,29986,187
10,7,safari,Single-stranded,125,0.3,89613,187,89613,0,2,29883,31,103,0.9996318854159695,0.9979175946547885,0.9989006962257237,0.9987740044358748,0.9981638972116276,89613,33,29986,187
10,7,giraffe,Single-stranded,125,0.45,135092,254,135092,0,6,45249,47,138,0.9996078286285102,0.9981233283584295,0.9988336267605634,0.9988650269325042,0.9983018596572744,135092,53,45387,254
10,7,safari,Single-stranded,125,0.45,135092,254,135092,0,6,45249,47,138,0.9996078286285102,0.9981233283584295,0.9988336267605634,0.9988650269325042,0.9983018596572744,135092,53,45387,254
10,7,giraffe,Single-stranded,125,0.4,119711,234,119711,0,6,40036,42,123,0.9995991950500589,0.9980491058401767,0.9988061780287014,0.9988235490438206,0.9982391727858534,119711,48,40159,234
10,7,safari,Single-stranded,125,0.4,119711,234,119711,0,6,40036,42,123,0.9995991950500589,0.9980491058401767,0.9988061780287014,0.9988235490438206,0.9982391727858534,119711,48,40159,234
10,7,giraffe,Single-stranded,125,0.55,165114,318,165114,1,6,55333,61,163,0.9995943843420249,0.9980717269226816,0.998794161582348,0.998832475333773,0.9982533620518018,165114,67,55496,319
10,7,safari,Single-stranded,125,0.55,165114,318,165114,1,6,55333,61,163,0.9995943843420249,0.9980717269226816,0.998794161582348,0.998832475333773,0.9982533620518018,165114,67,55496,319
10,7,giraffe,Single-stranded,125,0.5,150182,283,150182,0,6,50375,57,152,0.9995806848813604,0.9981191639251653,0.9987546946036766,0.9988493897775265,0.998279077864266,150182,63,50527,283
10,7,safari,Single-stranded,125,0.5,150182,283,150182,0,6,50375,57,152,0.9995806848813604,0.9981191639251653,0.9987546946036766,0.9988493897775265,0.998279077864266,150182,63,50527,283
10,7,giraffe,Single-stranded,125,0.65,195314,379,195314,1,6,65457,74,201,0.9995905708465971,0.998058192892986,0.9987830478566431,0.9988237941332897,0.9982404602344013,195314,80,65658,380
10,7,safari,Single-stranded,125,0.65,195314,379,195314,1,6,65457,74,201,0.9995905708465971,0.998058192892986,0.9987830478566431,0.9988237941332897,0.9982404602344013,195314,80,65658,380
10,7,giraffe,Single-stranded,125,0.6,180213,348,180213,1,6,60353,65,180,0.9996061769208582,0.9980671459110998,0.9988284601676457,0.9988360685721887,0.9982584609770864,180213,71,60533,349
10,7,safari,Single-stranded,125,0.6,180213,348,180213,1,6,60353,65,180,0.9996061769208582,0.9980671459110998,0.9988284601676457,0.9988360685721887,0.9982584609770864,180213,71,60533,349
10,7,giraffe,Single-stranded,125,0.75,225115,450,225115,1,8,75406,86,234,0.9995826099312194,0.9980005851945772,0.9987588137428368,0.9987909711053187,0.9981911715897777,225115,94,75640,451
10,7,safari,Single-stranded,125,0.75,225115,450,225115,1,8,75406,86,234,0.9995826099312194,0.9980005851945772,0.9987588137428368,0.9987909711053187,0.9981911715897777,225115,94,75640,451
10,7,giraffe,Single-stranded,125,0.7,210296,413,210296,1,6,70484,81,216,0.9995864684884235,0.9980352142755445,0.9987709607696328,0.9988102390683292,0.9982202297004942,210296,87,70700,414
10,7,safari,Single-stranded,125,0.7,210296,413,210296,1,6,70484,81,216,0.9995864684884235,0.9980352142755445,0.9987709607696328,0.9988102390683292,0.9982202297004942,210296,87,70700,414
10,7,giraffe,Single-stranded,125,0.85,255143,499,255143,1,8,85284,103,270,0.9995651390379778,0.998044147502572,0.9987042549465943,0.9988040642242958,0.9982098280731773,255143,111,85554,500
10,7,safari,Single-stranded,125,0.85,255143,499,255143,1,8,85284,103,270,0.9995651390379778,0.998044147502572,0.9987042549465943,0.9988040642242958,0.9982098280731773,255143,111,85554,500
10,7,giraffe,Single-stranded,125,0.8,240000,470,240000,1,8,80292,92,252,0.9995835068721366,0.9980413438626695,0.9987599821437428,0.9988118300937843,0.9982218208430002,240000,100,80544,471
10,7,safari,Single-stranded,125,0.8,240000,470,240000,1,8,80292,92,252,0.9995835068721366,0.9980413438626695,0.9987599821437428,0.9988118300937843,0.9982218208430002,240000,100,80544,471
10,7,giraffe,Single-stranded,125,0.95,285027,554,285027,1,9,95210,109,296,0.9995861754545933,0.9980566002058954,0.998766000167322,0.9988208022399502,0.9982345503481057,285027,118,95506,555
10,7,safari,Single-stranded,125,0.95,285027,554,285027,1,9,95210,109,296,0.9995861754545933,0.9980566002058954,0.998766000167322,0.9988208022399502,0.9982345503481057,285027,118,95506,555
10,7,giraffe,Single-stranded,125,0.9,270010,530,270010,1,8,90231,107,283,0.9995742711707543,0.9980372660705771,0.998731090489799,0.9988051773183444,0.9982113686075809,270010,115,90514,531
10,7,safari,Single-stranded,125,0.9,270010,530,270010,1,8,90231,107,283,0.9995742711707543,0.9980372660705771,0.998731090489799,0.9988051773183444,0.9982113686075809,270010,115,90514,531
11,6,giraffe,High,125,0.15,44652,92,44652,216,0,14956,11,49,0.9997537111255401,0.9931494661921708,0.9992674480554076,0.9964406458163642,0.9946812058156596,44652,11,15005,308
11,6,safari,High,125,0.15,44681,92,44681,187,0,14956,11,49,0.9997538709388705,0.9937944839857651,0.9992674480554076,0.9967652701557131,0.9951647325596905,44681,11,15005,279
11,6,giraffe,High,125,0.1,29759,57,29759,138,0,10014,7,26,0.9997648323590674,0.9934900180276424,0.9993032746093361,0.9966175485599464,0.9949501262468439,29759,7,10040,195
11,6,safari,High,125,0.1,29777,57,29777,120,0,10014,7,26,0.9997649744829439,0.9940909394404754,0.9993032746093361,0.9969198834912452,0.9954001149971251,29777,7,10040,177
11,6,giraffe,High,125,0.25,74494,157,74494,348,2,24984,19,89,0.9997181775481446,0.9932665768876918,0.9991631465689009,0.9964819348020921,0.994744887254853,74494,21,25073,505
11,6,safari,High,125,0.25,74549,157,74549,293,2,24984,19,89,0.9997183854096822,0.9939999199989333,0.9991631465689009,0.9968509517346509,0.995294376230106,74549,21,25073,450
11,6,giraffe,High,125,0.2,59598,124,59598,270,1,19909,14,71,0.9997483770318555,0.9934324576610215,0.9992498124531133,0.996580410517955,0.9948866690837261,59598,15,19980,394
11,6,safari,High,125,0.2,59642,124,59642,226,1,19909,14,71,0.9997485626162897,0.9941658887851713,0.9992498124531133,0.9969494103586323,0.9954367584732519,59642,15,19980,350
11,6,giraffe,High,125,0.35,104271,216,104271,457,4,35006,29,120,0.9996836171191901,0.9935870559536515,0.9990614067521829,0.9966260131518582,0.9949608502316153,104271,33,35126,673
11,6,safari,High,125,0.35,104333,216,104333,395,4,35006,29,120,0.9996838050706168,0.9941778472328099,0.9990614067521829,0.9969232239262338,0.9954033817976774,104333,33,35126,611
11,6,giraffe,High,125,0.3,89210,191,89210,398,2,29883,25,109,0.9996974349204926,0.9934409069143308,0.9991005696392284,0.9965593511919391,0.9948588692850824,89210,27,29992,589
11,6,safari,High,125,0.3,89263,191,89263,345,2,29883,25,109,0.9996976145145033,0.9940311139322264,0.9991005696392284,0.9968563116662665,0.9953012068303594,89263,27,29992,536
11,6,giraffe,High,125,0.45,134477,276,134477,591,4,45251,39,146,0.9996803449301219,0.99359410095756,0.9990536971830986,0.9966279311060386,0.9949663687051952,134477,43,45397,867
11,6,safari,High,125,0.45,134566,276,134566,502,4,45251,39,146,0.999680556277812,0.994251684596288,0.9990536971830986,0.9969587298529744,0.995458668908753,134566,43,45397,778
11,6,giraffe,High,125,0.4,119185,243,119185,515,4,40038,34,131,0.9996812695536935,0.9936803314907915,0.9990548909393887,0.9966717677261818,0.9950296596940369,119185,38,40169,758
11,6,safari,High,125,0.4,119259,243,119259,441,4,40038,34,131,0.9996814672623787,0.9942972912133263,0.9990548909393887,0.9969821100150476,0.9954917265064003,119259,38,40169,684
11,6,giraffe,High,125,0.55,164381,333,164381,719,4,55334,49,175,0.9996776822311687,0.9936409301650819,0.9990461106511644,0.9966501650665268,0.9949998868752686,164381,53,55509,1052
11,6,safari,High,125,0.55,164488,333,164488,612,4,55334,49,175,0.9996778918324308,0.9942877176863141,0.9990461106511644,0.9969755192833374,0.9954840607253558,164488,53,55509,945
11,6,giraffe,High,125,0.5,149499,302,149499,662,4,50377,46,163,0.9996656614220089,0.9935931092693885,0.9990116623838703,0.9966201351945922,0.9949565537445351,149499,50,50540,964
11,6,safari,High,125,0.5,149602,302,149602,559,4,50377,46,163,0.9996658915350279,0.9942776629470368,0.9990116623838703,0.9969644969428386,0.9954688564706818,149602,50,50540,861
11,6,giraffe,High,125,0.65,194449,398,194449,846,4,65458,57,218,0.9996863914451699,0.9936431042500242,0.9990720598749563,0.9966555869637086,0.995008223998776,194449,61,65676,1244
11,6,safari,High,125,0.65,194575,398,194575,720,4,65458,58,217,0.9996814583044333,0.994286969896726,0.9990568477417588,0.9969769169676941,0.9954863634624947,194575,62,65675,1118
11,6,giraffe,High,125,0.6,179405,372,179405,784,4,60354,50,195,0.9996990956151545,0.9935977315145574,0.9991089550022276,0.9966390756069108,0.9949826673964605,179405,54,60549,1156
11,6,safari,High,125,0.6,179518,372,179518,671,4,60354,51,194,0.9996937178751817,0.994223558797304,0.9990924541689356,0.9969511348553594,0.9954470816539782,179518,55,60548,1043
11,6,giraffe,High,125,0.75,224151,448,224151,968,4,75409,65,255,0.9996922665239497,0.9937224860019418,0.9990889044406005,0.9966984372603033,0.9950713574510455,224151,69,75664,1416
11,6,safari,High,125,0.75,224294,448,224294,825,4,75409,66,254,0.9996880069886435,0.9943564439833841,0.999075700157131,0.9970150978705624,0.9955426485230667,224294,70,75663,1273
11,6,giraffe,High,125,0.7,209379,419,209379,913,4,70485,61,236,0.9996896545138557,0.9936785454959637,0.9990817393269855,0.9966750365936381,0.9950372472886034,209379,65,70721,1332
11,6,safari,High,125,0.7,209518,419,209518,774,4,70485,62,235,0.9996850904649209,0.9943382167993128,0.9990676122397084,0.9970044849450981,0.9955274834190062,209518,66,70720,1193
11,6,giraffe,High,125,0.85,254042,511,254042,1093,5,85282,81,292,0.9996615878612353,0.9937256988178966,0.998996030819519,0.99668480542358,0.9950484316126877,254042,86,85574,1604
11,6,safari,High,125,0.85,254196,511,254196,939,5,85282,82,291,0.9996578615164994,0.994328094317924,0.9989843567592809,0.9969858548935243,0.9954967096974563,254196,87,85573,1450
11,6,giraffe,High,125,0.8,238974,475,238974,1025,5,80292,70,274,0.9996862567925404,0.9937623194191472,0.9990699520095236,0.9967154860142267,0.9950952151098517,238974,75,80566,1500
11,6,safari,High,125,0.8,239117,475,239117,882,5,80292,71,273,0.9996822649492251,0.9943569783011885,0.9990575513696507,0.9970125107626749,0.9955374242872491,239117,76,80565,1357
11,6,giraffe,High,125,0.95,283784,583,283784,1219,6,95209,86,319,0.9996759148360552,0.9936901668849313,0.9990378581886634,0.9966740537560014,0.9950315577404343,283784,92,95528,1802
11,6,safari,High,125,0.95,283951,583,283951,1052,6,95209,87,318,0.99967258593739,0.9942749294433201,0.9990274001254967,0.9969664519073784,0.9954670178328777,283951,93,95527,1635
11,6,giraffe,High,125,0.9,268841,552,268841,1152,5,90230,84,306,0.9996690588629011,0.9937016023212405,0.9990179310344828,0.9966763983502479,0.9950355788133012,268841,89,90536,1704
11,6,safari,High,125,0.9,268997,552,268997,996,5,90230,85,305,0.9996655356817683,0.9942782161932395,0.9990068965517241,0.9969645980964805,0.995464739596312,268997,90,90535,1548
11,6,giraffe,Mid,125,0.15,44871,86,44871,2,3,14953,17,50,0.9995544763983872,0.9980426610912164,0.9986687079810956,0.9987979966611019,0.9981994598379513,44871,20,15003,88
11,6,safari,Mid,125,0.15,44871,86,44871,2,3,14953,17,50,0.9995544763983872,0.9980426610912164,0.9986687079810956,0.9987979966611019,0.9981994598379513,44871,20,15003,88
11,6,giraffe,Mid,125,0.1,29892,61,29892,0,0,10014,13,33,0.9995652900852701,0.9979634761125764,0.9987077534791252,0.9987637408533531,0.9981506010546572,29892,13,10047,61
11,6,safari,Mid,125,0.1,29892,61,29892,0,0,10014,13,33,0.9995652900852701,0.9979634761125764,0.9987077534791252,0.9987637408533531,0.9981506010546572,29892,13,10047,61
11,6,giraffe,Mid,125,0.25,74845,150,74845,2,4,24982,30,83,0.999545934107026,0.9979732522634238,0.9986453643571457,0.9987589740852437,0.998141783887468,74845,34,25065,152
11,6,safari,Mid,125,0.25,74845,150,74845,2,4,24982,30,83,0.999545934107026,0.9979732522634238,0.9986453643571457,0.9987589740852437,0.998141783887468,74845,34,25065,152
11,6,giraffe,Mid,125,0.2,59874,114,59874,2,3,19907,24,67,0.9995492562728502,0.9980663443907318,0.9986500674966252,0.9988072499186761,0.9982122988836244,59874,27,19974,116
11,6,safari,Mid,125,0.2,59874,114,59874,2,3,19907,24,67,0.9995492562728502,0.9980663443907318,0.9986500674966252,0.9988072499186761,0.9982122988836244,59874,27,19974,116
11,6,giraffe,Mid,125,0.35,104741,200,104741,2,6,35004,38,116,0.9995800925705015,0.9980751455552062,0.9987487202821067,0.9988270521818737,0.9982441990764201,104741,44,35120,202
11,6,safari,Mid,125,0.35,104741,200,104741,2,6,35004,38,116,0.9995800925705015,0.9980751455552062,0.9987487202821067,0.9988270521818737,0.9982441990764201,104741,44,35120,202
11,6,giraffe,Mid,125,0.3,89615,180,89615,2,4,29881,36,101,0.9995538452958563,0.997973206231834,0.9986676437279328,0.9987629003856184,0.9981472053680969,89615,40,29982,182
11,6,safari,Mid,125,0.3,89615,180,89615,2,4,29881,36,101,0.9995538452958563,0.997973206231834,0.9986676437279328,0.9987629003856184,0.9981472053680969,89615,40,29982,182
11,6,giraffe,Mid,125,0.45,135071,269,135071,2,7,45250,48,148,0.99959297248494,0.9979976651741514,0.9987899588586012,0.9987946818107872,0.9981968527890704,135071,55,45398,271
11,6,safari,Mid,125,0.45,135071,269,135071,2,7,45250,48,148,0.99959297248494,0.9979976651741514,0.9987899588586012,0.9987946818107872,0.9981968527890704,135071,55,45398,271
11,6,giraffe,Mid,125,0.4,119703,236,119703,2,7,40035,42,132,0.999590821030129,0.9980156910480986,0.9987815794708573,0.9988026350373185,0.9982080083917656,119703,49,40167,238
11,6,safari,Mid,125,0.4,119703,236,119703,2,7,40035,42,132,0.999590821030129,0.9980156910480986,0.9987815794708573,0.9988026350373185,0.9982080083917656,119703,49,40167,238
11,6,giraffe,Mid,125,0.55,165095,332,165095,4,7,55333,61,178,0.9995882855118883,0.997968941734016,0.9987765163101171,0.9987779572527027,0.9981720284150039,165095,68,55511,336
11,6,safari,Mid,125,0.55,165095,332,165095,4,7,55333,61,178,0.9995882855118883,0.997968941734016,0.9987765163101171,0.9987779572527027,0.9981720284150039,165095,68,55511,336
11,6,giraffe,Mid,125,0.5,150164,294,150164,3,7,50376,55,165,0.9995872884853487,0.9980260665554529,0.9987747761990395,0.9988060674388983,0.9982144988660328,150164,62,50541,297
11,6,safari,Mid,125,0.5,150164,294,150164,3,7,50376,55,165,0.9995872884853487,0.9980260665554529,0.9987747761990395,0.9988060674388983,0.9982144988660328,150164,62,50541,297
11,6,giraffe,Mid,125,0.65,195300,389,195300,4,7,65455,73,214,0.9995905415088545,0.9979917523876685,0.9987832514562959,0.9987905071431676,0.9981908033139282,195300,80,65669,393
11,6,safari,Mid,125,0.65,195300,389,195300,4,7,65455,73,214,0.9995905415088545,0.9979917523876685,0.9987832514562959,0.9987905071431676,0.9981908033139282,195300,80,65669,393
11,6,giraffe,Mid,125,0.6,180198,358,180198,4,7,60353,66,194,0.9995950541129743,0.9979951262738148,0.9987957769712966,0.9987944494791189,0.9981963678580313,180198,73,60547,362
11,6,safari,Mid,125,0.6,180198,358,180198,4,7,60353,66,194,0.9995950541129743,0.9979951262738148,0.9987957769712966,0.9987944494791189,0.9981963678580313,180198,73,60547,362
11,6,giraffe,Mid,125,0.75,225113,444,225113,5,7,75406,83,246,0.9996003605635804,0.9980094164797262,0.9988117556969713,0.9988042549887414,0.9982111090460133,225113,90,75652,449
11,6,safari,Mid,125,0.75,225113,444,225113,5,7,75406,83,246,0.9996003605635804,0.9980094164797262,0.9988117556969713,0.9988042549887414,0.9982111090460133,225113,90,75652,449
11,6,giraffe,Mid,125,0.7,210279,422,210279,5,7,70482,77,229,0.9996006902354502,0.9979734796351314,0.9988134755279328,0.9987864221778379,0.9981847311377224,210279,84,70711,427
11,6,safari,Mid,125,0.7,210279,422,210279,5,7,70482,77,229,0.9996006902354502,0.9979734796351314,0.9988134755279328,0.9987864221778379,0.9981847311377224,210279,84,70711,427
11,6,giraffe,Mid,125,0.85,255137,496,255137,5,8,85279,90,272,0.9996160401198895,0.9980401974667303,0.9988557951639833,0.9988274972449122,0.9982448789435284,255137,98,85551,501
11,6,safari,Mid,125,0.85,255137,496,255137,5,8,85279,90,272,0.9996160401198895,0.9980401974667303,0.9988557951639833,0.9988274972449122,0.9982448789435284,255137,98,85551,501
11,6,giraffe,Mid,125,0.8,239996,467,239996,5,8,80289,85,263,0.9996126436446484,0.9980371608696376,0.9988467976935954,0.9988242809906006,0.9982404947790965,239996,93,80552,472
11,6,safari,Mid,125,0.8,239996,467,239996,5,8,80289,85,263,0.9996126436446484,0.9980371608696376,0.9988467976935954,0.9988242809906006,0.9982404947790965,239996,93,80552,472
11,6,giraffe,Mid,125,0.95,285017,555,285017,5,8,95205,97,304,0.999631736589951,0.9980390577672572,0.9989018344593887,0.9988347622827445,0.9982554677313997,285017,105,95509,560
11,6,safari,Mid,125,0.95,285017,555,285017,5,8,95205,97,304,0.999631736589951,0.9980390577672572,0.9989018344593887,0.9988347622827445,0.9982554677313997,285017,105,95509,560
11,6,giraffe,Mid,125,0.9,270000,531,270000,5,8,90227,94,289,0.9996223648843771,0.9980187479669989,0.9988743958154009,0.9988199127697276,0.9982334405821339,270000,102,90516,536
11,6,safari,Mid,125,0.9,270000,531,270000,5,8,90227,94,289,0.9996223648843771,0.9980187479669989,0.9988743958154009,0.9988199127697276,0.9982334405821339,270000,102,90516,536
11,6,giraffe,None,125,0.15,44879,82,44879,0,0,14958,17,43,0.9996213471133286,0.9981761971486399,0.9988680250366228,0.9988982494407781,0.9983494222978042,44879,17,15001,82
11,6,safari,None,125,0.15,44879,82,44879,0,0,14958,17,43,0.9996213471133286,0.9981761971486399,0.9988680250366228,0.9988982494407781,0.9983494222978042,44879,17,15001,82
11,6,giraffe,None,125,0.1,29905,50,29905,0,0,10014,10,23,0.999665719538693,0.9983308295776999,0.9990046780133374,0.9989978286286956,0.9985000749962502,29905,10,10037,50
11,6,safari,None,125,0.1,29905,50,29905,0,0,10014,10,23,0.999665719538693,0.9983308295776999,0.9990046780133374,0.9989978286286956,0.9985000749962502,29905,10,10037,50
11,6,giraffe,None,125,0.25,74863,137,74863,0,0,24988,27,81,0.9996394712244625,0.9981733333333334,0.998924131335671,0.998905864300487,0.9983615728900256,74863,27,25069,137
11,6,safari,None,125,0.25,74863,137,74863,0,0,24988,27,81,0.9996394712244625,0.9981733333333334,0.998924131335671,0.998905864300487,0.9983615728900256,74863,27,25069,137
11,6,giraffe,None,125,0.2,59885,108,59885,0,0,19912,22,63,0.9996327641177158,0.9981997899754972,0.9988998349752463,0.9989157631359467,0.9983747968496062,59885,22,19975,108
11,6,safari,None,125,0.2,59885,108,59885,0,0,19912,22,63,0.9996327641177158,0.9981997899754972,0.9988998349752463,0.9989157631359467,0.9983747968496062,59885,22,19975,108
11,6,giraffe,None,125,0.35,104751,195,104751,0,1,35011,40,109,0.9996087487594473,0.9981419015493682,0.9988339353260715,0.998874786638568,0.9983155730977039,104751,41,35120,195
11,6,safari,None,125,0.35,104751,195,104751,0,1,35011,40,109,0.9996087487594473,0.9981419015493682,0.9988339353260715,0.998874786638568,0.9983155730977039,104751,41,35120,195
11,6,giraffe,None,125,0.3,89632,168,89632,0,0,29887,34,100,0.9996208150246471,0.9981291759465479,0.9988674594450552,0.9988744386123277,0.9983141519433154,89632,34,29987,168
11,6,safari,None,125,0.3,89632,168,89632,0,0,29887,34,100,0.9996208150246471,0.9981291759465479,0.9988674594450552,0.9988744386123277,0.9983141519433154,89632,34,29987,168
11,6,giraffe,None,125,0.45,135088,258,135088,0,3,45254,50,135,0.9996078170207413,0.9980937744743102,0.9988336780951542,0.9988502220069726,0.9982797530809567,135088,53,45389,258
11,6,safari,None,125,0.45,135088,258,135088,0,3,45254,50,135,0.9996078170207413,0.9980937744743102,0.9988336780951542,0.9988502220069726,0.9982797530809567,135088,53,45389,258
11,6,giraffe,None,125,0.4,119726,219,119726,0,2,40042,45,120,0.9996075910263582,0.9981741631581141,0.9988311074635032,0.9988903628430071,0.9983390986175806,119726,47,40162,219
11,6,safari,None,125,0.4,119726,219,119726,0,2,40042,45,120,0.9996075910263582,0.9981741631581141,0.9988311074635032,0.9988903628430071,0.9983390986175806,119726,47,40162,219
11,6,giraffe,None,125,0.55,165117,318,165117,0,3,55337,63,161,0.9996004431448757,0.9980777949043431,0.9988121805485566,0.998838538736548,0.9982624355766315,165117,66,55498,318
11,6,safari,None,125,0.55,165117,318,165117,0,3,55337,63,161,0.9996004431448757,0.9980777949043431,0.9988121805485566,0.998838538736548,0.9982624355766315,165117,66,55498,318
11,6,giraffe,None,125,0.5,150179,286,150179,0,3,50380,59,150,0.9995873296902976,0.9980992257335592,0.9987745098039216,0.9988427234574634,0.9982691475551709,150179,62,50530,286
11,6,safari,None,125,0.5,150179,286,150179,0,3,50380,59,150,0.9995873296902976,0.9980992257335592,0.9987745098039216,0.9988427234574634,0.9982691475551709,150179,62,50530,286
11,6,giraffe,None,125,0.65,195306,389,195306,0,3,65461,75,200,0.9996007861442083,0.9980122128822914,0.998813489709305,0.998805867868129,0.9982136982947895,195306,78,65661,389
11,6,safari,None,125,0.65,195306,389,195306,0,3,65461,75,200,0.9996007861442083,0.9980122128822914,0.998813489709305,0.998805867868129,0.9982136982947895,195306,78,65661,389
11,6,giraffe,None,125,0.6,180211,352,180211,0,3,60357,67,178,0.9996117172636052,0.998050541916118,0.9988449797871463,0.998830519559699,0.9982501824454322,180211,70,60535,352
11,6,safari,None,125,0.6,180211,352,180211,0,3,60357,67,178,0.9996117172636052,0.998050541916118,0.9988449797871463,0.998830519559699,0.9982501824454322,180211,70,60535,352
11,6,giraffe,None,125,0.75,225134,433,225134,0,3,75412,84,236,0.9996137127532513,0.9980803929652831,0.9988512576747871,0.9988464644134272,0.9982741568260416,225134,87,75648,433
11,6,safari,None,125,0.75,225134,433,225134,0,3,75412,84,236,0.9996137127532513,0.9980803929652831,0.9988512576747871,0.9988464644134272,0.9982741568260416,225134,87,75648,433
11,6,giraffe,None,125,0.7,210297,414,210297,0,3,70488,80,217,0.9996054758056849,0.9980352236000968,0.9988274848844437,0.9988197325518711,0.998234451987396,210297,83,70705,414
11,6,safari,None,125,0.7,210297,414,210297,0,3,70488,80,217,0.9996054758056849,0.9980352236000968,0.9988274848844437,0.9988197325518711,0.998234451987396,210297,83,70705,414
11,6,giraffe,None,125,0.85,255159,485,255159,0,4,85287,101,272,0.9995886611508086,0.9981028304986622,0.998774280911468,0.9988451932637579,0.9982713560772088,255159,105,85559,485
11,6,safari,None,125,0.85,255159,485,255159,0,4,85287,101,272,0.9995886611508086,0.9981028304986622,0.998774280911468,0.9988451932637579,0.9982713560772088,255159,105,85559,485
11,6,giraffe,None,125,0.8,240015,457,240015,0,3,80296,90,254,0.9996126742965665,0.9980995708440068,0.9988467690934117,0.9988555495443007,0.9982872179748689,240015,93,80550,457
11,6,safari,None,125,0.8,240015,457,240015,0,3,80296,90,254,0.9996126742965665,0.9980995708440068,0.9988467690934117,0.9988555495443007,0.9982872179748689,240015,93,80550,457
11,6,giraffe,None,125,0.95,285032,552,285032,0,5,95213,105,300,0.9996142272972764,0.9980671186060843,0.9988496491429886,0.9988400738708242,0.9982634106928782,285032,110,95513,552
11,6,safari,None,125,0.95,285032,552,285032,0,5,95213,105,300,0.9996142272972764,0.9980671186060843,0.9988496491429886,0.9988400738708242,0.9982634106928782,285032,110,95513,552
11,6,giraffe,None,125,0.9,270021,522,270021,0,4,90234,104,286,0.9996001910198461,0.9980705470110112,0.9988083153109414,0.9988347833806819,0.9982556739051585,270021,108,90520,522
11,6,safari,None,125,0.9,270021,522,270021,0,4,90234,104,286,0.9996001910198461,0.9980705470110112,0.9988083153109414,0.9988347833806819,0.9982556739051585,270021,108,90520,522
11,6,giraffe,Single-stranded,125,0.15,44867,94,44867,0,0,14958,17,43,0.999621245878264,0.9979092991703922,0.9988680250366228,0.998764538928154,0.9981493522732956,44867,17,15001,94
11,6,safari,Single-stranded,125,0.15,44867,94,44867,0,0,14958,17,43,0.999621245878264,0.9979092991703922,0.9988680250366228,0.998764538928154,0.9981493522732956,44867,17,15001,94
11,6,giraffe,Single-stranded,125,0.1,29888,67,29888,0,0,10014,10,23,0.9996655294668539,0.9977633116341178,0.9990046780133374,0.9987135147778724,0.9980750962451878,29888,10,10037,67
11,6,safari,Single-stranded,125,0.1,29888,67,29888,0,0,10014,10,23,0.9996655294668539,0.9977633116341178,0.9990046780133374,0.9987135147778724,0.9980750962451878,29888,10,10037,67
11,6,giraffe,Single-stranded,125,0.25,74846,154,74846,0,0,24987,27,81,0.9996393893659931,0.9979466666666666,0.9989240884638374,0.9987923108231636,0.9981917178680254,74846,27,25068,154
11,6,safari,Single-stranded,125,0.25,74846,154,74846,0,0,24987,27,81,0.9996393893659931,0.9979466666666666,0.9989240884638374,0.9987923108231636,0.9981917178680254,74846,27,25068,154
11,6,giraffe,Single-stranded,125,0.2,59882,111,59882,0,0,19911,22,63,0.9996327457264957,0.9981497841414831,0.9988997799559912,0.9988907145299716,0.998337271374814,59882,22,19974,111
11,6,safari,Single-stranded,125,0.2,59882,111,59882,0,0,19911,22,63,0.9996327457264957,0.9981497841414831,0.9988997799559912,0.9988907145299716,0.998337271374814,59882,22,19974,111
11,6,giraffe,Single-stranded,125,0.35,104737,209,104737,0,2,35008,39,110,0.999608696482086,0.9980084996093229,0.9988338689951364,0.9988079571246018,0.9982156239962885,104737,41,35118,209
11,6,safari,Single-stranded,125,0.35,104737,209,104737,0,2,35008,39,110,0.999608696482086,0.9980084996093229,0.9988338689951364,0.9988079571246018,0.9982156239962885,104737,41,35118,209
11,6,giraffe,Single-stranded,125,0.3,89613,187,89613,0,0,29885,34,100,0.9996207346592747,0.9979175946547885,0.9988673839901395,0.9987684385918962,0.9981555512898622,89613,34,29985,187
11,6,safari,Single-stranded,125,0.3,89613,187,89613,0,0,29885,34,100,0.9996207346592747,0.9979175946547885,0.9988673839901395,0.9987684385918962,0.9981555512898622,89613,34,29985,187
11,6,giraffe,Single-stranded,125,0.45,135092,254,135092,0,3,45252,49,136,0.9996152252412241,0.9981233283584295,0.998855633802817,0.9988687197308588,0.9983073910590422,135092,52,45388,254
11,6,safari,Single-stranded,125,0.45,135092,254,135092,0,3,45252,49,136,0.9996152252412241,0.9981233283584295,0.998855633802817,0.9988687197308588,0.9983073910590422,135092,52,45388,254
11,6,giraffe,Single-stranded,125,0.4,119711,234,119711,0,3,40039,44,121,0.9996075418761169,0.9980491058401767,0.9988310493197702,0.9988277159651736,0.9982454168539887,119711,47,40160,234
11,6,safari,Single-stranded,125,0.4,119711,234,119711,0,3,40039,44,121,0.9996075418761169,0.9980491058401767,0.9988310493197702,0.9988277159651736,0.9982454168539887,119711,47,40160,234
11,6,giraffe,Single-stranded,125,0.55,165115,318,165115,0,3,55336,62,162,0.9996064898898172,0.9980777716658707,0.9988301567589943,0.9988415458557287,0.998266936958135,165115,65,55498,318
11,6,safari,Single-stranded,125,0.55,165115,318,165115,0,3,55336,62,162,0.9996064898898172,0.9980777716658707,0.9988301567589943,0.9988415458557287,0.998266936958135,165115,65,55498,318
11,6,giraffe,Single-stranded,125,0.5,150182,283,150182,0,3,50378,58,151,0.9995939910678034,0.9981191639251653,0.9987942281083219,0.9988560330952285,0.9982890253910621,150182,61,50529,283
11,6,safari,Single-stranded,125,0.5,150182,283,150182,0,3,50378,58,151,0.9995939910678034,0.9981191639251653,0.9987942281083219,0.9988560330952285,0.9982890253910621,150182,61,50529,283
11,6,giraffe,Single-stranded,125,0.65,195315,379,195315,0,4,65459,74,201,0.999600804532404,0.9980633029116887,0.9988134716602269,0.9988314620532005,0.9982519354937421,195315,78,65660,379
11,6,safari,Single-stranded,125,0.65,195315,379,195315,0,4,65459,74,201,0.999600804532404,0.9980633029116887,0.9988134716602269,0.9988314620532005,0.9982519354937421,195315,78,65660,379
11,6,giraffe,Single-stranded,125,0.6,180214,348,180214,0,3,60356,66,179,0.9996172684057842,0.9980726841749649,0.9988614612896839,0.9988443791655697,0.9982709005415357,180214,69,60535,348
11,6,safari,Single-stranded,125,0.6,180214,348,180214,0,3,60356,66,179,0.9996172684057842,0.9980726841749649,0.9988614612896839,0.9988443791655697,0.9982709005415357,180214,69,60535,348
11,6,giraffe,Single-stranded,125,0.75,225116,450,225116,0,4,75410,83,237,0.9996136818781277,0.9980050184868287,0.9988512425066681,0.9988087024617931,0.998217723199469,225116,87,75647,450
11,6,safari,Single-stranded,125,0.75,225116,450,225116,0,4,75410,83,237,0.9996136818781277,0.9980050184868287,0.9988512425066681,0.9988087024617931,0.998217723199469,225116,87,75647,450
11,6,giraffe,Single-stranded,125,0.7,210297,413,210297,0,4,70486,79,218,0.9996054758056849,0.9980399601347824,0.9988274683204543,0.9988221045382222,0.998237991879132,210297,83,70704,413
11,6,safari,Single-stranded,125,0.7,210297,413,210297,0,4,70486,79,218,0.9996054758056849,0.9980399601347824,0.9988274683204543,0.9988221045382222,0.998237991879132,210297,83,70704,413
11,6,giraffe,Single-stranded,125,0.85,255144,499,255144,0,4,85288,100,273,0.9995925531248041,0.9980480592075668,0.9987859685986109,0.9988197090964609,0.9982332673128084,255144,104,85561,499
11,6,safari,Single-stranded,125,0.85,255144,499,255144,0,4,85288,100,273,0.9995925531248041,0.9980480592075668,0.9987859685986109,0.9988197090964609,0.9982332673128084,255144,104,85561,499
11,6,giraffe,Single-stranded,125,0.8,240001,470,240001,0,4,80296,89,255,0.999612651711413,0.9980455023682689,0.9988467833936808,0.9988284623307983,0.998246734036093,240001,93,80551,470
11,6,safari,Single-stranded,125,0.8,240001,470,240001,0,4,80296,89,255,0.999612651711413,0.9980455023682689,0.9988467833936808,0.9988284623307983,0.998246734036093,240001,93,80551,470
11,6,giraffe,Single-stranded,125,0.95,285028,554,285028,0,5,95214,104,301,0.9996177276186535,0.998060101827146,0.9988601187986279,0.9988383074682988,0.9982607828837952,285028,109,95515,554
11,6,safari,Single-stranded,125,0.95,285028,554,285028,0,5,95214,104,301,0.9996177276186535,0.998060101827146,0.9988601187986279,0.9988383074682988,0.9982607828837952,285028,109,95515,554
11,6,giraffe,Single-stranded,125,0.9,270011,530,270011,0,4,90235,103,287,0.9996038768242027,0.998040962367996,0.9988193624557261,0.9988218082007329,0.998236287620788,270011,107,90522,530
11,6,safari,Single-stranded,125,0.9,270011,530,270011,0,4,90235,103,287,0.9996038768242027,0.998040962367996,0.9988193624557261,0.9988218082007329,0.998236287620788,270011,107,90522,530
12,3,giraffe,High,125,0.15,44733,92,44733,135,0,14956,11,49,0.9997541569819417,0.9949510676156583,0.9992674480554076,0.9973468295728172,0.996031746031746,44733,11,15005,227
12,3,safari,High,125,0.15,44769,92,44769,99,0,14956,11,49,0.9997543546225994,0.9957517793594306,0.9992674480554076,0.9977490528192556,0.9966319861277845,44769,11,15005,191
12,3,giraffe,High,125,0.1,29813,57,29813,84,0,10014,7,26,0.9997652582159624,0.9952927822661414,0.9993032746093361,0.9975240070933852,0.9963000924976876,29813,7,10040,141
12,3,safari,High,125,0.1,29834,57,29834,63,0,10014,7,26,0.9997654234107436,0.9959938572477799,0.9993032746093361,0.997876076595033,0.9968250793730157,29834,7,10040,120
12,3,giraffe,High,125,0.25,74626,157,74626,216,1,24985,20,88,0.9997186759012419,0.9950266003546714,0.9991631465689009,0.9973671197359101,0.9960636607954603,74626,21,25073,373
12,3,safari,High,125,0.25,74679,157,74679,163,1,24985,21,87,0.9997054925636872,0.9957332764436859,0.9991232964055152,0.9977154308617234,0.9965831776447903,74679,22,25072,320
12,3,giraffe,High,125,0.2,59701,124,59701,167,0,19910,15,70,0.9997488110389176,0.9951493532470996,0.9992498124531133,0.9974437798643365,0.9961743783364797,59701,15,19980,291
12,3,safari,High,125,0.2,59749,124,59749,119,0,19910,16,69,0.9997322847820631,0.9959494599279904,0.9991997999499875,0.9978372871731925,0.9967619738207458,59749,16,19979,243
12,3,giraffe,High,125,0.35,104429,215,104429,300,2,35008,31,118,0.9996840956520074,0.9950926208263455,0.9990614067521829,0.9973830740284424,0.9960885919644833,104429,33,35126,515
12,3,safari,High,125,0.35,104509,215,104509,220,2,35008,32,117,0.9996747749729776,0.9958549321542918,0.9990329645325521,0.9977611975922133,0.9966524628309172,104509,34,35125,435
12,3,giraffe,High,125,0.3,89351,191,89351,257,1,29884,26,108,0.9996979122379109,0.9950110803015624,0.9991005696392284,0.9973489901047567,0.9960356540753477,89351,27,29992,448
12,3,safari,High,125,0.3,89416,191,89416,192,1,29884,27,107,0.9996869549662358,0.9957349190970947,0.9990672574036443,0.9977070234262985,0.9965697975262482,89416,28,29991,383
12,3,giraffe,High,125,0.45,134671,276,134671,397,2,45253,41,144,0.999680805261517,0.9950274855183828,0.9990536971830986,0.9973487176828681,0.996039472519692,134671,43,45397,673
12,3,safari,High,125,0.45,134779,276,134779,289,2,45253,42,143,0.999673646187965,0.9958254521811088,0.999031690140845,0.9977458386849615,0.9966313390565537,134779,44,45396,565
12,3,giraffe,High,125,0.4,119351,243,119351,349,2,40040,36,129,0.9996817127206024,0.9950643222197211,0.9990548909393887,0.9973676733575118,0.996066187948798,119351,38,40169,592
12,3,safari,High,125,0.4,119446,243,119446,254,2,40040,37,128,0.9996735991965519,0.995856365106759,0.99903001964832,0.9977613311726281,0.9966531376834218,119446,39,40168,497
12,3,giraffe,High,125,0.55,164604,333,164604,496,2,55336,53,171,0.9996659763511256,0.994988907896248,0.9990101148266801,0.997321958726658,0.9959999095002149,164604,55,55507,829
12,3,safari,High,125,0.55,164743,333,164743,357,2,55336,54,170,0.9996601921128162,0.9958291271995309,0.9989921169144379,0.9977409820974346,0.9966243580171497,164743,56,55506,690
12,3,giraffe,High,125,0.5,149710,302,149710,451,2,50379,49,160,0.9996594574021274,0.994995447385736,0.9989918956315478,0.9973219995736515,0.9960010544483295,149710,51,50539,753
12,3,safari,High,125,0.5,149842,302,149842,319,2,50379,50,159,0.9996530881823155,0.9958727394774796,0.9989721288792252,0.9977593330603249,0.9966526239349823,149842,52,50538,621
12,3,giraffe,High,125,0.65,194704,398,194704,591,2,65460,61,214,0.9996765365796054,0.994946165677873,0.9990416356085614,0.9973057419453977,0.9959759782733427,194704,63,65674,989
12,3,safari,High,125,0.65,194870,398,194870,425,2,65460,62,213,0.9996716837493715,0.9957944331171784,0.999026423475364,0.9977292916260267,0.9966071223654516,194870,64,65673,823
12,3,giraffe,High,125,0.6,179645,372,179645,544,2,60356,54,191,0.9996883712388913,0.9949269222035766,0.9990759533356435,0.9973019635709567,0.9959695476936856,179645,56,60547,916
12,3,safari,High,125,0.6,179795,372,179795,394,2,60356,55,190,0.9996830727487045,0.9957576663842136,0.9990594525023514,0.997716508561012,0.996587384518419,179795,57,60546,766
12,3,giraffe,High,125,0.75,224429,448,224429,690,2,75411,70,250,0.9996792887336805,0.9949549357840465,0.9990492915901918,0.9973115173707084,0.9959840690341852,224429,72,75661,1138
12,3,safari,High,125,0.75,224627,448,224627,492,2,75411,71,249,0.9996751223854028,0.9958327237583512,0.9990360873067223,0.9977502237561269,0.9966379024228343,224627,73,75660,940
12,3,giraffe,High,125,0.7,209650,419,209650,642,2,70487,66,231,0.9996757550615588,0.9949646672456588,0.9990393580651541,0.9973146476575117,0.9959893000635885,209650,68,70718,1061
12,3,safari,High,125,0.7,209830,419,209830,462,2,70487,67,230,0.9996712704681775,0.9958189178543123,0.999025230977877,0.9977413756211216,0.9966251860588212,209830,69,70717,881
12,3,giraffe,High,125,0.85,254351,511,254351,784,3,85284,86,287,0.9996502122307813,0.9949344014770425,0.9989610086388045,0.9972867320412636,0.9959449877822247,254351,89,85571,1295
12,3,safari,High,125,0.85,254552,511,254552,583,3,85284,88,285,0.9996426369466272,0.995720644954351,0.9989376605183283,0.9976777865092133,0.9965280422846361,254552,91,85569,1094
12,3,giraffe,High,125,0.8,239260,475,239260,739,3,80294,75,269,0.9996741010620963,0.9949516371832298,0.9990327500899047,0.9973072786841513,0.99597651931551,239260,78,80563,1214
12,3,safari,High,125,0.8,239469,475,239469,530,3,80294,76,268,0.9996702122330389,0.9958207540108286,0.9990203494500316,0.9977417701688672,0.9966242623359233,239469,79,80562,1005
12,3,giraffe,High,125,0.95,284128,583,284128,875,4,95211,91,314,0.9996657554103644,0.994894707723768,0.9990064839991634,0.9972745253233979,0.9959260872074417,284128,95,95525,1458
12,3,safari,High,125,0.95,284344,583,284344,659,4,95211,93,312,0.999658980245464,0.9956510473202468,0.99898556787283,0.9976509884619501,0.9964874634711941,284344,97,95523,1242
12,3,giraffe,High,125,0.9,269165,552,269165,828,3,90232,89,301,0.9996583190037771,0.9948991849784694,0.9989848275862069,0.9972730742012812,0.9959243569510203,269165,92,90533,1380
12,3,safari,High,125,0.9,269371,552,269371,622,3,90232,91,299,0.9996511606331063,0.9956606109889298,0.9989627586206896,0.9976518953352717,0.9964891879170473,269371,94,90531,1174
12,3,giraffe,Mid,125,0.15,44872,86,44872,1,3,14953,17,50,0.9995544863227301,0.9980649035788163,0.9986687079810956,0.9988091395755195,0.9982161315061185,44872,20,15003,87
12,3,safari,Mid,125,0.15,44872,86,44872,1,3,14953,17,50,0.9995544863227301,0.9980649035788163,0.9986687079810956,0.9988091395755195,0.9982161315061185,44872,20,15003,87
12,3,giraffe,Mid,125,0.1,29892,61,29892,0,0,10014,13,33,0.9995652900852701,0.9979634761125764,0.9987077534791252,0.9987637408533531,0.9981506010546572,29892,13,10047,61
12,3,safari,Mid,125,0.1,29892,61,29892,0,0,10014,13,33,0.9995652900852701,0.9979634761125764,0.9987077534791252,0.9987637408533531,0.9981506010546572,29892,13,10047,61
12,3,giraffe,Mid,125,0.25,74846,150,74846,1,5,24981,30,83,0.9995325917121833,0.9979865861301118,0.9986055221323559,0.9987589906457253,0.998141783887468,74846,35,25064,151
12,3,safari,Mid,125,0.25,74846,150,74846,1,5,24981,30,83,0.9995325917121833,0.9979865861301118,0.9986055221323559,0.9987589906457253,0.998141783887468,74846,35,25064,151
12,3,giraffe,Mid,125,0.2,59875,114,59875,1,3,19907,24,67,0.999549263797536,0.9980830138356392,0.9986500674966252,0.9988156007073032,0.9982248002900326,59875,27,19974,115
12,3,safari,Mid,125,0.2,59875,114,59875,1,3,19907,24,67,0.999549263797536,0.9980830138356392,0.9986500674966252,0.9988156007073032,0.9982248002900326,59875,27,19974,115
12,3,giraffe,Mid,125,0.35,104742,200,104742,1,7,35003,38,116,0.9995705574164734,0.9980846745376061,0.9987202821067,0.9988270633671863,0.9982441990764201,104742,45,35119,201
12,3,safari,Mid,125,0.35,104742,200,104742,1,7,35003,38,116,0.9995705574164734,0.9980846745376061,0.9987202821067,0.9988270633671863,0.9982441990764201,104742,45,35119,201
12,3,giraffe,Mid,125,0.3,89616,180,89616,1,5,29880,36,101,0.9995427016295437,0.9979843424613294,0.9986343348211312,0.9987629141729915,0.9981472053680969,89616,41,29981,181
12,3,safari,Mid,125,0.3,89616,180,89616,1,5,29880,36,101,0.9995427016295437,0.9979843424613294,0.9986343348211312,0.9987629141729915,0.9981472053680969,89616,41,29981,181
12,3,giraffe,Mid,125,0.45,135072,269,135072,1,8,45249,51,145,0.9995633866396312,0.9980050538635457,0.9987019558664995,0.9987836124123295,0.9981802594098288,135072,59,45394,270
12,3,safari,Mid,125,0.45,135072,269,135072,1,8,45249,52,144,0.999555989698961,0.9980050538635457,0.9986799551184741,0.9987799196965327,0.9981747282834149,135072,60,45393,270
12,3,giraffe,Mid,125,0.4,119704,236,119704,1,8,40034,43,131,0.9995741305164711,0.9980240284806696,0.9987318480206883,0.9987984780722248,0.9982017645185661,119704,51,40165,237
12,3,safari,Mid,125,0.4,119704,236,119704,1,8,40034,43,131,0.9995741305164711,0.9980240284806696,0.9987318480206883,0.9987984780722248,0.9982017645185661,119704,51,40165,237
12,3,giraffe,Mid,125,0.55,165098,332,165098,1,8,55332,66,173,0.9995519821761558,0.9979870761828195,0.9986685618668921,0.9987689161925332,0.9981584543685806,165098,74,55505,333
12,3,safari,Mid,125,0.55,165098,332,165098,1,8,55332,67,172,0.9995459306303088,0.9979870761828195,0.998650569459688,0.998765895149484,0.9981539296864396,165098,75,55504,333
12,3,giraffe,Mid,125,0.5,150166,294,150166,1,8,50375,60,160,0.999547372765153,0.9980393590365609,0.9986562061537854,0.9987927966876735,0.9981946047029802,150166,68,50535,295
12,3,safari,Mid,125,0.5,150166,294,150166,1,8,50375,61,159,0.9995407195393883,0.9980393590365609,0.9986364444795763,0.9987894750844706,0.998189631162217,150166,69,50534,295
12,3,giraffe,Mid,125,0.65,195302,389,195302,2,9,65453,79,208,0.9995496187112953,0.9980019724772986,0.9986615766019254,0.9987751960581258,0.99816785367309,195302,88,65661,391
12,3,safari,Mid,125,0.65,195302,389,195302,2,9,65453,80,207,0.9995445030733248,0.9980019724772986,0.9986463672451292,0.9987726421945158,0.9981640287329503,195302,89,65660,391
12,3,giraffe,Mid,125,0.6,180201,358,180201,1,9,60351,72,188,0.9995507038972277,0.9980117412494461,0.9986638073243154,0.9987806297493085,0.9981756364541007,180201,81,60539,359
12,3,safari,Mid,125,0.6,180201,358,180201,1,9,60351,73,187,0.9995451595547001,0.9980117412494461,0.9986473111184427,0.9987778618401909,0.9981714901733145,180201,82,60538,359
12,3,giraffe,Mid,125,0.75,225116,444,225116,2,10,75403,90,239,0.9995559818130151,0.9980227165923338,0.9986797285521903,0.9987887607647223,0.9981878766959615,225116,100,75642,446
12,3,safari,Mid,125,0.75,225116,444,225116,2,10,75403,91,238,0.9995515436223731,0.9980227165923338,0.9986665258377122,0.9987865450697571,0.9981845577888113,225116,101,75641,446
12,3,giraffe,Mid,125,0.7,210282,422,210282,2,9,70480,83,223,0.9995626836015857,0.9979877174831282,0.9987004731972597,0.9987745796523226,0.9981669692114771,210282,92,70703,424
12,3,safari,Mid,125,0.7,210282,422,210282,2,9,70480,84,222,0.9995579322638146,0.9979877174831282,0.9986863479059256,0.9987722077225047,0.998163416826228,210282,93,70702,424
12,3,giraffe,Mid,125,0.85,255139,496,255139,3,12,85275,98,264,0.9995690482626768,0.9980480210297373,0.998715688449369,0.9988079555753033,0.9982155780911667,255139,110,85539,499
12,3,safari,Mid,125,0.85,255139,496,255139,3,12,85275,99,263,0.9995651322233104,0.9980480210297373,0.9987040128898177,0.9988060005324063,0.9982126480059305,255139,111,85538,499
12,3,giraffe,Mid,125,0.8,239998,467,239998,3,12,80285,93,255,0.9995626876798708,0.9980454779845968,0.9986979973959947,0.9988035066618669,0.9982093530937707,239998,105,80540,470
12,3,safari,Mid,125,0.8,239998,467,239998,3,12,80285,94,254,0.9995585246393229,0.9980454779845968,0.9986855973711948,0.9988014282979449,0.9982062389252382,239998,106,80539,470
12,3,giraffe,Mid,125,0.95,285018,555,285018,4,12,95201,104,297,0.9995931737358575,0.9980425594498157,0.9987867885456104,0.9988172647802478,0.9982292341634509,285018,116,95498,559
12,3,safari,Mid,125,0.95,285018,555,285018,4,12,95201,105,296,0.9995896680519754,0.9980425594498157,0.998776329826176,0.9988155146553779,0.998226610806656,285018,117,95497,559
12,3,giraffe,Mid,125,0.9,270001,531,270001,4,12,90223,102,281,0.9995779575366048,0.998022444332732,0.9987419717936834,0.9987995953027,0.9982029826611363,270001,114,90504,535
12,3,safari,Mid,125,0.9,270001,531,270001,4,12,90223,103,280,0.9995742569858875,0.998022444332732,0.9987309364585403,0.998797747904382,0.9982002137592274,270001,115,90503,535
12,3,giraffe,None,125,0.15,44879,82,44879,0,0,14958,17,43,0.9996213471133286,0.9981761971486399,0.9988680250366228,0.9988982494407781,0.9983494222978042,44879,17,15001,82
12,3,safari,None,125,0.15,44879,82,44879,0,0,14958,17,43,0.9996213471133286,0.9981761971486399,0.9988680250366228,0.9988982494407781,0.9983494222978042,44879,17,15001,82
12,3,giraffe,None,125,0.1,29905,50,29905,0,0,10014,10,23,0.999665719538693,0.9983308295776999,0.9990046780133374,0.9989978286286956,0.9985000749962502,29905,10,10037,50
12,3,safari,None,125,0.1,29905,50,29905,0,0,10014,10,23,0.999665719538693,0.9983308295776999,0.9990046780133374,0.9989978286286956,0.9985000749962502,29905,10,10037,50
12,3,giraffe,None,125,0.25,74863,137,74863,0,0,24988,28,80,0.9996261232991949,0.9981733333333334,0.9988842843481033,0.9988992000853955,0.9983515824808185,74863,28,25068,137
12,3,safari,None,125,0.25,74863,137,74863,0,0,24988,28,80,0.9996261232991949,0.9981733333333334,0.9988842843481033,0.9988992000853955,0.9983515824808185,74863,28,25068,137
12,3,giraffe,None,125,0.2,59885,108,59885,0,0,19912,23,62,0.9996160779862455,0.9981997899754972,0.9988498274741211,0.9989074319647043,0.9983622952869109,59885,23,19974,108
12,3,safari,None,125,0.2,59885,108,59885,0,0,19912,23,62,0.9996160779862455,0.9981997899754972,0.9988498274741211,0.9989074319647043,0.9983622952869109,59885,23,19974,108
12,3,giraffe,None,125,0.35,104751,195,104751,0,2,35010,41,108,0.9995896711643797,0.9981419015493682,0.9987770541224652,0.9988652617526461,0.9983012982934472,104751,43,35118,195
12,3,safari,None,125,0.35,104751,195,104751,0,2,35010,41,108,0.9995896711643797,0.9981419015493682,0.9987770541224652,0.9988652617526461,0.9983012982934472,104751,43,35118,195
12,3,giraffe,None,125,0.3,89632,168,89632,0,1,29886,35,99,0.9995985189811304,0.9981291759465479,0.9988008394124113,0.9988633071076739,0.9982974603783977,89632,36,29985,168
12,3,safari,None,125,0.3,89632,168,89632,0,1,29886,35,99,0.9995985189811304,0.9981291759465479,0.9988008394124113,0.9988633071076739,0.9982974603783977,89632,36,29985,168
12,3,giraffe,None,125,0.45,135088,258,135088,0,6,45251,51,134,0.9995782307891524,0.9980937744743102,0.9987456538004489,0.9988354510870971,0.9982576277186539,135088,57,45385,258
12,3,safari,None,125,0.45,135088,258,135088,0,6,45251,51,134,0.9995782307891524,0.9980937744743102,0.9987456538004489,0.9988354510870971,0.9982576277186539,135088,57,45385,258
12,3,giraffe,None,125,0.4,119726,219,119726,0,4,40040,46,119,0.9995825541009885,0.9981741631581141,0.9987564973015991,0.9988778621814526,0.9983203666471021,119726,50,40159,219
12,3,safari,None,125,0.4,119726,219,119726,0,4,40040,46,119,0.9995825541009885,0.9981741631581141,0.9987564973015991,0.9988778621814526,0.9983203666471021,119726,50,40159,219
12,3,giraffe,None,125,0.55,165117,318,165117,0,6,55334,66,158,0.9995641356264642,0.9980777949043431,0.9987041969620618,0.998820412311266,0.9982352861325164,165117,72,55492,318
12,3,safari,None,125,0.55,165117,318,165117,0,6,55334,66,158,0.9995641356264642,0.9980777949043431,0.9987041969620618,0.998820412311266,0.9982352861325164,165117,72,55492,318
12,3,giraffe,None,125,0.5,150179,286,150179,0,6,50377,61,148,0.999554064667279,0.9980992257335592,0.9986756799493991,0.9988261154397412,0.9982442789855613,150179,67,50525,286
12,3,safari,None,125,0.5,150179,286,150179,0,6,50377,61,148,0.999554064667279,0.9980992257335592,0.9986756799493991,0.9988261154397412,0.9982442789855613,150179,67,50525,286
12,3,giraffe,None,125,0.65,195306,389,195306,0,6,65458,78,197,0.9995700905880547,0.9980122128822914,0.9987222196869439,0.9987905442550852,0.9981907479516818,195306,84,65655,389
12,3,safari,None,125,0.65,195306,389,195306,0,6,65458,78,197,0.9995700905880547,0.9980122128822914,0.9987222196869439,0.9987905442550852,0.9981907479516818,195306,84,65655,389
12,3,giraffe,None,125,0.6,180211,352,180211,0,6,60354,70,175,0.9995784499159673,0.998050541916118,0.998745978054616,0.9988139115976168,0.9982253035228554,180211,76,60529,352
12,3,safari,None,125,0.6,180211,352,180211,0,6,60354,70,175,0.9995784499159673,0.998050541916118,0.998745978054616,0.9988139115976168,0.9982253035228554,180211,76,60529,352
12,3,giraffe,None,125,0.75,225134,433,225134,0,6,75409,89,231,0.9995782070692495,0.9980803929652831,0.9987456261966066,0.9988287384981233,0.9982476053925962,225134,95,75640,433
12,3,safari,None,125,0.75,225134,433,225134,0,6,75409,89,231,0.9995782070692495,0.9980803929652831,0.9987456261966066,0.9988287384981233,0.9982476053925962,225134,95,75640,433
12,3,giraffe,None,125,0.7,210297,414,210297,0,6,70485,85,212,0.9995674658250471,0.9980352236000968,0.9987144713793298,0.9988007570666281,0.998206032703491,210297,91,70697,414
12,3,safari,None,125,0.7,210297,414,210297,0,6,70485,85,212,0.9995674658250471,0.9980352236000968,0.9987144713793298,0.9988007570666281,0.998206032703491,210297,91,70697,414
12,3,giraffe,None,125,0.85,255159,485,255159,0,7,85284,104,269,0.9995651662945116,0.9981028304986622,0.9987042398206948,0.9988334631660122,0.9982537766474856,255159,111,85553,485
12,3,safari,None,125,0.85,255159,485,255159,0,7,85284,104,269,0.9995651662945116,0.9981028304986622,0.9987042398206948,0.9988334631660122,0.9982537766474856,255159,111,85553,485
12,3,giraffe,None,125,0.8,240015,457,240015,0,6,80293,93,251,0.9995876958444738,0.9980995708440068,0.9987723670994383,0.9988430790742968,0.9982685330800493,240015,99,80544,457
12,3,safari,None,125,0.8,240015,457,240015,0,6,80293,93,251,0.9995876958444738,0.9980995708440068,0.9987723670994383,0.9988430790742968,0.9982685330800493,240015,99,80544,457
12,3,giraffe,None,125,0.95,285032,552,285032,0,9,95209,109,296,0.999586182710854,0.9980671186060843,0.9987659872624787,0.9988260730918431,0.9982424247193782,285032,118,95505,552
12,3,safari,None,125,0.95,285032,552,285032,0,9,95209,109,296,0.999586182710854,0.9980671186060843,0.9987659872624787,0.9988260730918431,0.9982424247193782,285032,118,95505,552
12,3,giraffe,None,125,0.9,270021,522,270021,0,7,90231,107,283,0.9995779887833861,0.9980705470110112,0.9987421106059937,0.9988236991333104,0.9982390612756838,270021,114,90514,522
12,3,safari,None,125,0.9,270021,522,270021,0,7,90231,107,283,0.9995779887833861,0.9980705470110112,0.9987421106059937,0.9988236991333104,0.9982390612756838,270021,114,90514,522
12,3,giraffe,Single-stranded,125,0.15,44867,94,44867,0,0,14958,17,43,0.999621245878264,0.9979092991703922,0.9988680250366228,0.998764538928154,0.9981493522732956,44867,17,15001,94
12,3,safari,Single-stranded,125,0.15,44867,94,44867,0,0,14958,17,43,0.999621245878264,0.9979092991703922,0.9988680250366228,0.998764538928154,0.9981493522732956,44867,17,15001,94
12,3,giraffe,Single-stranded,125,0.1,29888,67,29888,0,0,10014,10,23,0.9996655294668539,0.9977633116341178,0.9990046780133374,0.9987135147778724,0.9980750962451878,29888,10,10037,67
12,3,safari,Single-stranded,125,0.1,29888,67,29888,0,0,10014,10,23,0.9996655294668539,0.9977633116341178,0.9990046780133374,0.9987135147778724,0.9980750962451878,29888,10,10037,67
12,3,giraffe,Single-stranded,125,0.25,74846,154,74846,0,0,24987,28,80,0.9996260384111975,0.9979466666666666,0.998884239888424,0.998785646609819,0.9981817273590089,74846,28,25067,154
12,3,safari,Single-stranded,125,0.25,74846,154,74846,0,0,24987,28,80,0.9996260384111975,0.9979466666666666,0.998884239888424,0.998785646609819,0.9981817273590089,74846,28,25067,154
12,3,giraffe,Single-stranded,125,0.2,59882,111,59882,0,0,19911,23,62,0.9996160587597028,0.9981497841414831,0.9988497699539908,0.9988823833591886,0.9983247696558277,59882,23,19973,111
12,3,safari,Single-stranded,125,0.2,59882,111,59882,0,0,19911,23,62,0.9996160587597028,0.9981497841414831,0.9988497699539908,0.9988823833591886,0.9983247696558277,59882,23,19973,111
12,3,giraffe,Single-stranded,125,0.35,104737,209,104737,0,3,35007,41,108,0.9995800765405942,0.9980084996093229,0.9987485423362439,0.9987936698660641,0.9981942114842439,104737,44,35115,209
12,3,safari,Single-stranded,125,0.35,104737,209,104737,0,3,35007,41,108,0.9995800765405942,0.9980084996093229,0.9987485423362439,0.9987936698660641,0.9981942114842439,104737,44,35115,209
12,3,giraffe,Single-stranded,125,0.3,89613,187,89613,0,1,29884,35,99,0.9995984338921795,0.9979175946547885,0.9988007595189713,0.9987573070900367,0.9981388594463315,89613,36,29983,187
12,3,safari,Single-stranded,125,0.3,89613,187,89613,0,1,29884,35,99,0.9995984338921795,0.9979175946547885,0.9988007595189713,0.9987573070900367,0.9981388594463315,89613,36,29983,187
12,3,giraffe,Single-stranded,125,0.45,135092,254,135092,0,5,45250,51,134,0.9995856394471246,0.9981233283584295,0.9987676056338028,0.9988539487012651,0.9982852654519708,135092,56,45384,254
12,3,safari,Single-stranded,125,0.45,135092,254,135092,0,5,45250,51,134,0.9995856394471246,0.9981233283584295,0.9987676056338028,0.9988539487012651,0.9982852654519708,135092,56,45384,254
12,3,giraffe,Single-stranded,125,0.4,119711,234,119711,0,5,40037,46,119,0.9995741554082264,0.9980491058401767,0.9987315641554954,0.9988110484883629,0.9982204405814477,119711,51,40156,234
12,3,safari,Single-stranded,125,0.4,119711,234,119711,0,5,40037,46,119,0.9995741554082264,0.9980491058401767,0.9987315641554954,0.9988110484883629,0.9982204405814477,119711,51,40156,234
12,3,giraffe,Single-stranded,125,0.55,165114,318,165114,1,5,55334,65,159,0.9995762301433553,0.9980717269226816,0.9987401688173785,0.9988234119842598,0.9982397871454687,165114,70,55493,319
12,3,safari,Single-stranded,125,0.55,165114,318,165114,1,5,55334,65,159,0.9995762301433553,0.9980717269226816,0.9987401688173785,0.9988234119842598,0.9982397871454687,165114,70,55493,319
12,3,giraffe,Single-stranded,125,0.5,150182,283,150182,0,5,50376,61,148,0.9995607262659071,0.9981191639251653,0.9986953943467088,0.9988394249666626,0.9982641565740717,150182,66,50524,283
12,3,safari,Single-stranded,125,0.5,150182,283,150182,0,5,50376,61,148,0.9995607262659071,0.9981191639251653,0.9986953943467088,0.9988394249666626,0.9982641565740717,150182,66,50524,283
12,3,giraffe,Single-stranded,125,0.65,195314,379,195314,1,6,65457,77,198,0.9995752237751859,0.998058192892986,0.9987374121512671,0.9988161323068033,0.9982289849750604,195314,83,65655,380
12,3,safari,Single-stranded,125,0.65,195314,379,195314,1,6,65457,77,198,0.9995752237751859,0.998058192892986,0.9987374121512671,0.9988161323068033,0.9982289849750604,195314,83,65655,380
12,3,giraffe,Single-stranded,125,0.6,180213,348,180213,1,5,60354,69,176,0.9995895433392313,0.9980671459110998,0.9987789584845885,0.9988277645220023,0.998246021412637,180213,74,60530,349
12,3,safari,Single-stranded,125,0.6,180213,348,180213,1,5,60354,69,176,0.9995895433392313,0.9980671459110998,0.9987789584845885,0.9988277645220023,0.998246021412637,180213,74,60530,349
12,3,giraffe,Single-stranded,125,0.75,225115,450,225115,1,7,75407,88,232,0.9995781714843923,0.9980005851945772,0.9987456096337181,0.9987887553907041,0.9981878526385662,225115,95,75639,451
12,3,safari,Single-stranded,125,0.75,225115,450,225115,1,7,75407,88,232,0.9995781714843923,0.9980005851945772,0.9987456096337181,0.9987887553907041,0.9981878526385662,225115,95,75639,451
12,3,giraffe,Single-stranded,125,0.7,210296,413,210296,1,6,70484,84,213,0.9995722148812183,0.9980352142755445,0.9987285801065168,0.9988031232783022,0.9982095723933114,210296,90,70697,414
12,3,safari,Single-stranded,125,0.7,210296,413,210296,1,6,70484,84,213,0.9995722148812183,0.9980352142755445,0.9987285801065168,0.9988031232783022,0.9982095723933114,210296,90,70697,414
12,3,giraffe,Single-stranded,125,0.85,255143,499,255143,1,8,85284,103,270,0.9995651390379778,0.998044147502572,0.9987042549465943,0.9988040642242958,0.9982098280731773,255143,111,85554,500
12,3,safari,Single-stranded,125,0.85,255143,499,255143,1,8,85284,103,270,0.9995651390379778,0.998044147502572,0.9987042549465943,0.9988040642242958,0.9982098280731773,255143,111,85554,500
12,3,giraffe,Single-stranded,125,0.8,240000,470,240000,1,8,80292,92,252,0.9995835068721366,0.9980413438626695,0.9987599821437428,0.9988118300937843,0.9982218208430002,240000,100,80544,471
12,3,safari,Single-stranded,125,0.8,240000,470,240000,1,8,80292,92,252,0.9995835068721366,0.9980413438626695,0.9987599821437428,0.9988118300937843,0.9982218208430002,240000,100,80544,471
12,3,giraffe,Single-stranded,125,0.95,285027,554,285027,1,9,95210,108,297,0.9995896810032826,0.9980566002058954,0.9987764577930227,0.9988225523280874,0.9982371736016746,285027,117,95507,555
12,3,safari,Single-stranded,125,0.95,285027,554,285027,1,9,95210,108,297,0.9995896810032826,0.9980566002058954,0.9987764577930227,0.9988225523280874,0.9982371736016746,285027,117,95507,555
12,3,giraffe,Single-stranded,125,0.9,270010,530,270010,1,8,90231,106,284,0.9995779715982289,0.9980372660705771,0.9987421244855399,0.9988070246825668,0.9982141373868262,270010,114,90515,531
12,3,safari,Single-stranded,125,0.9,270010,530,270010,1,8,90231,106,284,0.9995779715982289,0.9980372660705771,0.9987421244855399,0.9988070246825668,0.9982141373868262,270010,114,90515,531
12,5,giraffe,High,125,0.15,44620,93,44620,247,0,14956,10,50,0.9997759354694152,0.9924377224199288,0.9993340436867342,0.9960933139859359,0.9941643323996265,44620,10,15006,340
12,5,safari,High,125,0.15,44658,93,44658,209,0,14956,10,50,0.9997761260857885,0.9932829181494662,0.9993340436867342,0.9965189449725532,0.994797919167667,44658,10,15006,302
12,5,giraffe,High,125,0.1,29737,58,29737,159,0,10014,6,27,0.9997982718622869,0.9927555585230687,0.9994028068080024,0.9962644689012847,0.9944251393715157,29737,6,10041,217
12,5,safari,High,125,0.1,29760,58,29760,136,0,10014,6,27,0.9997984277363435,0.9935234025505776,0.9994028068080024,0.9966510381781648,0.9950001249968751,29760,6,10041,194
12,5,giraffe,High,125,0.25,74441,158,74441,400,1,24985,18,90,0.9997448294386247,0.9925599007986773,0.9992428468956722,0.9961394094701557,0.9942353611141638,74441,19,25075,558
12,5,safari,High,125,0.25,74491,158,74491,350,1,24985,19,89,0.9997315832561635,0.9932265763543514,0.9992029967322866,0.9964684636479166,0.994724905837571,74491,20,25074,508
12,5,giraffe,High,125,0.2,59553,125,59553,314,0,19910,13,72,0.9997817546922741,0.9926823576476863,0.9993498374593648,0.9962194081533648,0.9943490817257804,59553,13,19982,439
12,5,safari,High,125,0.2,59599,125,59599,268,0,19910,14,71,0.9997651518963985,0.9934491265502067,0.999299824956239,0.9965971322269136,0.9949116731468863,59599,14,19981,393
12,5,giraffe,High,125,0.35,104183,216,104183,545,2,35008,29,120,0.9997025351680197,0.9927485134929105,0.9991182911914446,0.996213388921294,0.9943470161238518,104183,31,35128,761
12,5,safari,High,125,0.35,104261,216,104261,467,2,35008,30,119,0.9996931721208518,0.9934917670376582,0.9990898489718137,0.9965828223497757,0.9948966117784772,104261,32,35127,683
12,5,giraffe,High,125,0.3,89139,192,89139,468,1,29884,24,110,0.9997196177829617,0.9926502522299803,0.9991671941103968,0.9961723931762432,0.9942829958770802,89139,25,29994,660
12,5,safari,High,125,0.3,89201,192,89201,406,1,29884,25,109,0.9997086083808713,0.9933406830811033,0.9991338818748127,0.9965144727581469,0.9947921013537198,89201,26,29993,598
12,5,giraffe,High,125,0.45,134344,278,134344,722,2,45253,38,147,0.9997023455173235,0.9926114197895732,0.9991197183098591,0.9961442638509906,0.994247278520223,134344,40,45400,1000
12,5,safari,High,125,0.45,134458,278,134458,608,2,45253,39,146,0.9996951650198143,0.9934537179335619,0.9990977112676056,0.996564669085357,0.9948723338348526,134458,41,45399,886
12,5,giraffe,High,125,0.4,119064,245,119064,634,2,40040,33,132,0.9997061268356577,0.9926715189715115,0.9991295048125948,0.9961764041465516,0.9942928504527005,119064,35,40172,879
12,5,safari,High,125,0.4,119166,245,119166,532,2,40040,34,131,0.9996979916444355,0.9935219229133838,0.9991046335215261,0.9966003888854043,0.9949235092101155,119166,36,40171,777
12,5,giraffe,High,125,0.55,164204,335,164204,894,2,55336,50,174,0.9996834210013638,0.9925710106206138,0.9990641085634067,0.9961145200476812,0.9942034887667142,164204,52,55510,1229
12,5,safari,High,125,0.55,164355,335,164355,743,2,55336,51,173,0.9996776312588195,0.9934837668421657,0.9990461106511644,0.9965710751543925,0.9948822371546867,164355,53,55509,1078
12,5,giraffe,High,125,0.5,149344,304,149344,815,2,50379,46,163,0.9996786976544929,0.992562955676811,0.9990511958885155,0.9961081189241467,0.9941955603746276,149344,48,50542,1119
12,5,safari,High,125,0.5,149480,304,149480,679,2,50379,47,162,0.9996723043690522,0.9934668323773951,0.9990314291361929,0.9965599082642205,0.9948670251127812,149480,49,50541,983
12,5,giraffe,High,125,0.65,194222,401,194222,1070,2,65460,56,219,0.9997014618077003,0.9924831240769981,0.9991176962745486,0.9960792157405768,0.9941513980797919,194222,58,65679,1471
12,5,safari,High,125,0.65,194400,401,194400,892,2,65460,57,218,0.9996965941406671,0.9933927120540847,0.9991024841413512,0.9965346839180627,0.9948284435604177,194400,59,65678,1293
12,5,giraffe,High,125,0.6,179200,375,179200,986,2,60356,51,194,0.999704328518909,0.9924623811343535,0.9991254558355197,0.9960701918213299,0.9941367699988389,179200,53,60550,1361
12,5,safari,High,125,0.6,179362,375,179362,824,2,60356,52,193,0.9996990234984616,0.9933595848494414,0.9991089550022276,0.9965192220614094,0.9948043654940206,179362,54,60549,1199
12,5,giraffe,High,125,0.75,223888,452,223888,1227,2,75411,65,255,0.9997008327565806,0.9925565353087996,0.9991153130075396,0.9961158741952563,0.9942051111848655,223888,67,75666,1679
12,5,safari,High,125,0.75,224089,452,224089,1026,2,75411,66,254,0.9996966411934493,0.9934476231008968,0.9991021087240701,0.9965623360105309,0.994868901427149,224089,68,75665,1478
12,5,giraffe,High,125,0.7,209137,422,209137,1152,2,70487,61,236,0.9996988527724665,0.9925300530109961,0.9991099935015398,0.9961015548532903,0.9941846627139899,209137,63,70723,1574
12,5,safari,High,125,0.7,209325,422,209325,964,2,70487,62,235,0.999694348795782,0.9934222703133676,0.9990958664142627,0.9965484408474173,0.994848968195043,209325,64,70722,1386
12,5,giraffe,High,125,0.85,253732,516,253732,1398,3,85284,80,293,0.9996729901700057,0.9925130844996597,0.9990310530002334,0.9960801710042575,0.9941489455210281,253732,83,85577,1914
12,5,safari,High,125,0.85,253938,516,253938,1192,3,85284,81,292,0.9996693199801592,0.9933188862724236,0.9990193789399954,0.9964839856534057,0.9947495795561754,253938,84,85576,1708
12,5,giraffe,High,125,0.8,238682,479,238682,1313,3,80294,70,274,0.9996942472408955,0.9925480509327411,0.9990947532892698,0.996108332342158,0.994192111860237,238682,73,80568,1792
12,5,safari,High,125,0.8,238891,479,238891,1104,3,80294,71,273,0.9996903312200531,0.99341716776034,0.9990823526493967,0.9965438773232882,0.9948398548806502,238891,74,80567,1583
12,5,giraffe,High,125,0.95,283443,589,283443,1554,3,95212,85,320,0.9996896282946133,0.9924961307627125,0.9990796904413303,0.9960798921838567,0.9941475212877027,283443,88,95532,2143
12,5,safari,High,125,0.95,283667,589,283667,1330,3,95212,86,319,0.9996863502445763,0.9932804829368387,0.9990692323781636,0.9964731216035353,0.9947325068335755,283667,89,95531,1919
12,5,giraffe,High,125,0.9,268516,557,268516,1472,3,90232,83,307,0.999679823679645,0.9925003234212423,0.9990510344827587,0.9960771366621719,0.9941440318963369,268516,86,90539,2029
12,5,safari,High,125,0.9,268729,557,268729,1259,3,90232,84,306,0.9996763585500863,0.9932876231310872,0.99904,0.996471750831076,0.9947310130963258,268729,87,90538,1816
12,5,giraffe,Mid,125,0.15,44869,86,44869,4,2,14954,13,54,0.9996658051867034,0.9979981761160168,0.9990015309858218,0.9988312945916766,0.9982494748424527,44869,15,15008,90
12,5,safari,Mid,125,0.15,44869,86,44869,4,2,14954,13,54,0.9996658051867034,0.9979981761160168,0.9990015309858218,0.9988312945916766,0.9982494748424527,44869,15,15008,90
12,5,giraffe,Mid,125,0.1,29890,61,29890,2,0,10014,11,35,0.9996321193271128,0.9978967048375789,0.9989065606361829,0.9987636582350387,0.9981506010546572,29890,11,10049,63
12,5,safari,Mid,125,0.1,29890,61,29890,2,0,10014,11,35,0.9996321193271128,0.9978967048375789,0.9989065606361829,0.9987636582350387,0.9981506010546572,29890,11,10049,63
12,5,giraffe,Mid,125,0.25,74842,150,74842,5,3,24983,26,87,0.9996126671207811,0.9979332506633599,0.9988445754810948,0.9987722529158994,0.9981617647058824,74842,29,25070,155
12,5,safari,Mid,125,0.25,74842,150,74842,5,3,24983,26,87,0.9996126671207811,0.9979332506633599,0.9988445754810948,0.9987722529158994,0.9981617647058824,74842,29,25070,155
12,5,giraffe,Mid,125,0.2,59871,114,59871,5,2,19908,20,71,0.9996326782762593,0.9980163360560094,0.9989000549972501,0.9988238532569256,0.9982373016964409,59871,22,19979,119
12,5,safari,Mid,125,0.2,59871,114,59871,5,2,19908,20,71,0.9996326782762593,0.9980163360560094,0.9989000549972501,0.9988238532569256,0.9982373016964409,59871,22,19979,119
12,5,giraffe,Mid,125,0.35,104738,200,104738,5,5,35005,33,121,0.9996373215240131,0.9980465586080063,0.9989193493345467,0.9988413067008711,0.9982656112828053,104738,38,35126,205
12,5,safari,Mid,125,0.35,104738,200,104738,5,5,35005,33,121,0.9996373215240131,0.9980465586080063,0.9989193493345467,0.9988413067008711,0.9982656112828053,104738,38,35126,205
12,5,giraffe,Mid,125,0.3,89612,180,89612,5,3,29882,32,105,0.9996095797963122,0.9979397975433478,0.9988341882619413,0.9987739907714942,0.9981638972116276,89612,35,29987,185
12,5,safari,Mid,125,0.3,89612,180,89612,5,3,29882,32,105,0.9996095797963122,0.9979397975433478,0.9988341882619413,0.9987739907714942,0.9981638972116276,89612,35,29987,185
12,5,giraffe,Mid,125,0.45,135066,269,135066,7,6,45251,45,151,0.9996225493461223,0.99796072172718,0.9988779618507029,0.9987909442836068,0.9981913216626566,135066,51,45402,276
12,5,safari,Mid,125,0.45,135066,269,135066,7,6,45251,45,151,0.9996225493461223,0.99796072172718,0.9988779618507029,0.9987909442836068,0.9981913216626566,135066,51,45402,276
12,5,giraffe,Mid,125,0.4,119699,236,119699,6,6,40036,37,137,0.9996408945900352,0.9979823413178146,0.9989307738213646,0.9988109294359634,0.9982204961381644,119699,43,40173,242
12,5,safari,Mid,125,0.4,119699,236,119699,6,6,40036,37,137,0.9996408945900352,0.9979823413178146,0.9989307738213646,0.9988109294359634,0.9982204961381644,119699,43,40173,242
12,5,giraffe,Mid,125,0.55,165092,332,165092,7,6,55334,59,180,0.9996064350890365,0.9979508072852126,0.9988304935317296,0.9987779350732634,0.9981720284150039,165092,65,55514,339
12,5,safari,Mid,125,0.55,165092,332,165092,7,6,55334,59,180,0.9996064350890365,0.9979508072852126,0.9988304935317296,0.9987779350732634,0.9981720284150039,165092,65,55514,339
12,5,giraffe,Mid,125,0.5,150160,294,150160,7,6,50377,54,166,0.9996005858074823,0.9979994815932368,0.9988142995474577,0.9987993920467206,0.9982045517845064,150160,60,50543,301
12,5,safari,Mid,125,0.5,150160,294,150160,7,6,50377,54,166,0.9996005858074823,0.9979994815932368,0.9988142995474577,0.9987993920467206,0.9982045517845064,150160,60,50543,301
12,5,giraffe,Mid,125,0.65,195296,389,195296,8,7,65455,71,216,0.999600765710893,0.9979713122084081,0.9988136701698885,0.9987853743731893,0.9981831534336487,195296,78,65671,397
12,5,safari,Mid,125,0.65,195296,389,195296,8,7,65455,71,216,0.999600765710893,0.9979713122084081,0.9988136701698885,0.9987853743731893,0.9981831534336487,195296,78,65671,397
12,5,giraffe,Mid,125,0.6,180195,358,180195,7,7,60353,65,195,0.9996005924545258,0.9979785112981834,0.9988122731771693,0.9987888932923534,0.998188075296459,180195,72,60548,365
12,5,safari,Mid,125,0.6,180195,358,180195,7,7,60353,65,195,0.9996005924545258,0.9979785112981834,0.9988122731771693,0.9987888932923534,0.998188075296459,180195,72,60548,365
12,5,giraffe,Mid,125,0.75,225110,444,225110,8,8,75405,81,248,0.9996047939822112,0.9979961163671186,0.9988249584114494,0.9987998074367569,0.9982044712317129,225110,89,75653,452
12,5,safari,Mid,125,0.75,225110,444,225110,8,8,75405,81,248,0.9996047939822112,0.9979961163671186,0.9988249584114494,0.9987998074367569,0.9982044712317129,225110,89,75653,452
12,5,giraffe,Mid,125,0.7,210276,422,210276,8,7,70482,74,232,0.9996149403157489,0.9979592417871347,0.9988558514019351,0.9987864048847798,0.9981847311377224,210276,81,70714,430
12,5,safari,Mid,125,0.7,210276,422,210276,8,7,70482,74,232,0.9996149403157489,0.9979592417871347,0.9988558514019351,0.9987864048847798,0.9981847311377224,210276,81,70714,430
12,5,giraffe,Mid,125,0.85,255133,496,255133,9,9,85278,87,275,0.999623867193775,0.9980245503407161,0.9988791462830856,0.9988235685608975,0.9982390187730561,255133,96,85553,505
12,5,safari,Mid,125,0.85,255133,496,255133,9,9,85278,87,275,0.999623867193775,0.9980245503407161,0.9988791462830856,0.9988235685608975,0.9982390187730561,255133,96,85553,505
12,5,giraffe,Mid,125,0.8,239992,467,239992,9,9,80288,83,265,0.9996168007863915,0.9980205266397192,0.9988591977183955,0.9988180259368393,0.9982311522734988,239992,92,80553,476
12,5,safari,Mid,125,0.8,239992,467,239992,9,9,80288,83,265,0.9996168007863915,0.9980205266397192,0.9988591977183955,0.9988180259368393,0.9982311522734988,239992,92,80553,476
12,5,giraffe,Mid,125,0.95,285012,555,285012,10,9,95204,93,308,0.9996422483638123,0.9980215493544649,0.998933210617692,0.9988312414248691,0.99825022101781,285012,102,95512,565
12,5,safari,Mid,125,0.95,285012,555,285012,10,9,95204,93,308,0.9996422483638123,0.9980215493544649,0.998933210617692,0.9988312414248691,0.99825022101781,285012,102,95512,565
12,5,giraffe,Mid,125,0.9,269995,531,269995,10,9,90226,91,292,0.9996297598992947,0.9980002661383328,0.9988964664856872,0.998814348418792,0.9982251338764073,269995,100,90518,541
12,5,safari,Mid,125,0.9,269995,531,269995,10,9,90226,91,292,0.9996297598992947,0.9980002661383328,0.9988964664856872,0.998814348418792,0.9982251338764073,269995,100,90518,541
12,5,giraffe,None,125,0.15,44879,82,44879,0,0,14958,13,47,0.9997104161097746,0.9981761971486399,0.9991343720868291,0.9989427175497758,0.9984161123059737,44879,13,15005,82
12,5,safari,None,125,0.15,44879,82,44879,0,0,14958,13,47,0.9997104161097746,0.9981761971486399,0.9991343720868291,0.9989427175497758,0.9984161123059737,44879,13,15005,82
12,5,giraffe,None,125,0.1,29905,50,29905,0,0,10014,8,25,0.9997325577508107,0.9983308295776999,0.9992037424106699,0.9990312019776842,0.9985500724963752,29905,8,10039,50
12,5,safari,None,125,0.1,29905,50,29905,0,0,10014,8,25,0.9997325577508107,0.9983308295776999,0.9992037424106699,0.9990312019776842,0.9985500724963752,29905,8,10039,50
12,5,giraffe,None,125,0.25,74863,137,74863,0,0,24988,24,84,0.9996795171391564,0.9981733333333334,0.9990436722983742,0.9989258574793012,0.9983915441176471,74863,24,25072,137
12,5,safari,None,125,0.25,74863,137,74863,0,0,24988,24,84,0.9996795171391564,0.9981733333333334,0.9990436722983742,0.9989258574793012,0.9983915441176471,74863,24,25072,137
12,5,giraffe,None,125,0.2,59885,108,59885,0,0,19912,19,66,0.9996828258547008,0.9981997899754972,0.9990498574786217,0.9989407574835066,0.9984123015376922,59885,19,19978,108
12,5,safari,None,125,0.2,59885,108,59885,0,0,19912,19,66,0.9996828258547008,0.9981997899754972,0.9990498574786217,0.9989407574835066,0.9984123015376922,59885,19,19978,108
12,5,giraffe,None,125,0.35,104751,195,104751,0,2,35010,37,112,0.9996278270827369,0.9981419015493682,0.9988908165296778,0.9988843117061448,0.9983298479019607,104751,39,35122,195
12,5,safari,None,125,0.35,104751,195,104751,0,2,35010,37,112,0.9996278270827369,0.9981419015493682,0.9988908165296778,0.9988843117061448,0.9983298479019607,104751,39,35122,195
12,5,giraffe,None,125,0.3,89632,168,89632,0,1,29886,31,103,0.9996431120628123,0.9981291759465479,0.998934079477699,0.9988855703650872,0.9983308435082331,89632,32,29989,168
12,5,safari,None,125,0.3,89632,168,89632,0,1,29886,31,103,0.9996431120628123,0.9981291759465479,0.998934079477699,0.9988855703650872,0.9983308435082331,89632,32,29989,168
12,5,giraffe,None,125,0.45,135088,258,135088,0,5,45252,46,139,0.9996226107933313,0.9980937744743102,0.9988776902425069,0.9988576076307374,0.9982908157621081,135088,51,45391,258
12,5,safari,None,125,0.45,135088,258,135088,0,5,45252,46,139,0.9996226107933313,0.9980937744743102,0.9988776902425069,0.9988576076307374,0.9982908157621081,135088,51,45391,258
12,5,giraffe,None,125,0.4,119726,219,119726,0,3,40041,41,124,0.9996326292059782,0.9981741631581141,0.9989057176254073,0.9989028638174499,0.998357830588059,119726,44,40165,219
12,5,safari,None,125,0.4,119726,219,119726,0,3,40041,41,124,0.9996326292059782,0.9981741631581141,0.9989057176254073,0.9989028638174499,0.998357830588059,119726,44,40165,219
12,5,giraffe,None,125,0.55,165117,318,165117,0,5,55335,61,163,0.9996004431448757,0.9980777949043431,0.9988121805485566,0.998838538736548,0.9982624355766315,165117,66,55498,318
12,5,safari,None,125,0.55,165117,318,165117,0,5,55335,61,163,0.9996004431448757,0.9980777949043431,0.9988121805485566,0.998838538736548,0.9982624355766315,165117,66,55498,318
12,5,giraffe,None,125,0.5,150179,286,150179,0,5,50378,56,153,0.9995939829605964,0.9980992257335592,0.998794275774826,0.9988460451272841,0.9982741212690929,150179,61,50531,286
12,5,safari,None,125,0.5,150179,286,150179,0,5,50378,56,153,0.9995939829605964,0.9980992257335592,0.998794275774826,0.9988460451272841,0.9982741212690929,150179,61,50531,286
12,5,giraffe,None,125,0.65,195306,389,195306,0,5,65459,70,205,0.9996161346292628,0.9980122128822914,0.9988591247204855,0.9988135298509753,0.9982251734663433,195306,75,65664,389
12,5,safari,None,125,0.65,195306,389,195306,0,5,65459,70,205,0.9996161346292628,0.9980122128822914,0.9988591247204855,0.9988135298509753,0.9982251734663433,195306,75,65664,389
12,5,giraffe,None,125,0.6,180211,352,180211,0,5,60355,64,181,0.9996172620368315,0.998050541916118,0.9988614800759014,0.9988332876070757,0.9982543289325284,180211,69,60536,352
12,5,safari,None,125,0.6,180211,352,180211,0,5,60355,64,181,0.9996172620368315,0.998050541916118,0.9988614800759014,0.9988332876070757,0.9982543289325284,180211,69,60536,352
12,5,giraffe,None,125,0.75,225134,433,225134,0,5,75410,80,240,0.9996225895683757,0.9980803929652831,0.9988776655443322,0.9988508959905588,0.998280794684403,225134,85,75650,433
12,5,safari,None,125,0.75,225134,433,225134,0,5,75410,80,240,0.9996225895683757,0.9980803929652831,0.9988776655443322,0.9988508959905588,0.998280794684403,225134,85,75650,433
12,5,giraffe,None,125,0.7,210297,414,210297,0,5,70486,76,221,0.9996149787525311,0.9980352236000968,0.9988557382607222,0.9988244765358392,0.9982415568083723,210297,81,70707,414
12,5,safari,None,125,0.7,210297,414,210297,0,5,70486,76,221,0.9996149787525311,0.9980352236000968,0.9988557382607222,0.9988244765358392,0.9982415568083723,210297,81,70707,414
12,5,giraffe,None,125,0.85,255159,485,255159,0,6,85285,94,279,0.999608241041452,0.9981028304986622,0.9988326484871124,0.998854968555675,0.9982860056019782,255159,100,85564,485
12,5,safari,None,125,0.85,255159,485,255159,0,6,85285,94,279,0.999608241041452,0.9981028304986622,0.9988326484871124,0.998854968555675,0.9982860056019782,255159,100,85564,485
12,5,giraffe,None,125,0.8,240015,457,240015,0,5,80294,84,260,0.999629327291507,0.9980995708440068,0.9988963704227273,0.9988638633639632,0.9982996745714152,240015,89,80554,457
12,5,safari,None,125,0.8,240015,457,240015,0,5,80294,84,260,0.999629327291507,0.9980995708440068,0.9988963704227273,0.9988638633639632,0.9982996745714152,240015,89,80554,457
12,5,giraffe,None,125,0.95,285032,552,285032,0,7,95211,99,306,0.9996282501806143,0.9980671186060843,0.9988914800832436,0.9988470744075048,0.9982739036796281,285032,106,95517,552
12,5,safari,None,125,0.95,285032,552,285032,0,7,95211,99,306,0.9996282501806143,0.9980671186060843,0.9988914800832436,0.9988470744075048,0.9982739036796281,285032,106,95517,552
12,5,giraffe,None,125,0.9,270021,522,270021,0,6,90232,97,293,0.9996186936369963,0.9980705470110112,0.9988634858983978,0.9988440204414177,0.9982695177630541,270021,103,90525,522
12,5,safari,None,125,0.9,270021,522,270021,0,6,90232,97,293,0.9996186936369963,0.9980705470110112,0.9988634858983978,0.9988440204414177,0.9982695177630541,270021,103,90525,522
12,5,giraffe,Single-stranded,125,0.15,44867,94,44867,0,0,14958,13,47,0.999710338680927,0.9979092991703922,0.9991343720868291,0.9988090070235194,0.9982160422814652,44867,13,15005,94
12,5,safari,Single-stranded,125,0.15,44867,94,44867,0,0,14958,13,47,0.999710338680927,0.9979092991703922,0.9991343720868291,0.9988090070235194,0.9982160422814652,44867,13,15005,94
12,5,giraffe,Single-stranded,125,0.1,29888,67,29888,0,0,10014,8,25,0.9997324056729997,0.9977633116341178,0.9992037424106699,0.9987468881054619,0.9981250937453128,29888,8,10039,67
12,5,safari,Single-stranded,125,0.1,29888,67,29888,0,0,10014,8,25,0.9997324056729997,0.9977633116341178,0.9992037424106699,0.9987468881054619,0.9981250937453128,29888,8,10039,67
12,5,giraffe,Single-stranded,125,0.25,74846,154,74846,0,0,24987,24,84,0.9996794443702417,0.9979466666666666,0.9990436341900777,0.9988123039967971,0.9982216893950747,74846,24,25071,154
12,5,safari,Single-stranded,125,0.25,74846,154,74846,0,0,24987,24,84,0.9996794443702417,0.9979466666666666,0.9990436341900777,0.9988123039967971,0.9982216893950747,74846,24,25071,154
12,5,giraffe,Single-stranded,125,0.2,59882,111,59882,0,0,19911,19,66,0.9996828099697834,0.9981497841414831,0.9990498099619924,0.9989157088761738,0.9983747765317731,59882,19,19977,111
12,5,safari,Single-stranded,125,0.2,59882,111,59882,0,0,19911,19,66,0.9996828099697834,0.9981497841414831,0.9990498099619924,0.9989157088761738,0.9983747765317731,59882,19,19977,111
12,5,giraffe,Single-stranded,125,0.35,104737,209,104737,0,3,35007,37,112,0.9996182368267845,0.9980084996093229,0.9988623112147672,0.998812719634947,0.9982227615003033,104737,40,35119,209
12,5,safari,Single-stranded,125,0.35,104737,209,104737,0,3,35007,37,112,0.9996182368267845,0.9980084996093229,0.9988623112147672,0.998812719634947,0.9982227615003033,104737,40,35119,209
12,5,giraffe,Single-stranded,125,0.3,89613,187,89613,0,1,29884,31,103,0.9996430364214401,0.9979175946547885,0.9989340084613079,0.9987795703418875,0.9981722431333929,89613,32,29987,187
12,5,safari,Single-stranded,125,0.3,89613,187,89613,0,1,29884,31,103,0.9996430364214401,0.9979175946547885,0.9989340084613079,0.9987795703418875,0.9981722431333929,89613,32,29987,187
12,5,giraffe,Single-stranded,125,0.45,135092,254,135092,0,4,45251,46,139,0.9996300187950452,0.9981233283584295,0.998899647887324,0.9988761054094821,0.9983184538625779,135092,50,45390,254
12,5,safari,Single-stranded,125,0.45,135092,254,135092,0,4,45251,46,139,0.9996300187950452,0.9981233283584295,0.998899647887324,0.9988761054094821,0.9983184538625779,135092,50,45390,254
12,5,giraffe,Single-stranded,125,0.4,119711,234,119711,0,4,40038,41,124,0.9996242359464244,0.9980491058401767,0.9988807919019076,0.9988360499121821,0.9982579049902592,119711,45,40162,234
12,5,safari,Single-stranded,125,0.4,119711,234,119711,0,4,40038,41,124,0.9996242359464244,0.9980491058401767,0.9988807919019076,0.9988360499121821,0.9982579049902592,119711,45,40162,234
12,5,giraffe,Single-stranded,125,0.55,165114,318,165114,1,4,55335,60,164,0.9996125392001356,0.9980717269226816,0.9988481543473174,0.9988415388477698,0.998266936958135,165114,64,55499,319
12,5,safari,Single-stranded,125,0.55,165114,318,165114,1,4,55335,60,164,0.9996125392001356,0.9980717269226816,0.9988481543473174,0.9988415388477698,0.998266936958135,165114,64,55499,319
12,5,giraffe,Single-stranded,125,0.5,150182,283,150182,0,4,50377,56,153,0.9996006442938725,0.9981191639251653,0.9988139948606444,0.998859354787218,0.9982939991544603,150182,60,50530,283
12,5,safari,Single-stranded,125,0.5,150182,283,150182,0,4,50377,56,153,0.9996006442938725,0.9981191639251653,0.9988139948606444,0.998859354787218,0.9982939991544603,150182,60,50530,283
12,5,giraffe,Single-stranded,125,0.65,195314,379,195314,1,4,65459,69,206,0.9996263825126543,0.998058192892986,0.9988895311691868,0.9988416721855574,0.9982672358395299,195314,73,65665,380
12,5,safari,Single-stranded,125,0.65,195314,379,195314,1,4,65459,69,206,0.9996263825126543,0.998058192892986,0.9988895311691868,0.9988416721855574,0.9982672358395299,195314,73,65665,380
12,5,giraffe,Single-stranded,125,0.6,180213,348,180213,1,4,60355,63,182,0.9996283558908364,0.9980671459110998,0.998894462411722,0.9988471408538917,0.9982750470630188,180213,67,60537,349
12,5,safari,Single-stranded,125,0.6,180213,348,180213,1,4,60355,63,182,0.9996283558908364,0.9980671459110998,0.998894462411722,0.9988471408538917,0.9982750470630188,180213,67,60537,349
12,5,giraffe,Single-stranded,125,0.75,225115,450,225115,1,5,75409,79,241,0.9996269965674803,0.9980005851945772,0.9988908548340244,0.9988131287921644,0.9982243611018918,225115,84,75650,451
12,5,safari,Single-stranded,125,0.75,225115,450,225115,1,5,75409,79,241,0.9996269965674803,0.9980005851945772,0.9988908548340244,0.9988131287921644,0.9982243611018918,225115,84,75650,451
12,5,giraffe,Single-stranded,125,0.7,210296,413,210296,1,4,70486,75,222,0.9996244800950683,0.9980352142755445,0.9988839758712758,0.9988292150040966,0.9982486491863146,210296,79,70708,414
12,5,safari,Single-stranded,125,0.7,210296,413,210296,1,4,70486,75,222,0.9996244800950683,0.9980352142755445,0.9988839758712758,0.9988292150040966,0.9982486491863146,210296,79,70708,414
12,5,giraffe,Single-stranded,125,0.85,255143,499,255143,1,6,85286,93,280,0.9996121327994609,0.998044147502572,0.9988443354929084,0.9988275247854215,0.9982449869326239,255143,99,85566,500
12,5,safari,Single-stranded,125,0.85,255143,499,255143,1,6,85286,93,280,0.9996121327994609,0.998044147502572,0.9988443354929084,0.9988275247854215,0.9982449869326239,255143,99,85566,500
12,5,giraffe,Single-stranded,125,0.8,240000,470,240000,1,6,80294,83,261,0.9996293041330506,0.9980413438626695,0.9988963841079311,0.9988346928583319,0.9982560764835028,240000,89,80555,471
12,5,safari,Single-stranded,125,0.8,240000,470,240000,1,6,80294,83,261,0.9996293041330506,0.9980413438626695,0.9988963841079311,0.9988346928583319,0.9982560764835028,240000,89,80555,471
12,5,giraffe,Single-stranded,125,0.95,285027,554,285027,1,7,95212,98,307,0.9996317495054922,0.9980566002058954,0.9989019493014306,0.9988435538641071,0.9982686526445019,285027,105,95519,555
12,5,safari,Single-stranded,125,0.95,285027,554,285027,1,7,95212,98,307,0.9996317495054922,0.9980566002058954,0.9989019493014306,0.9988435538641071,0.9982686526445019,285027,105,95519,555
12,5,giraffe,Single-stranded,125,0.9,270010,530,270010,1,6,90233,96,294,0.9996223788650633,0.9980372660705771,0.9988745324344305,0.9988291935862742,0.9982473627377689,270010,102,90527,531
12,5,safari,Single-stranded,125,0.9,270010,530,270010,1,6,90233,96,294,0.9996223788650633,0.9980372660705771,0.9988745324344305,0.9988291935862742,0.9982473627377689,270010,102,90527,531
12,7,giraffe,High,125,0.15,44461,91,44461,408,0,14956,9,51,0.999797616370587,0.9889012455516014,0.9994006393180608,0.994319579559432,0.9915299453114579,44461,9,15007,499
12,7,safari,High,125,0.15,44494,91,44494,375,0,14956,9,51,0.9997977664427117,0.9896352313167259,0.9994006393180608,0.9946905424588937,0.9920801653994932,44494,9,15007,466
12,7,giraffe,High,125,0.1,29635,56,29635,263,0,10014,6,27,0.9997975776795655,0.9893503371836816,0.9994028068080024,0.9945465223592583,0.991875203119922,29635,6,10041,319
12,7,safari,High,125,0.1,29660,56,29660,238,0,10014,6,27,0.9997977482640059,0.9901849502570609,0.9994028068080024,0.9949681314994969,0.9925001874953127,29660,6,10041,294
12,7,giraffe,High,125,0.25,74157,157,74157,685,1,24985,16,92,0.9997708091784183,0.9887731836424486,0.9993225472224436,0.9942415852734744,0.991417981277412,74157,17,25077,842
12,7,safari,High,125,0.25,74210,157,74210,632,1,24985,17,91,0.9997575039068815,0.9894798597314631,0.9992826970590579,0.9945921314507429,0.9919374981267421,74210,18,25076,789
12,7,giraffe,High,125,0.2,59340,123,59340,529,0,19910,11,74,0.999814661926505,0.9891318842512336,0.9994498624656164,0.9944445840979362,0.9917111530623727,59340,11,19984,652
12,7,safari,High,125,0.2,59385,123,59385,484,0,19910,12,73,0.9997979695944239,0.9898819842645686,0.9993998499624906,0.9948152677382339,0.9922612424518984,59385,12,19983,607
12,7,giraffe,High,125,0.35,103799,215,103799,930,2,35008,25,124,0.999739949530946,0.9890894191187681,0.9992320600699679,0.9943861665948173,0.9916347258802453,103799,27,35132,1145
12,7,safari,High,125,0.35,103878,215,103878,851,2,35008,26,123,0.9997305256674301,0.9898422015551152,0.9992036178503371,0.994761790758918,0.992191459140775,103878,28,35131,1066
12,7,giraffe,High,125,0.3,88799,191,88799,809,1,29884,21,113,0.9997523108273945,0.9888640185302732,0.9992671308171491,0.9942783562870899,0.9914703967684321,88799,22,29997,1000
12,7,safari,High,125,0.3,88863,191,88863,745,1,29884,22,112,0.9997412415903517,0.9895767213443357,0.999233818581565,0.9946330134034755,0.9919961942279123,88863,23,29996,936
12,7,giraffe,High,125,0.45,133850,278,133850,1216,2,45253,34,151,0.999731114530272,0.9889614611656224,0.9992077464788732,0.9943171266203618,0.9915368616691743,133850,36,45404,1494
12,7,safari,High,125,0.45,133954,278,133954,1112,2,45253,35,150,0.9997238620504362,0.9897298735075069,0.9991857394366197,0.9947017654593721,0.9921066023541907,133954,37,45403,1390
12,7,giraffe,High,125,0.4,118631,244,118631,1068,2,40040,29,136,0.9997387537712157,0.9890614708653277,0.9992289899768697,0.9943714507239999,0.9916141117702154,118631,31,40176,1312
12,7,safari,High,125,0.4,118724,244,118724,975,2,40040,30,135,0.999730539930614,0.9898368391652702,0.999204118685801,0.9947590898998321,0.9921885732126132,118724,32,40175,1219
12,7,giraffe,High,125,0.55,163606,335,163606,1492,2,55336,46,178,0.9997066982780745,0.9889562541935406,0.9991361002123753,0.994302418509391,0.9915156451503427,163606,48,55514,1827
12,7,safari,High,125,0.55,163742,335,163742,1356,2,55336,47,177,0.9997008382633966,0.9897783392672562,0.9991181023001332,0.9947148446042815,0.9921265186995181,163742,49,55513,1691
12,7,giraffe,High,125,0.5,148793,304,148793,1366,2,50379,42,167,0.9997043745842767,0.9889009258090029,0.9991302628978059,0.9942733043768793,0.9914748847318866,148793,44,50546,1670
12,7,safari,High,125,0.5,148918,304,148918,1241,2,50379,43,166,0.9996979115619314,0.9897316948352751,0.9991104961454833,0.9946898398936632,0.9920916375284129,148918,45,50545,1545
12,7,giraffe,High,125,0.65,193525,401,193525,1767,2,65460,52,223,0.9997210441215214,0.9889214228408784,0.9991785448073384,0.9942919089993629,0.991500592892935,193525,54,65683,2168
12,7,safari,High,125,0.65,193684,401,193684,1608,2,65460,53,222,0.9997161129147978,0.9897339199664781,0.9991633326741409,0.9946999732944392,0.9921049611750755,193684,55,65682,2009
12,7,giraffe,High,125,0.6,178552,375,178552,1634,2,60356,47,198,0.9997256454331163,0.9888735662740016,0.999191459168688,0.9942699951553895,0.9914663880181122,178552,49,60554,2009
12,7,safari,High,125,0.6,178693,375,178693,1493,2,60356,48,197,0.9997202687657698,0.9896544658038003,0.9991749583353959,0.9946619018992273,0.9920469058400093,178693,50,60553,1868
12,7,giraffe,High,125,0.75,223098,451,223098,2018,2,75411,60,260,0.9997221724323355,0.9890542499567756,0.9991813344248874,0.9943595994892218,0.991599734483903,223098,62,75671,2469
12,7,safari,High,125,0.75,223275,451,223275,1841,2,75411,61,259,0.9997179163420465,0.9898389392065329,0.9991681301414179,0.994753901159488,0.9921838698971125,223275,63,75670,2292
12,7,giraffe,High,125,0.7,208390,421,208390,1900,2,70487,56,241,0.9997217531470679,0.9889849129850838,0.9991806289379256,0.9943243494712031,0.9915487554041429,208390,58,70728,2321
12,7,safari,High,125,0.7,208559,421,208559,1731,2,70487,57,240,0.9997171864364532,0.9897869593898753,0.9991665018506485,0.9947272905045919,0.9921455646063724,208559,59,70727,2152
12,7,giraffe,High,125,0.85,252847,515,252847,2284,3,85284,73,300,0.9996995132906062,0.9890512662040478,0.9991127714219006,0.9943468831171384,0.9915764738973238,252847,76,85584,2799
12,7,safari,High,125,0.85,253031,515,253031,2100,3,85284,74,299,0.9996957820377073,0.9897710114768078,0.9991010973616624,0.9947086411114212,0.9921126496457724,253031,77,85583,2615
12,7,giraffe,High,125,0.8,237848,478,237848,2148,3,80294,64,280,0.9997183868188219,0.989079900529787,0.9991691571285078,0.9943706899615167,0.9916135963751304,237848,67,80574,2626
12,7,safari,High,125,0.8,238028,478,238028,1968,3,80294,65,279,0.9997144009139171,0.9898284221994893,0.9991567564886348,0.9947468499905969,0.9921710290705822,238028,68,80573,2446
12,7,giraffe,High,125,0.95,282437,590,282437,2559,3,95212,77,328,0.9997168311995385,0.9889735491235565,0.9991633549466639,0.9943161715393161,0.9915295142259041,282437,80,95540,3149
12,7,safari,High,125,0.95,282646,590,282646,2350,3,95212,78,327,0.999713504546789,0.9897053777145939,0.9991528968834972,0.9946842672963666,0.992075150968243,282646,81,95539,2940
12,7,giraffe,High,125,0.9,267560,557,267560,2428,3,90232,75,315,0.9997085615645013,0.9889667153338632,0.9991393103448276,0.9943086273628114,0.9915192291718581,267560,78,90547,2985
12,7,safari,High,125,0.9,267759,557,267759,2229,3,90232,76,314,0.9997050455872579,0.989702267644939,0.999128275862069,0.994678509536891,0.9920674474624138,267759,79,90546,2786
12,7,giraffe,Mid,125,0.15,44868,86,44868,5,2,14954,11,56,0.9997103451349123,0.997975933628417,0.9991346601877121,0.9988423864648264,0.9982661465106198,44868,13,15010,91
12,7,safari,Mid,125,0.15,44868,86,44868,5,2,14954,11,56,0.9997103451349123,0.997975933628417,0.9991346601877121,0.9988423864648264,0.9982661465106198,44868,13,15010,91
12,7,giraffe,Mid,125,0.1,29889,61,29889,3,0,10014,9,37,0.9996989765201686,0.9978633192000801,0.9991053677932406,0.9987803044226496,0.998175592932297,29889,9,10051,64
12,7,safari,Mid,125,0.1,29889,61,29889,3,0,10014,9,37,0.9996989765201686,0.9978633192000801,0.9991053677932406,0.9987803044226496,0.998175592932297,29889,9,10051,64
12,7,giraffe,Mid,125,0.25,74841,150,74841,6,3,24983,22,91,0.9996660700451473,0.9979199167966719,0.9990039443802542,0.9987922302369497,0.9981917359335039,74841,25,25074,156
12,7,safari,Mid,125,0.25,74841,150,74841,6,3,24983,22,91,0.9996660700451473,0.9979199167966719,0.9990039443802542,0.9987922302369497,0.9981917359335039,74841,25,25074,156
12,7,giraffe,Mid,125,0.2,59870,114,59870,6,2,19908,16,75,0.9996994389527117,0.9979996666111018,0.9991000449977501,0.9988488296434709,0.9982748059156655,59870,18,19983,120
12,7,safari,Mid,125,0.2,59870,114,59870,6,2,19908,16,75,0.9996994389527117,0.9979996666111018,0.9991000449977501,0.9988488296434709,0.9982748059156655,59870,18,19983,120
12,7,giraffe,Mid,125,0.35,104737,200,104737,6,4,35006,29,125,0.9996850243390284,0.9980370296256063,0.99906154021158,0.9988603472364613,0.9982941608913187,104737,33,35131,206
12,7,safari,Mid,125,0.35,104737,200,104737,6,4,35006,29,125,0.9996850243390284,0.9980370296256063,0.99906154021158,0.9988603472364613,0.9982941608913187,104737,33,35131,206
12,7,giraffe,Mid,125,0.3,89611,180,89611,6,3,29882,28,109,0.9996541799602865,0.9979286613138524,0.9989674238891479,0.9987906753827207,0.9981889349769235,89611,31,29991,186
12,7,safari,Mid,125,0.3,89611,180,89611,6,3,29882,28,109,0.9996541799602865,0.9979286613138524,0.9989674238891479,0.9987906753827207,0.9981889349769235,89611,31,29991,186
12,7,giraffe,Mid,125,0.45,135064,269,135064,9,5,45252,39,157,0.999674334606389,0.9979459443483915,0.9990319670868809,0.9988093917544832,0.9982189772947261,135064,44,45409,278
12,7,safari,Mid,125,0.45,135064,269,135064,9,5,45252,39,157,0.999674334606389,0.9979459443483915,0.9990319670868809,0.9988093917544832,0.9982189772947261,135064,44,45409,278
12,7,giraffe,Mid,125,0.4,119698,236,119698,7,5,40037,32,142,0.9996909842569006,0.9979740038852436,0.999079968171872,0.9988317562042089,0.9982517155041616,119698,37,40179,243
12,7,safari,Mid,125,0.4,119698,236,119698,7,5,40037,32,142,0.9996909842569006,0.9979740038852436,0.999079968171872,0.9988317562042089,0.9982517155041616,119698,37,40179,243
12,7,giraffe,Mid,125,0.55,165089,332,165089,10,5,55335,53,186,0.999648797737773,0.9979326728364092,0.9989564403821587,0.9987899981244972,0.9981901271435681,165089,58,55521,342
12,7,safari,Mid,125,0.55,165089,332,165089,10,5,55335,53,186,0.999648797737773,0.9979326728364092,0.9989564403821587,0.9987899981244972,0.9981901271435681,165089,58,55521,342
12,7,giraffe,Mid,125,0.5,150157,294,150157,10,5,50378,48,172,0.9996471606417682,0.9979795428715746,0.9989526312669209,0.9988126556934322,0.998224445947559,150157,53,50550,304
12,7,safari,Mid,125,0.5,150157,294,150157,10,5,50378,48,172,0.9996471606417682,0.9979795428715746,0.9989526312669209,0.9988126556934322,0.998224445947559,150157,53,50550,304
12,7,giraffe,Mid,125,0.65,195292,389,195292,12,6,65456,63,224,0.9996468077047108,0.9979508720291477,0.9989505543810552,0.9987981199527433,0.9982022781343471,195292,69,65680,401
12,7,safari,Mid,125,0.65,195292,389,195292,12,6,65456,63,224,0.9996468077047108,0.9979508720291477,0.9989505543810552,0.9987981199527433,0.9982022781343471,195292,69,65680,401
12,7,giraffe,Mid,125,0.6,180192,358,180192,10,6,60354,57,203,0.9996504951318965,0.9979618963225521,0.9989607390300231,0.9988054820337292,0.9982129529811758,180192,63,60557,368
12,7,safari,Mid,125,0.6,180192,358,180192,10,6,60354,57,203,0.9996504951318965,0.9979618963225521,0.9989607390300231,0.9988054820337292,0.9982129529811758,180192,63,60557,368
12,7,giraffe,Mid,125,0.75,225104,444,225104,14,7,75406,73,256,0.9996447349722893,0.9979695161419033,0.9989437828417522,0.9988064231296563,0.9982144279531636,225104,80,75662,458
12,7,safari,Mid,125,0.75,225104,444,225104,14,7,75406,73,256,0.9996447349722893,0.9979695161419033,0.9989437828417522,0.9988064231296563,0.9982144279531636,225104,80,75662,458
12,7,giraffe,Mid,125,0.7,210270,422,210270,14,6,70483,66,240,0.9996577003166273,0.9979307660911412,0.9989829790239424,0.9987934867283541,0.9981953882934697,210270,72,70723,436
12,7,safari,Mid,125,0.7,210270,422,210270,14,6,70483,66,240,0.9996577003166273,0.9979307660911412,0.9989829790239424,0.9987934867283541,0.9981953882934697,210270,72,70723,436
12,7,giraffe,Mid,125,0.85,255125,496,255125,17,8,85279,79,283,0.9996591069385452,0.9979932560886879,0.9989842263190464,0.9988254869335421,0.9982419488582923,255125,87,85562,513
12,7,safari,Mid,125,0.85,255125,496,255125,17,8,85279,79,283,0.9996591069385452,0.9979932560886879,0.9989842263190464,0.9988254869335421,0.9982419488582923,255125,87,85562,513
12,7,giraffe,Mid,125,0.8,239985,467,239985,16,8,80289,75,273,0.9996542646250229,0.9979914167373621,0.9989707979415959,0.9988221486007292,0.9982373806105639,239985,83,80562,483
12,7,safari,Mid,125,0.8,239985,467,239985,16,8,80289,75,273,0.9996542646250229,0.9979914167373621,0.9989707979415959,0.9988221486007292,0.9982373806105639,239985,83,80562,483
12,7,giraffe,Mid,125,0.95,285004,555,285004,18,8,95205,85,316,0.9996737952346043,0.9979935358939971,0.9990273390926016,0.9988329589222569,0.9982528443746048,285004,93,95521,573
12,7,safari,Mid,125,0.95,285004,555,285004,18,8,95205,85,316,0.9996737952346043,0.9979935358939971,0.9990273390926016,0.9988329589222569,0.9982528443746048,285004,93,95521,573
12,7,giraffe,Mid,125,0.9,269987,531,269987,18,8,90227,83,300,0.9996630603010982,0.9979706952124671,0.9989957845019753,0.9988161608837358,0.9982279027783162,269987,91,90527,549
12,7,safari,Mid,125,0.9,269987,531,269987,18,8,90227,83,300,0.9996630603010982,0.9979706952124671,0.9989957845019753,0.9988161608837358,0.9982279027783162,269987,91,90527,549
12,7,giraffe,None,125,0.15,44879,82,44879,0,0,14958,11,49,0.9997549565604812,0.9981761971486399,0.9992675456119323,0.9989649530890029,0.9984494573100585,44879,11,15007,82
12,7,safari,None,125,0.15,44879,82,44879,0,0,14958,11,49,0.9997549565604812,0.9981761971486399,0.9992675456119323,0.9989649530890029,0.9984494573100585,44879,11,15007,82
12,7,giraffe,None,125,0.1,29905,50,29905,0,0,10014,7,26,0.999765980208612,0.9983308295776999,0.9993032746093361,0.9990478894883659,0.9985750712464376,29905,7,10040,50
12,7,safari,None,125,0.1,29905,50,29905,0,0,10014,7,26,0.999765980208612,0.9983308295776999,0.9993032746093361,0.9990478894883659,0.9985750712464376,29905,7,10040,50
12,7,giraffe,None,125,0.25,74863,137,74863,0,0,24988,21,87,0.9997195662624859,0.9981733333333334,0.9991632132610775,0.998945851458461,0.9984215153452686,74863,21,25075,137
12,7,safari,None,125,0.25,74863,137,74863,0,0,24988,21,87,0.9997195662624859,0.9981733333333334,0.9991632132610775,0.998945851458461,0.9984215153452686,74863,21,25075,137
12,7,giraffe,None,125,0.2,59885,108,59885,0,0,19912,16,69,0.9997328926061334,0.9981997899754972,0.9991998799819973,0.9989657530818891,0.9984498062257782,59885,16,19981,108
12,7,safari,None,125,0.2,59885,108,59885,0,0,19912,16,69,0.9997328926061334,0.9981997899754972,0.9991998799819973,0.9989657530818891,0.9984498062257782,59885,16,19981,108
12,7,giraffe,None,125,0.35,104751,195,104751,0,2,35010,32,117,0.9996755260772057,0.9981419015493682,0.9990330195386934,0.9989081251698604,0.9983655349126025,104751,34,35127,195
12,7,safari,None,125,0.35,104751,195,104751,0,2,35010,32,117,0.9996755260772057,0.9981419015493682,0.9990330195386934,0.9989081251698604,0.9983655349126025,104751,34,35127,195
12,7,giraffe,None,125,0.3,89632,168,89632,0,1,29886,27,107,0.9996877091233549,0.9981291759465479,0.9990673195429866,0.9989078346149559,0.9983642266380685,89632,28,29993,168
12,7,safari,None,125,0.3,89632,168,89632,0,1,29886,27,107,0.9996877091233549,0.9981291759465479,0.9990673195429866,0.9989078346149559,0.9983642266380685,89632,28,29993,168
12,7,giraffe,None,125,0.45,135088,258,135088,0,5,45252,41,144,0.999659597140616,0.9980937744743102,0.9989877206108886,0.9988760721679977,0.9983184724649866,135088,46,45396,258
12,7,safari,None,125,0.45,135088,258,135088,0,5,45252,41,144,0.999659597140616,0.9980937744743102,0.9989877206108886,0.9988760721679977,0.9983184724649866,135088,46,45396,258
12,7,giraffe,None,125,0.4,119726,219,119726,0,3,40041,36,129,0.9996743622928235,0.9981741631581141,0.9990300678952473,0.9989236994701931,0.9983890505388564,119726,39,40170,219
12,7,safari,None,125,0.4,119726,219,119726,0,3,40041,36,129,0.9996743622928235,0.9981741631581141,0.9990300678952473,0.9989236994701931,0.9983890505388564,119726,39,40170,219
12,7,giraffe,None,125,0.55,165117,318,165117,0,5,55335,55,169,0.9996367533010044,0.9980777949043431,0.9989201641350515,0.9988566658197525,0.9982895850207467,165117,60,55504,318
12,7,safari,None,125,0.55,165117,318,165117,0,5,55335,55,169,0.9996367533010044,0.9980777949043431,0.9989201641350515,0.9988566658197525,0.9982895850207467,165117,60,55504,318
12,7,giraffe,None,125,0.5,150179,286,150179,0,5,50378,50,159,0.9996339044424032,0.9980992257335592,0.998912871600253,0.9988659756101617,0.9983039635526244,150179,55,50537,286
12,7,safari,None,125,0.5,150179,286,150179,0,5,50378,50,159,0.9996339044424032,0.9980992257335592,0.998912871600253,0.9988659756101617,0.9983039635526244,150179,55,50537,286
12,7,giraffe,None,125,0.65,195306,389,195306,0,5,65459,64,211,0.9996468330134357,0.9980122128822914,0.9989503947428467,0.9988288541693303,0.9982481238094509,195306,69,65670,389
12,7,safari,None,125,0.65,195306,389,195306,0,5,65459,64,211,0.9996468330134357,0.9980122128822914,0.9989503947428467,0.9988288541693303,0.9982481238094509,195306,69,65670,389
12,7,giraffe,None,125,0.6,180211,352,180211,0,5,60355,58,187,0.9996505319680042,0.998050541916118,0.9989604818084317,0.9988498962135258,0.9982792078551052,180211,63,60542,352
12,7,safari,None,125,0.6,180211,352,180211,0,5,60355,58,187,0.9996505319680042,0.998050541916118,0.9989604818084317,0.9988498962135258,0.9982792078551052,180211,63,60542,352
12,7,giraffe,None,125,0.75,225134,433,225134,0,5,75410,74,246,0.9996492209597136,0.9980803929652831,0.9989568891529675,0.9988641909578951,0.9983007082594871,225134,79,75656,433
12,7,safari,None,125,0.75,225134,433,225134,0,5,75410,74,246,0.9996492209597136,0.9980803929652831,0.9989568891529675,0.9988641909578951,0.9983007082594871,225134,79,75656,433
12,7,giraffe,None,125,0.7,210297,414,210297,0,5,70486,70,227,0.9996434886772004,0.9980352236000968,0.9989404983895576,0.9988387087581307,0.9982628712713011,210297,75,70713,414
12,7,safari,None,125,0.7,210297,414,210297,0,5,70486,70,227,0.9996434886772004,0.9980352236000968,0.9989404983895576,0.9988387087581307,0.9982628712713011,210297,75,70713,414
12,7,giraffe,None,125,0.85,255159,485,255159,0,5,85286,87,286,0.9996395704620158,0.9981028304986622,0.9989260366081435,0.9988706094207225,0.9983094448416093,255159,92,85572,485
12,7,safari,None,125,0.85,255159,485,255159,0,5,85286,87,286,0.9996395704620158,0.9981028304986622,0.9989260366081435,0.9988706094207225,0.9983094448416093,255159,92,85572,485
12,7,giraffe,None,125,0.8,240015,457,240015,0,5,80294,78,266,0.9996543078243051,0.9980995708440068,0.9989707724167007,0.998876334352956,0.9983183594662348,240015,83,80560,457
12,7,safari,None,125,0.8,240015,457,240015,0,5,80294,78,266,0.9996543078243051,0.9980995708440068,0.9989707724167007,0.998876334352956,0.9983183594662348,240015,83,80560,457
12,7,giraffe,None,125,0.95,285032,552,285032,0,6,95212,92,313,0.999656297127626,0.9980671186060843,0.9989751419637535,0.9988610757752571,0.9982948896531281,285032,98,95525,552
12,7,safari,None,125,0.95,285032,552,285032,0,6,95212,92,313,0.999656297127626,0.9980671186060843,0.9989751419637535,0.9988610757752571,0.9982948896531281,285032,98,95525,552
12,7,giraffe,None,125,0.9,270021,522,270021,0,5,90233,90,300,0.9996482992492115,0.9980705470110112,0.9989517588383281,0.9988588000939594,0.998291667935687,270021,95,90533,522
12,7,safari,None,125,0.9,270021,522,270021,0,5,90233,90,300,0.9996482992492115,0.9980705470110112,0.9989517588383281,0.9988588000939594,0.998291667935687,270021,95,90533,522
12,7,giraffe,Single-stranded,125,0.15,44867,94,44867,0,0,14958,11,49,0.999754891037925,0.9979092991703922,0.9992675456119323,0.9988312425561282,0.9982493872855499,44867,11,15007,94
12,7,safari,Single-stranded,125,0.15,44867,94,44867,0,0,14958,11,49,0.999754891037925,0.9979092991703922,0.9992675456119323,0.9988312425561282,0.9982493872855499,44867,11,15007,94
12,7,giraffe,Single-stranded,125,0.1,29888,67,29888,0,0,10014,7,26,0.9997658471316274,0.9977633116341178,0.9993032746093361,0.998763575605681,0.9981500924953752,29888,7,10040,67
12,7,safari,Single-stranded,125,0.1,29888,67,29888,0,0,10014,7,26,0.9997658471316274,0.9977633116341178,0.9993032746093361,0.998763575605681,0.9981500924953752,29888,7,10040,67
12,7,giraffe,Single-stranded,125,0.25,74846,154,74846,0,0,24987,21,87,0.9997195025845833,0.9979466666666666,0.999163179916318,0.9988322979708674,0.998251660922124,74846,21,25074,154
12,7,safari,Single-stranded,125,0.25,74846,154,74846,0,0,24987,21,87,0.9997195025845833,0.9979466666666666,0.999163179916318,0.9988322979708674,0.998251660922124,74846,21,25074,154
12,7,giraffe,Single-stranded,125,0.2,59882,111,59882,0,0,19911,16,69,0.999732879228021,0.9981497841414831,0.9991998399679936,0.9989407044732299,0.9984122816887322,59882,16,19980,111
12,7,safari,Single-stranded,125,0.2,59882,111,59882,0,0,19911,16,69,0.999732879228021,0.9981497841414831,0.9991998399679936,0.9989407044732299,0.9984122816887322,59882,16,19980,111
12,7,giraffe,Single-stranded,125,0.35,104737,209,104737,0,2,35008,32,117,0.9996754827194548,0.9980084996093229,0.9990329645325521,0.9988412956508057,0.9982655865243925,104737,34,35125,209
12,7,safari,Single-stranded,125,0.35,104737,209,104737,0,2,35008,32,117,0.9996754827194548,0.9980084996093229,0.9990329645325521,0.9988412956508057,0.9982655865243925,104737,34,35125,209
12,7,giraffe,Single-stranded,125,0.3,89613,187,89613,0,1,29884,27,107,0.999687642931248,0.9979175946547885,0.9990672574036443,0.9988018345862987,0.9982056268204542,89613,28,29991,187
12,7,safari,Single-stranded,125,0.3,89613,187,89613,0,1,29884,27,107,0.999687642931248,0.9979175946547885,0.9990672574036443,0.9988018345862987,0.9982056268204542,89613,28,29991,187
12,7,giraffe,Single-stranded,125,0.45,135091,254,135091,1,3,45252,41,144,0.9996743996743996,0.9981159398873997,0.999031690140845,0.9988945619100786,0.998346110871417,135091,44,45396,255
12,7,safari,Single-stranded,125,0.45,135091,254,135091,1,3,45252,41,144,0.9996743996743996,0.9981159398873997,0.999031690140845,0.9988945619100786,0.998346110871417,135091,44,45396,255
12,7,giraffe,Single-stranded,125,0.4,119711,234,119711,0,3,40039,36,129,0.9996743215031315,0.9980491058401767,0.99903001964832,0.9988610525876634,0.9982953693990709,119711,39,40168,234
12,7,safari,Single-stranded,125,0.4,119711,234,119711,0,3,40039,36,129,0.9996743215031315,0.9980491058401767,0.99903001964832,0.9988610525876634,0.9982953693990709,119711,39,40168,234
12,7,giraffe,Single-stranded,125,0.55,165113,318,165113,2,3,55336,54,170,0.9996549010110795,0.9980656821794927,0.9989741374655796,0.9988596594707249,0.9982940867708013,165113,57,55506,320
12,7,safari,Single-stranded,125,0.55,165113,318,165113,2,3,55336,54,170,0.9996549010110795,0.9980656821794927,0.9989741374655796,0.9988596594707249,0.9982940867708013,165113,57,55506,320
12,7,giraffe,Single-stranded,125,0.5,150181,283,150181,1,3,50378,50,159,0.999647217008134,0.9981125178612966,0.9989523621269025,0.9988792779490454,0.9983238417348487,150181,53,50537,284
12,7,safari,Single-stranded,125,0.5,150181,283,150181,1,3,50378,50,159,0.999647217008134,0.9981125178612966,0.9989523621269025,0.9988792779490454,0.9983238417348487,150181,53,50537,284
12,7,giraffe,Single-stranded,125,0.65,195313,379,195313,2,3,65460,63,212,0.999662195015841,0.9980530828742833,0.9989960144817305,0.9988569908942831,0.9982901863582117,195313,66,65672,381
12,7,safari,Single-stranded,125,0.65,195313,379,195313,2,3,65460,63,212,0.999662195015841,0.9980530828742833,0.9989960144817305,0.9988569908942831,0.9982901863582117,195313,66,65672,381
12,7,giraffe,Single-stranded,125,0.6,180212,348,180212,2,3,60356,57,188,0.9996671696103666,0.9980616076472347,0.9990099663388555,0.9988637434388112,0.9982999261919177,180212,60,60544,350
12,7,safari,Single-stranded,125,0.6,180212,348,180212,2,3,60356,57,188,0.9996671696103666,0.9980616076472347,0.9990099663388555,0.9988637434388112,0.9982999261919177,180212,60,60544,350
12,7,giraffe,Single-stranded,125,0.75,225114,450,225114,2,4,75410,73,247,0.9996580680400193,0.9979961519023257,0.9989832835978556,0.998826418669039,0.9982442748091603,225114,77,75657,452
12,7,safari,Single-stranded,125,0.75,225114,450,225114,2,4,75410,73,247,0.9996580680400193,0.9979961519023257,0.9989832835978556,0.998826418669039,0.9982442748091603,225114,77,75657,452
12,7,giraffe,Single-stranded,125,0.7,210295,413,210295,2,3,70487,69,228,0.9996577409954983,0.9980304684163068,0.9989828640852134,0.998843441935798,0.9982699638006799,210295,72,70715,415
12,7,safari,Single-stranded,125,0.7,210295,413,210295,2,3,70487,69,228,0.9996577409954983,0.9980304684163068,0.9989828640852134,0.998843441935798,0.9982699638006799,210295,72,70715,415
12,7,giraffe,Single-stranded,125,0.85,255141,499,255141,3,5,85287,86,287,0.9996434616349047,0.9980363240925822,0.9989377225237845,0.9988392463909959,0.9982625663623472,255141,91,85574,502
12,7,safari,Single-stranded,125,0.85,255141,499,255141,3,5,85287,86,287,0.9996434616349047,0.9980363240925822,0.9989377225237845,0.9988392463909959,0.9982625663623472,255141,91,85574,502
12,7,giraffe,Single-stranded,125,0.8,239998,470,239998,3,5,80295,77,267,0.9996584471842719,0.9980330268514707,0.9989831853578691,0.9988450757567875,0.9982716472291858,239998,82,80562,473
12,7,safari,Single-stranded,125,0.8,239998,470,239998,3,5,80295,77,267,0.9996584471842719,0.9980330268514707,0.9989831853578691,0.9988450757567875,0.9982716472291858,239998,82,80562,473
12,7,giraffe,Single-stranded,125,0.95,285025,554,285025,3,6,95213,91,314,0.9996597947545262,0.998049596963394,0.9989856103070359,0.9988540469315091,0.9982843921659156,285025,97,95527,557
12,7,safari,Single-stranded,125,0.95,285025,554,285025,3,6,95213,91,314,0.9996597947545262,0.998049596963394,0.9989856103070359,0.9988540469315091,0.9982843921659156,285025,97,95527,557
12,7,giraffe,Single-stranded,125,0.9,270008,530,270008,3,5,90234,89,301,0.9996519833248181,0.9980298734757393,0.9989628044003575,0.9988402698268544,0.9982639754132403,270008,94,90535,533
12,7,safari,Single-stranded,125,0.9,270008,530,270008,3,5,90234,89,301,0.9996519833248181,0.9980298734757393,0.9989628044003575,0.9988402698268544,0.9982639754132403,270008,94,90535,533
15,15,giraffe,High,125,0.15,40830,84,40830,4046,0,14956,7,53,0.9998285868207752,0.9081405693950177,0.9995338305807139,0.951781530822756,0.9310224089635855,40830,7,15009,4130
15,15,safari,High,125,0.15,40872,84,40872,4004,0,14956,7,53,0.9998287629345141,0.9090747330960854,0.9995338305807139,0.9522944116310768,0.9317226890756303,40872,7,15009,4088
15,15,giraffe,High,125,0.1,27209,53,27209,2692,0,10014,5,28,0.9998162710369662,0.9083594845429659,0.9995023390066686,0.9518961656870977,0.9312517187070323,27209,5,10042,2745
15,15,safari,High,125,0.1,27235,53,27235,2666,0,10014,5,28,0.9998164464023495,0.9092274821392802,0.9995023390066686,0.9523726264992831,0.9319017024574385,27235,5,10042,2719
15,15,giraffe,High,125,0.25,68040,145,68040,6814,0,24986,13,95,0.9998089724185562,0.9072120961612822,0.9994819478759863,0.9512624779800353,0.9303447793551997,68040,13,25081,6959
15,15,safari,High,125,0.25,68115,145,68115,6739,0,24986,13,95,0.9998091827148896,0.9082121094947933,0.9994819478759863,0.9518120270808443,0.931094082503272,68115,13,25081,6884
15,15,giraffe,High,125,0.2,54486,113,54486,5393,0,19910,9,76,0.9998348472336912,0.9082210961461529,0.999549887471868,0.9518285918925293,0.9310512958355733,54486,9,19986,5506
15,15,safari,High,125,0.2,54544,113,54544,5335,0,19910,9,76,0.999835022821843,0.9091878917188958,0.999549887471868,0.9523593347592649,0.931776413667221,54544,9,19986,5448
15,15,giraffe,High,125,0.35,95357,203,95357,9384,0,35010,18,131,0.9998112712975098,0.9086465162372312,0.9994880400466453,0.952051477892761,0.9314432952898939,95357,18,35141,9587
15,15,safari,High,125,0.35,95450,203,95450,9291,0,35010,18,131,0.9998114551472744,0.9095327031559689,0.9994880400466453,0.95253777218929,0.9321070926389871,95450,18,35141,9494
15,15,giraffe,High,125,0.3,81537,178,81537,8084,0,29885,16,118,0.9998038085662084,0.9079945210971169,0.9994670042306539,0.9516900882394136,0.9309118830225842,81537,16,30003,8262
15,15,safari,High,125,0.3,81619,178,81619,8002,0,29885,16,118,0.999804005634838,0.9089076715776345,0.9994670042306539,0.9521915139353919,0.9315962543190506,81619,16,30003,8180
15,15,giraffe,High,125,0.45,122926,263,122926,12155,0,45255,22,163,0.9998210625630348,0.9082486109469204,0.9995158450704226,0.9518374552831679,0.9311886007611293,122926,22,45418,12418
15,15,safari,High,125,0.45,123048,263,123048,12033,0,45255,22,163,0.9998212399447469,0.9091500177325925,0.9995158450704226,0.9523323039773387,0.9318634392424109,123048,22,45418,12296
15,15,giraffe,High,125,0.4,108987,229,108987,10727,0,40042,20,145,0.9998165255442311,0.9086566118906481,0.9995025741786256,0.9520594016160734,0.9314642522635029,108987,20,40187,10956
15,15,safari,High,125,0.4,109097,229,109097,10617,0,40042,20,145,0.9998167105034046,0.9095737141809026,0.9995025741786256,0.9525626473413079,0.9321511083359351,109097,20,40187,10846
15,15,giraffe,High,125,0.55,150213,316,150213,14904,0,55338,27,197,0.9998202875399361,0.907999008662117,0.9995140563694611,0.951700018690227,0.931007488857214,150213,27,55535,15220
15,15,safari,High,125,0.55,150363,317,150363,14753,0,55338,27,197,0.9998204667863555,0.9089057201404799,0.9995140563694611,0.9521979083220664,0.9316862372451865,150363,27,55535,15070
15,15,giraffe,High,125,0.5,136653,288,136653,13522,0,50381,27,182,0.9998024582967515,0.908216637977443,0.99946629768729,0.9518114667604644,0.9311773512456915,136653,27,50563,13810
15,15,safari,High,125,0.5,136794,288,136794,13381,0,50381,27,182,0.999802661872081,0.909153745439078,0.99946629768729,0.952325921387895,0.9318786588610963,136794,27,50563,13669
15,15,giraffe,High,125,0.65,177698,378,177698,17617,0,65462,30,245,0.9998312027367663,0.908044743552401,0.9995436360040768,0.9517300848104419,0.9310522893317523,177698,30,65707,17995
15,15,safari,High,125,0.65,177872,379,177872,17442,0,65462,30,245,0.9998313678317275,0.9089338913502272,0.9995436360040768,0.9522183112729025,0.9317178594652489,177872,30,65707,17821
15,15,giraffe,High,125,0.6,163887,354,163887,16320,0,60358,27,218,0.9998352794758227,0.9076544768803895,0.9995544775011138,0.9515175266710211,0.9307483704035429,163887,27,60576,16674
15,15,safari,High,125,0.6,164049,355,164049,16157,0,60358,27,218,0.9998354421121919,0.9085516805954774,0.9995544775011138,0.9520103761348898,0.9314201124545952,164049,27,60576,16512
15,15,giraffe,High,125,0.75,204846,423,204846,20298,0,75413,32,288,0.9998438094866213,0.9081381585072285,0.9995774629289742,0.9517871040434899,0.931121805509459,204846,32,75701,20721
15,15,safari,High,125,0.75,205048,424,205048,20095,0,75413,32,288,0.9998439633313829,0.9090336795719232,0.9995774629289742,0.9522787805325476,0.9317922336541653,205048,32,75701,20519
15,15,giraffe,High,125,0.7,191371,397,191371,18943,0,70489,31,266,0.9998380372200918,0.9082155179368898,0.9995620602944085,0.9518269740097933,0.9311857675215011,191371,31,70755,19340
15,15,safari,High,125,0.7,191562,398,191562,18751,0,70489,31,266,0.9998381986815802,0.9091219727494055,0.9995620602944085,0.9523246102449888,0.9318642827454644,191562,31,70755,19149
15,15,giraffe,High,125,0.85,232092,478,232092,23076,0,85287,40,333,0.9998276842486171,0.9078647817685394,0.999533037590474,0.9516296347928772,0.9308714174377245,232092,40,85620,23554
15,15,safari,High,125,0.85,232324,479,232324,22843,0,85287,40,333,0.9998278562944346,0.9087722866776715,0.999533037590474,0.9521280301633164,0.931551159370184,232324,40,85620,23322
15,15,giraffe,High,125,0.8,218332,449,218332,21693,0,80297,35,309,0.9998397193715167,0.9079235177191713,0.9995659776044444,0.9516673531789879,0.9309375145975741,218332,35,80606,22142
15,15,safari,High,125,0.8,218550,450,218550,21474,0,80297,35,309,0.9998398792231855,0.9088300606302553,0.9995659776044444,0.9521651900953909,0.9316163991093533,218550,35,80606,21924
15,15,giraffe,High,125,0.95,259258,548,259258,25780,0,95215,41,364,0.9998418813801827,0.9078106069625261,0.9995712194101652,0.9516063022472631,0.9308274266407139,259258,41,95579,26328
15,15,safari,High,125,0.95,259515,549,259515,25522,0,95215,41,364,0.9998420379417159,0.9087105110194478,0.9995712194101652,0.9521005536172227,0.9315016028079306,259515,41,95579,26071
15,15,giraffe,High,125,0.9,245582,518,245582,24445,0,90235,41,349,0.999833077521242,0.9077306917518343,0.9995475862068965,0.9515584073402459,0.9307694437522497,245582,41,90584,24963
15,15,safari,High,125,0.9,245827,519,245827,24199,0,90235,41,349,0.999833243854426,0.9086362712302944,0.9995475862068965,0.9520558157908495,0.9314477946673312,245827,41,90584,24718
15,15,giraffe,Mid,125,0.15,44617,86,44617,256,0,14956,5,62,0.9998879476491417,0.9923930692408639,0.999667176995274,0.9961264107344191,0.9942149311460104,44617,5,15018,342
15,15,safari,Mid,125,0.15,44617,86,44617,256,0,14956,5,62,0.9998879476491417,0.9923930692408639,0.999667176995274,0.9961264107344191,0.9942149311460104,44617,5,15018,342
15,15,giraffe,Mid,125,0.1,29729,61,29729,163,0,10014,4,42,0.9998654693438267,0.9925216172002804,0.9996023856858847,0.9961800087122608,0.9943018518981331,29729,4,10056,224
15,15,safari,Mid,125,0.1,29729,61,29729,163,0,10014,4,42,0.9998654693438267,0.9925216172002804,0.9996023856858847,0.9961800087122608,0.9943018518981331,29729,4,10056,224
15,15,giraffe,Mid,125,0.25,74391,150,74391,456,0,24986,14,99,0.99981184060211,0.9919196767870715,0.9994422088529423,0.99585012248832,0.99380594629156,74391,14,25085,606
15,15,safari,Mid,125,0.25,74393,150,74393,454,0,24986,14,99,0.9998118456596825,0.9919463445204475,0.9994422088529423,0.9958635645631977,0.9938259271099744,74393,14,25085,604
15,15,giraffe,Mid,125,0.2,59512,114,59512,364,0,19910,8,83,0.9998655913978495,0.9920320053342224,0.9996000199990001,0.9959333946950045,0.9939243164856046,59512,8,19993,478
15,15,safari,Mid,125,0.2,59512,114,59512,364,0,19910,8,83,0.9998655913978495,0.9920320053342224,0.9996000199990001,0.9959333946950045,0.9939243164856046,59512,8,19993,478
15,15,giraffe,Mid,125,0.35,104109,200,104109,634,1,35009,19,135,0.999807930547686,0.9920528286784255,0.9994312364918667,0.9959152827733987,0.9939046585823692,104109,20,35144,834
15,15,safari,Mid,125,0.35,104113,200,104113,630,1,35009,19,135,0.9998079379255376,0.9920909446080253,0.9994312364918667,0.9959344927203505,0.9939332081908827,104113,20,35144,830
15,15,giraffe,Mid,125,0.3,89072,180,89072,545,0,29885,18,119,0.9997979571220115,0.9919262336158223,0.9994004396775698,0.9958465399945217,0.9937989801283603,89072,18,30004,725
15,15,safari,Mid,125,0.3,89074,180,89074,543,0,29885,18,119,0.9997979616576124,0.9919485060748132,0.9994004396775698,0.9958577665479711,0.9938156719718909,89074,18,30004,723
15,15,giraffe,Mid,125,0.45,134253,269,134253,820,1,45256,25,171,0.9998063732973883,0.9919537172496342,0.9994279805513387,0.9958645654455698,0.993832794048508,134253,26,45427,1089
15,15,safari,Mid,125,0.45,134258,269,134258,815,1,45256,25,171,0.9998063805069852,0.9919906606966057,0.9994279805513387,0.9958831863395964,0.9938604496805774,134258,26,45427,1084
15,15,giraffe,Mid,125,0.4,118974,236,118974,731,1,40041,21,153,0.9998151198359608,0.9919377027038294,0.99945295404814,0.9958608336088592,0.9938248094057706,118974,22,40194,967
15,15,safari,Mid,125,0.4,118979,236,118979,726,1,40041,21,153,0.9998151276039697,0.9919793898666844,0.99945295404814,0.9958818458035841,0.9938560287717677,118979,22,40194,962
15,15,giraffe,Mid,125,0.55,164069,331,164069,1031,1,55339,30,209,0.9998110907982938,0.9917669602432434,0.9994422353766711,0.9957727801026307,0.9936971177774762,164069,31,55548,1362
15,15,safari,Mid,125,0.55,164074,331,164074,1026,1,55339,30,209,0.9998110965540355,0.9917971843245824,0.9994422353766711,0.9957880170906973,0.9937197411881815,164074,31,55548,1357
15,15,giraffe,Mid,125,0.5,149238,294,149238,929,1,50382,28,192,0.9998057172717345,0.9918716478024205,0.9994269114479378,0.9958228794106656,0.9937731269645486,149238,29,50574,1223
15,15,safari,Mid,125,0.5,149243,294,149243,924,1,50382,28,192,0.9998057237794093,0.9919048790051908,0.9994269114479378,0.9958396306045714,0.9937979946683643,149243,29,50574,1218
15,15,giraffe,Mid,125,0.65,194086,388,194086,1219,1,65461,36,251,0.9998093991953555,0.9917881579821455,0.9994372537985369,0.9957826256490241,0.9937117984103548,194086,37,65712,1607
15,15,safari,Mid,125,0.65,194092,388,194092,1213,1,65461,36,251,0.9998094050863086,0.991818818251036,0.9994372537985369,0.9957980822016202,0.993734748051193,194092,37,65712,1601
15,15,giraffe,Mid,125,0.6,179090,357,179090,1113,1,60359,32,228,0.9998157690525504,0.9918586619406291,0.9994556252062026,0.995821320440499,0.9937681399784394,179090,33,60587,1470
15,15,safari,Mid,125,0.6,179096,357,179096,1107,1,60359,32,228,0.9998157752234423,0.9918918918918919,0.9994556252062026,0.9958380712226396,0.9937930176631562,179096,33,60587,1464
15,15,giraffe,Mid,125,0.75,223698,443,223698,1421,1,75412,41,288,0.9998122821131671,0.9917361966997987,0.99944548599192,0.9957578644208127,0.9936741629716167,223698,42,75700,1864
15,15,safari,Mid,125,0.75,223705,443,223705,1414,1,75412,41,288,0.9998122879859842,0.9917672302958832,0.99944548599192,0.9957735099897844,0.9936973953216685,223705,42,75700,1857
15,15,giraffe,Mid,125,0.7,208970,421,208970,1315,1,70488,38,268,0.9998134051643709,0.9917610319592228,0.9994491136379687,0.995770939804391,0.993694516182891,208970,39,70756,1736
15,15,safari,Mid,125,0.7,208977,421,208977,1308,1,70488,38,268,0.9998134114134803,0.9917942536045485,0.9994491136379687,0.995787688041132,0.9937193828796346,208977,39,70756,1729
15,15,giraffe,Mid,125,0.85,253515,495,253515,1628,1,85286,44,318,0.9998225272124941,0.9916952878680009,0.9994745998201964,0.9957423242039442,0.9936475752079628,253515,45,85604,2123
15,15,safari,Mid,125,0.85,253522,495,253522,1621,1,85286,44,318,0.9998225321118285,0.9917226703385256,0.9994745998201964,0.9957561296530866,0.9936680858046161,253522,45,85604,2116
15,15,giraffe,Mid,125,0.8,238482,466,238482,1520,1,80296,42,306,0.9998197253956609,0.9917411048455512,0.9994667989335979,0.9957640299545089,0.9936813520474101,238482,43,80602,1986
15,15,safari,Mid,125,0.8,238489,466,238489,1513,1,80296,42,306,0.9998197306860296,0.9917702147479083,0.9994667989335979,0.9957787056367433,0.9937031512271381,238489,43,80602,1979
15,15,giraffe,Mid,125,0.95,283190,553,283190,1834,1,95212,49,352,0.9998234712611214,0.9916414837329337,0.9994770640282804,0.9957156695387093,0.9936068794908589,283190,50,95564,2387
15,15,safari,Mid,125,0.95,283197,553,283197,1827,1,95212,49,352,0.9998234756237488,0.991665995510843,0.9994770640282804,0.995728028353234,0.9936252429884231,283197,50,95564,2380
15,15,giraffe,Mid,125,0.9,268271,530,268271,1735,1,90234,47,336,0.999821108456725,0.9916277316142769,0.9994703039131299,0.9957075651149198,0.9935955298847583,268271,48,90570,2265
15,15,safari,Mid,125,0.9,268278,530,268278,1728,1,90234,47,336,0.9998211131235885,0.9916536061744093,0.9994703039131299,0.9957206112140028,0.9936149121981205,268278,48,90570,2258
15,15,giraffe,None,125,0.15,44863,81,44863,17,0,14958,7,53,0.9998439937597504,0.9978203331776428,0.9995338926621388,0.9988311384711291,0.9982493872855499,44863,7,15011,98
15,15,safari,None,125,0.15,44863,81,44863,17,0,14958,7,53,0.9998439937597504,0.9978203331776428,0.9995338926621388,0.9988311384711291,0.9982493872855499,44863,7,15011,98
15,15,giraffe,None,125,0.1,29895,50,29895,10,0,10014,5,28,0.9998327759197324,0.9979969954932398,0.9995023390066686,0.9989140422688162,0.9983750812459377,29895,5,10042,60
15,15,safari,None,125,0.1,29895,50,29895,10,0,10014,5,28,0.9998327759197324,0.9979969954932398,0.9995023390066686,0.9989140422688162,0.9983750812459377,29895,5,10042,60
15,15,giraffe,None,125,0.25,74839,136,74839,25,0,24988,14,94,0.9998129667481598,0.9978533333333334,0.9994421421740517,0.9988321888784342,0.9982516783887468,74839,14,25082,161
15,15,safari,None,125,0.25,74839,136,74839,25,0,24988,14,94,0.9998129667481598,0.9978533333333334,0.9994421421740517,0.9988321888784342,0.9982516783887468,74839,14,25082,161
15,15,giraffe,None,125,0.2,59867,107,59867,19,0,19912,10,75,0.9998329909648112,0.9978997549714134,0.9994999249887483,0.9988654375573539,0.9982997874734342,59867,10,19987,126
15,15,safari,None,125,0.2,59867,107,59867,19,0,19912,10,75,0.9998329909648112,0.9978997549714134,0.9994999249887483,0.9988654375573539,0.9982997874734342,59867,10,19987,126
15,15,giraffe,None,125,0.35,104719,194,104719,33,0,35012,22,127,0.999789958087091,0.9978369828292646,0.999374306760331,0.9988125157973551,0.9982227868700351,104719,22,35139,227
15,15,safari,None,125,0.35,104719,194,104719,33,0,35012,22,127,0.999789958087091,0.9978369828292646,0.999374306760331,0.9988125157973551,0.9982227868700351,104719,22,35139,227
15,15,giraffe,None,125,0.3,89602,167,89602,31,0,29887,18,116,0.9997991519750056,0.9977951002227171,0.9994004197062056,0.9987961208337978,0.9981973109888918,89602,18,30003,198
15,15,safari,None,125,0.3,89602,167,89602,31,0,29887,18,116,0.9997991519750056,0.9977951002227171,0.9994004197062056,0.9987961208337978,0.9981973109888918,89602,18,30003,198
15,15,giraffe,None,125,0.45,135046,257,135046,43,0,45257,28,157,0.999792706220294,0.9977834586910584,0.9993838299370627,0.9987870719621329,0.9981857202911698,135046,28,45414,300
15,15,safari,None,125,0.45,135046,257,135046,43,0,45257,28,157,0.999792706220294,0.9977834586910584,0.9993838299370627,0.9987870719621329,0.9981857202911698,135046,28,45414,300
15,15,giraffe,None,125,0.4,119687,218,119687,40,0,40044,25,140,0.9997911654637798,0.997849014131477,0.9993782486507996,0.9988191456957236,0.9982329507848695,119687,25,40184,258
15,15,safari,None,125,0.4,119687,218,119687,40,0,40044,25,140,0.9997911654637798,0.997849014131477,0.9993782486507996,0.9988191456957236,0.9982329507848695,119687,25,40184,258
15,15,giraffe,None,125,0.55,165062,317,165062,56,0,55340,34,190,0.9997940592140331,0.997745338048176,0.9993880930098625,0.9987686480239372,0.9981583627075236,165062,34,55530,373
15,15,safari,None,125,0.55,165062,317,165062,56,0,55340,34,190,0.9997940592140331,0.997745338048176,0.9993880930098625,0.9987686480239372,0.9981583627075236,165062,34,55530,373
15,15,giraffe,None,125,0.5,150133,285,150133,47,0,50383,33,176,0.9997802431975281,0.9977935067956003,0.9993477229601518,0.9987858870176396,0.9981845944184983,150133,33,50559,332
15,15,safari,None,125,0.5,150133,285,150133,47,0,50383,33,176,0.9997802431975281,0.9977935067956003,0.9993477229601518,0.9987858870176396,0.9981845944184983,150133,33,50559,332
15,15,giraffe,None,125,0.65,195237,388,195237,70,0,65464,40,235,0.9997951627687849,0.9976596233935461,0.999391533184259,0.9987262514962707,0.9980951215220668,195237,40,65699,458
15,15,safari,None,125,0.65,195237,388,195237,70,0,65464,40,235,0.9997951627687849,0.9976596233935461,0.999391533184259,0.9987262514962707,0.9980951215220668,195237,40,65699,458
15,15,giraffe,None,125,0.6,180147,351,180147,65,0,60360,36,209,0.999800203126821,0.9976960949917757,0.9994059896048181,0.9987470408542297,0.9981257878325482,180147,36,60569,416
15,15,safari,None,125,0.6,180147,351,180147,65,0,60360,36,209,0.999800203126821,0.9976960949917757,0.9994059896048181,0.9987470408542297,0.9981257878325482,180147,36,60569,416
15,15,giraffe,None,125,0.75,225053,432,225053,82,0,75415,44,276,0.9998045287142876,0.9977212978848856,0.9994190268700073,0.9987618269930592,0.9981480375171755,225053,44,75691,514
15,15,safari,None,125,0.75,225053,432,225053,82,0,75415,44,276,0.9998045287142876,0.9977212978848856,0.9994190268700073,0.9987618269930592,0.9981480375171755,225053,44,75691,514
15,15,giraffe,None,125,0.7,210222,413,210222,76,0,70491,42,255,0.9998002511128866,0.9976792858464911,0.9994066790981523,0.9987386424371993,0.9981136700307994,210222,42,70746,489
15,15,safari,None,125,0.7,210222,413,210222,76,0,70491,42,255,0.9998002511128866,0.9976792858464911,0.9994066790981523,0.9987386424371993,0.9981136700307994,210222,42,70746,489
15,15,giraffe,None,125,0.85,255066,484,255066,94,1,85290,54,319,0.9997844160222012,0.9977390433571686,0.9993579566679118,0.9987606825056533,0.9981453701641919,255066,55,85609,578
15,15,safari,None,125,0.85,255066,484,255066,94,1,85290,54,319,0.9997844160222012,0.9977390433571686,0.9993579566679118,0.9987606825056533,0.9981453701641919,255066,55,85609,578
15,15,giraffe,None,125,0.8,239930,456,239930,86,0,80299,48,296,0.999799981664986,0.9977460993379687,0.9994047840482125,0.9987719845977729,0.9981626520094047,239930,48,80595,542
15,15,safari,None,125,0.8,239930,456,239930,86,0,80299,48,296,0.999799981664986,0.9977460993379687,0.9994047840482125,0.9987719845977729,0.9981626520094047,239930,48,80595,542
15,15,giraffe,None,125,0.95,284930,551,284930,103,1,95217,56,349,0.9997999908767768,0.9977099557398174,0.9994039091013668,0.9987538798852378,0.9981348716051909,284930,57,95566,654
15,15,safari,None,125,0.95,284930,551,284930,103,1,95217,56,349,0.9997999908767768,0.9977099557398174,0.9994039091013668,0.9987538798852378,0.9981348716051909,284930,57,95566,654
15,15,giraffe,None,125,0.9,269923,521,269923,99,1,90237,56,334,0.9997888732498703,0.997708312541814,0.9993710553029969,0.9987475093566787,0.9981255416409401,269923,57,90571,620
15,15,safari,None,125,0.9,269923,521,269923,99,1,90237,56,334,0.9997888732498703,0.997708312541814,0.9993710553029969,0.9987475093566787,0.9981255416409401,269923,57,90571,620
15,15,giraffe,Single-stranded,125,0.15,44806,94,44806,61,0,14958,7,53,0.9998437953272488,0.9965525677809657,0.9995338926621388,0.9981954686212043,0.9972990546691342,44806,7,15011,155
15,15,safari,Single-stranded,125,0.15,44806,94,44806,61,0,14958,7,53,0.9998437953272488,0.9965525677809657,0.9995338926621388,0.9981954686212043,0.9972990546691342,44806,7,15011,155
15,15,giraffe,Single-stranded,125,0.1,29843,67,29843,45,0,10014,5,28,0.9998324845885822,0.9962610582540478,0.9995023390066686,0.9980435764092102,0.9970751462426879,29843,5,10042,112
15,15,safari,Single-stranded,125,0.1,29843,67,29843,45,0,10014,5,28,0.9998324845885822,0.9962610582540478,0.9995023390066686,0.9980435764092102,0.9970751462426879,29843,5,10042,112
15,15,giraffe,Single-stranded,125,0.25,74754,154,74754,92,0,24987,14,94,0.9998127541194094,0.99672,0.999442119944212,0.9982639816249133,0.997402467655727,74754,14,25081,246
15,15,safari,Single-stranded,125,0.25,74754,154,74754,92,0,24987,14,94,0.9998127541194094,0.99672,0.999442119944212,0.9982639816249133,0.997402467655727,74754,14,25081,246
15,15,giraffe,Single-stranded,125,0.2,59812,111,59812,70,0,19911,10,75,0.9998328374176725,0.9969829813478239,0.999499899979996,0.9984058757250762,0.9976121716736052,59812,10,19986,181
15,15,safari,Single-stranded,125,0.2,59812,111,59812,70,0,19911,10,75,0.9998328374176725,0.9969829813478239,0.999499899979996,0.9984058757250762,0.9976121716736052,59812,10,19986,181
15,15,giraffe,Single-stranded,125,0.35,104609,208,104609,129,1,35009,22,127,0.9997801819710987,0.9967888247289082,0.9993458289484911,0.9982822624512115,0.9974304985546555,104609,23,35136,337
15,15,safari,Single-stranded,125,0.35,104609,208,104609,129,1,35009,22,127,0.9997801819710987,0.9967888247289082,0.9993458289484911,0.9982822624512115,0.9974304985546555,104609,23,35136,337
15,15,giraffe,Single-stranded,125,0.3,89499,187,89499,114,0,29885,18,116,0.9997989208753645,0.9966481069042317,0.9994003797594857,0.9982210275657076,0.9973376509568599,89499,18,30001,301
15,15,safari,Single-stranded,125,0.3,89499,187,89499,114,0,29885,18,116,0.9997989208753645,0.9966481069042317,0.9994003797594857,0.9982210275657076,0.9973376509568599,89499,18,30001,301
15,15,giraffe,Single-stranded,125,0.45,134928,253,134928,165,1,45254,28,157,0.9997851167408879,0.9969116191095415,0.9993617957746479,0.9983463002630381,0.9975274634097773,134928,29,45411,418
15,15,safari,Single-stranded,125,0.45,134928,253,134928,165,1,45254,28,157,0.9997851167408879,0.9969116191095415,0.9993617957746479,0.9983463002630381,0.9975274634097773,134928,29,45411,418
15,15,giraffe,Single-stranded,125,0.4,119564,233,119564,148,1,40041,25,140,0.9997825905176018,0.9968235441243903,0.9993533464322133,0.9983008746112259,0.9974586642689445,119564,26,40181,381
15,15,safari,Single-stranded,125,0.4,119564,233,119564,148,1,40041,25,140,0.9997825905176018,0.9968235441243903,0.9993533464322133,0.9983008746112259,0.9974586642689445,119564,26,40181,381
15,15,giraffe,Single-stranded,125,0.55,164901,317,164901,215,1,55338,34,190,0.9997877964786341,0.9967841966234064,0.9993700844086892,0.9982837372755919,0.9974343427030353,164901,35,55528,532
15,15,safari,Single-stranded,125,0.55,164901,317,164901,215,1,55338,34,190,0.9997877964786341,0.9967841966234064,0.9993700844086892,0.9982837372755919,0.9974343427030353,164901,35,55528,532
15,15,giraffe,Single-stranded,125,0.5,149995,282,149995,188,1,50380,33,176,0.9997733771470849,0.9968763499817234,0.9993279304210319,0.9983227618521501,0.9974932232473701,149995,34,50556,470
15,15,safari,Single-stranded,125,0.5,149995,282,149995,188,1,50380,33,176,0.9997733771470849,0.9968763499817234,0.9993279304210319,0.9983227618521501,0.9974932232473701,149995,34,50556,470
15,15,giraffe,Single-stranded,125,0.65,195064,378,195064,252,1,65462,40,235,0.9997898567438046,0.9967806882173189,0.9993763120265295,0.9982830048183337,0.997433366994094,195064,41,65697,630
15,15,safari,Single-stranded,125,0.65,195064,378,195064,252,1,65462,40,235,0.9997898567438046,0.9967806882173189,0.9993763120265295,0.9982830048183337,0.997433366994094,195064,41,65697,630
15,15,giraffe,Single-stranded,125,0.6,179986,347,179986,229,1,60358,36,209,0.9997944707065208,0.9968099600137349,0.9993894792422943,0.9982999847470083,0.9974581823308426,179986,37,60567,576
15,15,safari,Single-stranded,125,0.6,179986,347,179986,229,1,60358,36,209,0.9997944707065208,0.9968099600137349,0.9993894792422943,0.9982999847470083,0.9974581823308426,179986,37,60567,576
15,15,giraffe,Single-stranded,125,0.75,224828,448,224828,290,1,75413,44,276,0.9997998870473557,0.9967282303183991,0.9994058150896559,0.9982616958123075,0.9974012612014603,224828,45,75689,738
15,15,safari,Single-stranded,125,0.75,224828,448,224828,290,1,75413,44,276,0.9997998870473557,0.9967282303183991,0.9994058150896559,0.9982616958123075,0.9974012612014603,224828,45,75689,738
15,15,giraffe,Single-stranded,125,0.7,210030,411,210030,269,1,70489,42,255,0.9997953092496418,0.9967728157182858,0.9993925438286692,0.9982817746914682,0.9974315889689765,210030,43,70744,680
15,15,safari,Single-stranded,125,0.7,210030,411,210030,269,1,70489,42,255,0.9997953092496418,0.9967728157182858,0.9993925438286692,0.9982817746914682,0.9974315889689765,210030,43,70744,680
15,15,giraffe,Single-stranded,125,0.85,254812,497,254812,334,1,85291,54,319,0.9997842011715915,0.9967493731492746,0.9993579641627269,0.9982644806174219,0.9974041042108595,254812,55,85610,831
15,15,safari,Single-stranded,125,0.85,254812,497,254812,334,1,85291,54,319,0.9997842011715915,0.9967493731492746,0.9993579641627269,0.9982644806174219,0.9974041042108595,254812,55,85610,831
15,15,giraffe,Single-stranded,125,0.8,239688,468,239688,315,1,80299,48,296,0.9997956093552518,0.996743890115648,0.999392391250434,0.9982674174524372,0.997409027918347,239688,49,80595,783
15,15,safari,Single-stranded,125,0.8,239688,468,239688,315,1,80299,48,296,0.9997956093552518,0.996743890115648,0.999392391250434,0.9982674174524372,0.997409027918347,239688,49,80595,783
15,15,giraffe,Single-stranded,125,0.95,284646,552,284646,384,1,95218,56,349,0.9997997913615241,0.9967224825094019,0.9994039153350623,0.9982587653541649,0.9973951092060461,284646,57,95567,936
15,15,safari,Single-stranded,125,0.95,284646,552,284646,384,1,95218,56,349,0.9997997913615241,0.9967224825094019,0.9994039153350623,0.9982587653541649,0.9973951092060461,284646,57,95567,936
15,15,giraffe,Single-stranded,125,0.9,269649,528,269649,364,1,90238,56,334,0.9997886587617628,0.9967029027023631,0.99937106224277,0.9982433960762392,0.9973724284962759,269649,57,90572,892
15,15,safari,Single-stranded,125,0.9,269649,528,269649,364,1,90238,56,334,0.9997886587617628,0.9967029027023631,0.99937106224277,0.9982433960762392,0.9973724284962759,269649,57,90572,892
18,8,giraffe,High,125,0.15,41311,88,41311,3561,0,14956,5,55,0.9998789815083745,0.9188389679715302,0.9996670218433671,0.9576475497241411,0.9390756302521008,41311,5,15011,3649
18,8,safari,High,125,0.15,41366,88,41366,3506,0,14956,5,55,0.9998791423944309,0.9200622775800712,0.9996670218433671,0.9583116145996224,0.9399926637321595,41366,5,15011,3594
18,8,giraffe,High,125,0.1,27538,55,27538,2361,0,10014,4,29,0.9998547672645415,0.9193429925886359,0.999601871205335,0.9579101154862949,0.9395015124621885,27538,4,10043,2416
18,8,safari,High,125,0.1,27582,55,27582,2317,0,10014,4,29,0.9998549989124919,0.9208119115977833,0.999601871205335,0.9587069864442127,0.9406014849628759,27582,4,10043,2372
18,8,giraffe,High,125,0.25,68893,152,68893,5954,0,24986,11,97,0.9998403575989783,0.9185855811410819,0.9995616482027576,0.9574921996066794,0.9388868352432238,68893,11,25083,6106
18,8,safari,High,125,0.25,68976,152,68976,5871,0,24986,11,97,0.9998405496687782,0.9196922625635009,0.9995616482027576,0.9580931479449393,0.9397160640604239,68976,11,25083,6023
18,8,giraffe,High,125,0.2,55151,120,55151,4721,0,19910,7,78,0.9998730918452445,0.9193059074543273,0.9996499124781195,0.9578983933999131,0.9393901508995212,55151,7,19988,4841
18,8,safari,High,125,0.2,55219,120,55219,4653,0,19910,7,78,0.9998732481077753,0.9204393919189225,0.9996499124781195,0.9585134267215193,0.9402402890469701,55219,7,19988,4773
18,8,giraffe,High,125,0.35,96459,211,96459,8274,0,35010,16,133,0.9998341539258875,0.919147354779692,0.9995449244859069,0.9577944483886823,0.9393232122081612,96459,16,35143,8485
18,8,safari,High,125,0.35,96582,211,96582,8151,0,35010,16,133,0.9998343651007268,0.9203194084464095,0.9995449244859069,0.958430500838535,0.9402011377343812,96582,16,35143,8362
18,8,giraffe,High,125,0.3,82536,185,82536,7078,0,29885,14,120,0.9998304058146578,0.919119366585374,0.9995336287018222,0.9577775327968251,0.9392662204343254,82536,14,30005,7263
18,8,safari,High,125,0.3,82631,185,82631,6983,0,29885,14,120,0.9998306007622966,0.920177284824998,0.9995336287018222,0.9583516967827236,0.9400590896192559,82631,14,30005,7168
18,8,giraffe,High,125,0.45,124448,267,124448,10629,0,45255,20,165,0.9998393161294469,0.91949403002719,0.9995598591549296,0.9579850045417455,0.9396185503141871,124448,20,45420,10896
18,8,safari,High,125,0.45,124627,267,124627,10450,0,45255,20,165,0.9998395468803902,0.9208165858848564,0.9995598591549296,0.9587024166221139,0.9406086821842641,124627,20,45420,10717
18,8,giraffe,High,125,0.4,110286,235,110286,9422,0,40042,18,147,0.9998368146214099,0.9194867562091994,0.9995523167607631,0.9579799085330102,0.9395878863565408,110286,18,40189,9657
18,8,safari,High,125,0.4,110428,235,110428,9280,0,40042,18,147,0.9998370244282274,0.9206706518929825,0.9995523167607631,0.9586221564397606,0.9404745551045894,110428,18,40189,9515
18,8,giraffe,High,125,0.55,152091,323,152091,13019,0,55338,24,200,0.9998422246326792,0.9193510363712197,0.9995680501061877,0.9579087256099865,0.9395189936423901,152091,24,55538,13342
18,8,safari,High,125,0.55,152304,323,152304,12806,0,55338,24,200,0.9998424452497243,0.920638566670495,0.9995680501061877,0.9586072551382958,0.9404828163533112,152304,24,55538,13129
18,8,giraffe,High,125,0.5,138358,293,138358,11812,0,50381,24,185,0.9998265670390658,0.9195483274957963,0.9995255979442578,0.9580086205404282,0.9396726236365536,138358,24,50566,12105
18,8,safari,High,125,0.5,138551,293,138551,11619,0,50381,24,185,0.9998268085874076,0.9208310348723606,0.9995255979442578,0.9587043918100735,0.9406325695214695,138551,24,50566,11912
18,8,giraffe,High,125,0.65,179933,386,179933,15374,0,65462,27,248,0.9998499666592576,0.9194656937141339,0.9995892724036691,0.9579745137134535,0.9396128982901732,179933,27,65710,15760
18,8,safari,High,125,0.65,180183,386,180183,15124,0,65462,27,248,0.9998501747960713,0.9207432049179072,0.9995892724036691,0.9586675285911526,0.9405691772176108,180183,27,65710,15510
18,8,giraffe,High,125,0.6,165952,363,165952,14246,0,60358,25,220,0.9998493767208709,0.9190910551004924,0.999587479167698,0.9577708649556471,0.9393193013882669,165952,25,60578,14609
18,8,safari,High,125,0.6,166193,363,166193,14005,0,60358,25,220,0.9998495951100362,0.9204257840840492,0.999587479167698,0.9584951799272736,0.9403186213531041,166193,25,60578,14368
18,8,giraffe,High,125,0.75,207407,433,207407,17727,0,75413,29,291,0.9998601978441544,0.9194917696294227,0.9996170757793829,0.9579933626325914,0.9396315964155327,207407,29,75704,18160
18,8,safari,High,125,0.75,207688,433,207688,17446,0,75413,29,291,0.9998603869688085,0.9207375192293199,0.9996170757793829,0.9586691407944905,0.9405642217059409,207688,29,75704,17879
18,8,giraffe,High,125,0.7,193732,406,193732,16573,0,70489,28,269,0.9998554913294798,0.9194204384203957,0.99960444155624,0.9579524860867652,0.9395837255814449,193732,28,70758,16979
18,8,safari,High,125,0.7,193998,406,193998,16307,0,70489,28,269,0.9998556894436829,0.920682830986517,0.99960444155624,0.9586373373326383,0.9405286734849749,193998,28,70758,16713
18,8,giraffe,High,125,0.85,235049,493,235049,20104,0,85287,34,339,0.9998553702309397,0.9194315577008833,0.9996030819519028,0.9579584658742402,0.9395527766871956,235049,34,85626,20597
18,8,safari,High,125,0.85,235394,493,235394,19759,0,85287,34,339,0.9998555821737432,0.9207810800873082,0.9996030819519028,0.9586905435840627,0.9405635998195168,235394,34,85626,20252
18,8,giraffe,High,125,0.8,221119,460,221119,18895,0,80297,31,313,0.999859823649107,0.9195131282383958,0.9996155801639365,0.9580047831135297,0.9396291048378307,221119,31,80610,19355
18,8,safari,High,125,0.8,221433,460,221433,18581,0,80297,31,313,0.9998600223964166,0.9208188827066544,0.9996155801639365,0.9587130740488984,0.9406069476667238,221433,31,80610,19041
18,8,giraffe,High,125,0.95,262603,565,262603,22418,0,95215,35,370,0.9998667367250741,0.9195233659913301,0.9996339677891655,0.9580135127247257,0.9396179493502201,262603,35,95585,22983
18,8,safari,High,125,0.95,262967,565,262967,22054,0,95215,35,370,0.9998669211640976,0.9207979382742851,0.9996339677891655,0.958704893289682,0.940572813649313,262967,35,95585,22619
18,8,giraffe,High,125,0.9,248726,535,248726,21284,0,90235,35,355,0.999859302704202,0.919351679018278,0.9996137931034482,0.9579169121866491,0.9394910983747266,248726,35,90590,21819
18,8,safari,High,125,0.9,249089,535,249089,20921,0,90235,35,355,0.9998595077150335,0.9206934151435067,0.9996137931034482,0.958644829689668,0.9404961652407453,249089,35,90590,21456
18,8,giraffe,Mid,125,0.15,44693,86,44693,180,0,14956,6,61,0.9998657688091456,0.9940834982984497,0.9996006123943287,0.9969662495259763,0.9954653062585442,44693,6,15017,266
18,8,safari,Mid,125,0.15,44693,86,44693,180,0,14956,6,61,0.9998657688091456,0.9940834982984497,0.9996006123943287,0.9969662495259763,0.9954653062585442,44693,6,15017,266
18,8,giraffe,Mid,125,0.1,29783,61,29783,109,0,10014,5,41,0.9998321471733584,0.9943244416252128,0.9995029821073559,0.9970706884719037,0.9956264214130408,29783,5,10055,170
18,8,safari,Mid,125,0.1,29783,61,29783,109,0,10014,5,41,0.9998321471733584,0.9943244416252128,0.9995029821073559,0.9970706884719037,0.9956264214130408,29783,5,10055,170
18,8,giraffe,Mid,125,0.25,74543,150,74543,304,0,24986,16,97,0.999785404847168,0.9939464245236476,0.9993625244033627,0.9968573644654846,0.9953045076726342,74543,16,25083,454
18,8,safari,Mid,125,0.25,74544,150,74544,303,0,24986,16,97,0.9997854077253219,0.9939597583903356,0.9993625244033627,0.9968640718923221,0.9953144980818415,74544,16,25083,453
18,8,giraffe,Mid,125,0.2,59648,114,59648,228,0,19910,10,81,0.9998323778872908,0.9942990498416403,0.99950002499875,0.9970580369082642,0.9955995049443063,59648,10,19991,342
18,8,safari,Mid,125,0.2,59648,114,59648,228,0,19910,10,81,0.9998323778872908,0.9942990498416403,0.99950002499875,0.9970580369082642,0.9955995049443063,59648,10,19991,342
18,8,giraffe,Mid,125,0.35,104308,200,104308,435,0,35010,21,133,0.9997987136845939,0.9939490961760193,0.9994027983164601,0.996865323597997,0.9953178642037871,104308,21,35143,635
18,8,safari,Mid,125,0.35,104309,200,104309,434,0,35010,21,133,0.9997987156139174,0.9939586251584194,0.9994027983164601,0.9968701170241742,0.9953250016059155,104309,21,35143,634
18,8,giraffe,Mid,125,0.3,89254,180,89254,363,0,29885,20,117,0.9997759706073437,0.9939530273839883,0.9993338218639665,0.9968559956665234,0.9953012460461196,89254,20,30002,543
18,8,safari,Mid,125,0.3,89255,180,89255,362,0,29885,20,117,0.999775973116774,0.9939641636134837,0.9993338218639665,0.9968615975696926,0.9953095919678849,89255,20,30002,542
18,8,giraffe,Mid,125,0.45,134494,269,134494,579,1,45256,23,173,0.9998215852153615,0.9937343913936546,0.9994719820473896,0.996768694878826,0.9951768577670843,134494,24,45429,848
18,8,safari,Mid,125,0.45,134495,269,134495,578,1,45256,23,173,0.9998215865416781,0.9937417800830489,0.9994719820473896,0.9967724124641946,0.9951823888934982,134495,24,45429,847
18,8,giraffe,Mid,125,0.4,119196,236,119196,509,1,40041,22,152,0.9998070777308986,0.9937886127345945,0.9994280883230555,0.996788760662318,0.9952047053828431,119196,23,40193,745
18,8,safari,Mid,125,0.4,119197,236,119197,508,1,40041,22,152,0.9998070793491025,0.9937969501671655,0.9994280883230555,0.9967929553731587,0.9952109492560425,119197,23,40193,744
18,8,giraffe,Mid,125,0.55,164374,331,164374,726,1,55339,26,213,0.9998357674223393,0.9936106292049253,0.9995142050054877,0.9967134783768706,0.9950952445590697,164374,27,55552,1057
18,8,safari,Mid,125,0.55,164375,331,164375,725,1,55339,26,213,0.9998357684213087,0.9936166740211931,0.9995142050054877,0.9967165201783934,0.9950997692412108,164375,27,55552,1056
18,8,giraffe,Mid,125,0.5,149523,294,149523,644,1,50382,25,195,0.9998261439394446,0.9937658263603193,0.999486196470565,0.9967867737742074,0.9952055067043329,149523,26,50577,938
18,8,safari,Mid,125,0.5,149524,294,149524,643,1,50382,25,195,0.9998261451019725,0.9937724726008733,0.999486196470565,0.9967901176956846,0.9952104802450961,149524,26,50577,937
18,8,giraffe,Mid,125,0.65,194455,388,194455,850,1,65461,31,256,0.9998354645811802,0.9936737645189149,0.9995133005825184,0.9967450920088164,0.9951423260225978,194455,32,65717,1238
18,8,safari,Mid,125,0.65,194457,388,194457,848,1,65461,31,256,0.9998354662731569,0.993683984608545,0.9995133005825184,0.9967502345059486,0.9951499759028771,194457,32,65717,1236
18,8,giraffe,Mid,125,0.6,179418,357,179418,785,1,60359,29,231,0.9998328206499933,0.9936752326096588,0.9995051138238206,0.9967445167885159,0.9951405589186499,179418,30,60590,1142
18,8,safari,Mid,125,0.6,179419,357,179419,784,1,60359,29,231,0.9998328215816192,0.9936807709348693,0.9995051138238206,0.9967473035396338,0.9951447051994361,179419,30,60590,1141
18,8,giraffe,Mid,125,0.75,224127,443,224127,992,1,75412,36,293,0.9998349422744063,0.9936381128026884,0.9995114995643104,0.9967268959321899,0.9951145686748267,224127,37,75705,1435
18,8,safari,Mid,125,0.75,224130,443,224130,989,1,75412,36,293,0.999834944483354,0.993651412915296,0.9995114995643104,0.9967335884499331,0.9951245253962775,224130,37,75705,1432
18,8,giraffe,Mid,125,0.7,209362,421,209362,923,1,70488,32,274,0.9998424031137324,0.9936214440974628,0.9995338653859736,0.9967222168002456,0.9951083655120231,209362,33,70762,1344
18,8,safari,Mid,125,0.7,209365,421,209365,920,1,70488,32,274,0.9998424053715891,0.9936356819454596,0.9995338653859736,0.9967293812960599,0.9951190226677703,209365,33,70762,1341
18,8,giraffe,Mid,125,0.85,254008,495,254008,1135,1,85286,39,323,0.999842549439476,0.9936237961492422,0.9995329776179523,0.9967234728833047,0.9951067576555802,254008,40,85609,1630
18,8,safari,Mid,125,0.85,254012,495,254012,1131,1,85286,39,323,0.9998425519185049,0.9936394432752564,0.9995329776179523,0.9967313465047383,0.9951184779965249,254012,40,85609,1626
18,8,giraffe,Mid,125,0.8,238945,466,238945,1057,1,80296,37,311,0.9998409928739701,0.9936665169585974,0.9995287990575981,0.9967441928372243,0.995138782920654,238945,38,80607,1523
18,8,safari,Mid,125,0.8,238949,466,238949,1053,1,80296,37,311,0.999840995535322,0.9936831511885157,0.9995287990575981,0.9967525628056856,0.9951512395947844,238949,38,80607,1519
18,8,giraffe,Mid,125,0.95,283748,554,283748,1275,1,95212,44,357,0.9998414337210573,0.9935954226005596,0.9995293576254524,0.9967086428859968,0.9950838293663806,283748,45,95569,1829
18,8,safari,Mid,125,0.95,283753,554,283753,1270,1,95212,44,357,0.9998414365147041,0.9936129310133519,0.9995293576254524,0.9967174533479692,0.995096946150355,283753,45,95569,1824
18,8,giraffe,Mid,125,0.9,268798,530,268798,1208,1,90234,42,341,0.9998400541584059,0.9935757163556791,0.9995254805888455,0.9966980423711059,0.995068585700283,268798,43,90575,1738
18,8,safari,Mid,125,0.9,268802,530,268802,1204,1,90234,42,341,0.999840056538154,0.993590501818612,0.9995254805888455,0.9967054827663563,0.9950796613079185,268802,43,90575,1734
18,8,giraffe,None,125,0.15,44867,81,44867,13,0,14958,7,53,0.999844007665909,0.9979092991703922,0.9995338926621388,0.9988757165915289,0.9983160772937195,44867,7,15011,94
18,8,safari,None,125,0.15,44867,81,44867,13,0,14958,7,53,0.999844007665909,0.9979092991703922,0.9995338926621388,0.9988757165915289,0.9983160772937195,44867,7,15011,94
18,8,giraffe,None,125,0.1,29897,50,29897,8,0,10014,5,28,0.9998327871045415,0.9980637623101318,0.9995023390066686,0.9989474915214596,0.9984250787460627,29897,5,10042,58
18,8,safari,None,125,0.1,29897,50,29897,8,0,10014,5,28,0.9998327871045415,0.9980637623101318,0.9995023390066686,0.9989474915214596,0.9984250787460627,29897,5,10042,58
18,8,giraffe,None,125,0.25,74846,136,74846,18,0,24988,13,95,0.9998263401862167,0.9979466666666666,0.9994819891616193,0.9988856191486665,0.9983316016624041,74846,13,25083,154
18,8,safari,None,125,0.25,74846,136,74846,18,0,24988,13,95,0.9998263401862167,0.9979466666666666,0.9994819891616193,0.9988856191486665,0.9983316016624041,74846,13,25083,154
18,8,giraffe,None,125,0.2,59870,107,59870,16,0,19912,9,76,0.9998496968887256,0.9979497608054273,0.9995499324898734,0.9988988254137746,0.9983497937242155,59870,9,19988,123
18,8,safari,None,125,0.2,59870,107,59870,16,0,19912,9,76,0.9998496968887256,0.9979497608054273,0.9995499324898734,0.9988988254137746,0.9983497937242155,59870,9,19988,123
18,8,giraffe,None,125,0.35,104729,194,104729,23,0,35012,21,128,0.9997995226730311,0.997932269929297,0.9994027473621342,0.9988650236532886,0.9983012982934472,104729,21,35140,217
18,8,safari,None,125,0.35,104729,194,104729,23,0,35012,21,128,0.9997995226730311,0.997932269929297,0.9994027473621342,0.9988650236532886,0.9983012982934472,104729,21,35140,217
18,8,giraffe,None,125,0.3,89612,167,89612,21,0,29887,17,117,0.9998103292461146,0.9979064587973274,0.9994337297225275,0.9988574868053658,0.9982891145959389,89612,17,30004,188
18,8,safari,None,125,0.3,89612,167,89612,21,0,29887,17,117,0.9998103292461146,0.9979064587973274,0.9994337297225275,0.9988574868053658,0.9982891145959389,89612,17,30004,188
18,8,giraffe,None,125,0.45,135061,257,135061,28,1,45256,28,157,0.999785328299652,0.9978942857565055,0.9993618238633863,0.9988389119791743,0.9982631590592296,135061,29,45413,285
18,8,safari,None,125,0.45,135061,257,135061,28,1,45256,28,157,0.999785328299652,0.9978942857565055,0.9993618238633863,0.9988389119791743,0.9982631590592296,135061,29,45413,285
18,8,giraffe,None,125,0.4,119702,218,119702,25,0,40044,25,140,0.9997911916276195,0.9979740714494143,0.9993782486507996,0.9988818051336829,0.9983266106372617,119702,25,40184,243
18,8,safari,None,125,0.4,119702,218,119702,25,0,40044,25,140,0.9997911916276195,0.9979740714494143,0.9993782486507996,0.9988818051336829,0.9983266106372617,119702,25,40184,243
18,8,giraffe,None,125,0.55,165081,317,165081,37,1,55339,34,190,0.9997880278107513,0.9978601867803064,0.9993700957454467,0.9988231770589107,0.9982398110398689,165081,35,55529,354
18,8,safari,None,125,0.55,165081,317,165081,37,1,55339,34,190,0.9997880278107513,0.9978601867803064,0.9993700957454467,0.9988231770589107,0.9982398110398689,165081,35,55529,354
18,8,giraffe,None,125,0.5,150149,285,150149,31,1,50382,32,177,0.9997802666098468,0.9978998438174991,0.9993477229601518,0.9988391701896244,0.998264173841249,150149,33,50559,316
18,8,safari,None,125,0.5,150149,285,150149,31,1,50382,32,177,0.9997802666098468,0.9978998438174991,0.9993477229601518,0.9988391701896244,0.998264173841249,150149,33,50559,316
18,8,giraffe,None,125,0.65,195263,388,195263,44,1,65463,37,238,0.9998054285436326,0.9977924832008993,0.9994219565250461,0.9987979416669224,0.9982022231232357,195263,38,65701,432
18,8,safari,None,125,0.65,195263,388,195263,44,1,65463,37,238,0.9998054285436326,0.9977924832008993,0.9994219565250461,0.9987979416669224,0.9982022231232357,195263,38,65701,432
18,8,giraffe,None,125,0.6,180171,351,180171,41,1,60359,35,210,0.9998002297358038,0.9978290125884041,0.9994059896048181,0.9988136485849711,0.9982253035228554,180171,36,60569,392
18,8,safari,None,125,0.6,180171,351,180171,41,1,60359,35,210,0.9998002297358038,0.9978290125884041,0.9994059896048181,0.9988136485849711,0.9982253035228554,180171,36,60569,392
18,8,giraffe,None,125,0.75,225083,432,225083,52,1,75414,43,277,0.999804554762423,0.9978542960628106,0.9994190268700073,0.9988284734209907,0.9982476053925962,225083,44,75691,484
18,8,safari,None,125,0.75,225083,432,225083,52,1,75414,43,277,0.999804554762423,0.9978542960628106,0.9994190268700073,0.9988284734209907,0.9982476053925962,225083,44,75691,484
18,8,giraffe,None,125,0.7,210251,413,210251,47,1,70490,40,257,0.999805033001731,0.9978169151112187,0.9994208057862914,0.9988099847269498,0.9982202423454435,210251,41,70747,460
18,8,safari,None,125,0.7,210251,413,210251,47,1,70490,40,257,0.999805033001731,0.9978169151112187,0.9994208057862914,0.9988099847269498,0.9982202423454435,210251,41,70747,460
18,8,giraffe,None,125,0.85,255097,484,255097,63,1,85290,49,324,0.9998040345369532,0.9978603057376665,0.9994163242435562,0.9988312245125698,0.9982508467425316,255097,50,85614,547
18,8,safari,None,125,0.85,255097,484,255097,63,1,85290,49,324,0.9998040345369532,0.9978603057376665,0.9994163242435562,0.9988312245125698,0.9982508467425316,255097,50,85614,547
18,8,giraffe,None,125,0.8,239959,456,239959,57,1,80298,46,298,0.9998041715623776,0.9978666954988522,0.9994171843805414,0.9988344939830752,0.9982560764835028,239959,47,80596,513
18,8,safari,None,125,0.8,239959,456,239959,57,1,80298,46,298,0.9998041715623776,0.9978666954988522,0.9994171843805414,0.9988344939830752,0.9982560764835028,239959,47,80596,513
18,8,giraffe,None,125,0.95,284960,551,284960,73,1,95217,51,354,0.9998175515416895,0.9978150036416606,0.9994561977766855,0.9988152738540053,0.9982266852392532,284960,52,95571,624
18,8,safari,None,125,0.95,284960,551,284960,73,1,95217,51,354,0.9998175515416895,0.9978150036416606,0.9994561977766855,0.9988152738540053,0.9982266852392532,284960,52,95571,624
18,8,giraffe,None,125,0.9,269952,521,269952,70,1,90237,51,339,0.9998074102605887,0.9978155043745357,0.9994262258904533,0.9988104642149527,0.99821967987463,269952,52,90576,591
18,8,safari,None,125,0.9,269952,521,269952,70,1,90237,51,339,0.9998074102605887,0.9978155043745357,0.9994262258904533,0.9988104642149527,0.99821967987463,269952,52,90576,591
18,8,giraffe,Single-stranded,125,0.15,44827,94,44827,40,0,14958,7,53,0.9998438684926618,0.9970196392428994,0.9995338926621388,0.9984297566679659,0.9976491772120242,44827,7,15011,134
18,8,safari,Single-stranded,125,0.15,44827,94,44827,40,0,14958,7,53,0.9998438684926618,0.9970196392428994,0.9995338926621388,0.9984297566679659,0.9976491772120242,44827,7,15011,134
18,8,giraffe,Single-stranded,125,0.1,29860,67,29860,28,0,10014,5,28,0.9998325799430772,0.9968285761976298,0.9995023390066686,0.9983283182881979,0.9975001249937503,29860,5,10042,95
18,8,safari,Single-stranded,125,0.1,29860,67,29860,28,0,10014,5,28,0.9998325799430772,0.9968285761976298,0.9995023390066686,0.9983283182881979,0.9975001249937503,29860,5,10042,95
18,8,giraffe,Single-stranded,125,0.25,74779,155,74779,66,0,24987,13,95,0.9998261846186758,0.9970533333333333,0.9994819685196255,0.9984378337961973,0.9976622208901543,74779,13,25082,221
18,8,safari,Single-stranded,125,0.25,74779,155,74779,66,0,24987,13,95,0.9998261846186758,0.9970533333333333,0.9994819685196255,0.9984378337961973,0.9976622208901543,74779,13,25082,221
18,8,giraffe,Single-stranded,125,0.2,59835,111,59835,47,0,19911,9,76,0.9998496089833567,0.9973663594085976,0.9995499099819964,0.9986064404148969,0.9979122129292778,59835,9,19987,158
18,8,safari,Single-stranded,125,0.2,59835,111,59835,47,0,19911,9,76,0.9998496089833567,0.9973663594085976,0.9995499099819964,0.9986064404148969,0.9979122129292778,59835,9,19987,158
18,8,giraffe,Single-stranded,125,0.35,104642,209,104642,95,0,35010,21,128,0.9997993560283959,0.9971032721590151,0.9994027133877528,0.9984494940579841,0.9976803111951751,104642,21,35138,304
18,8,safari,Single-stranded,125,0.35,104642,209,104642,95,0,35010,21,128,0.9997993560283959,0.9971032721590151,0.9994027133877528,0.9984494940579841,0.9976803111951751,104642,21,35138,304
18,8,giraffe,Single-stranded,125,0.3,89529,188,89529,83,0,29885,17,117,0.9998101534406897,0.9969821826280624,0.9994336919950698,0.9983941654678665,0.9975963745315851,89529,17,30002,271
18,8,safari,Single-stranded,125,0.3,89529,188,89529,83,0,29885,17,117,0.9998101534406897,0.9969821826280624,0.9994336919950698,0.9983941654678665,0.9975963745315851,89529,17,30002,271
18,8,giraffe,Single-stranded,125,0.45,134973,254,134973,119,0,45255,28,157,0.9997925941289324,0.9972441003058827,0.9993838028169014,0.9985167211028789,0.9977819078910978,134973,28,45412,373
18,8,safari,Single-stranded,125,0.45,134973,254,134973,119,0,45255,28,157,0.9997925941289324,0.9972441003058827,0.9993838028169014,0.9985167211028789,0.9977819078910978,134973,28,45412,373
18,8,giraffe,Single-stranded,125,0.4,119605,234,119605,106,0,40042,25,140,0.9997910223188163,0.9971653674600859,0.9993782177232821,0.998476468746739,0.9977209151306259,119605,25,40182,340
18,8,safari,Single-stranded,125,0.4,119605,234,119605,106,0,40042,25,140,0.9997910223188163,0.9971653674600859,0.9993782177232821,0.998476468746739,0.9977209151306259,119605,25,40182,340
18,8,giraffe,Single-stranded,125,0.55,164961,318,164961,154,0,55339,34,190,0.9997939331494894,0.9971468812147516,0.9993880819970123,0.9984686527776098,0.9977103657984759,164961,34,55529,472
18,8,safari,Single-stranded,125,0.55,164961,318,164961,154,0,55339,34,190,0.9997939331494894,0.9971468812147516,0.9993880819970123,0.9984686527776098,0.9977103657984759,164961,34,55529,472
18,8,giraffe,Single-stranded,125,0.5,150043,283,150043,139,0,50381,32,177,0.9997867732800266,0.9971953610474197,0.999367463925677,0.9984893857722765,0.9977419114172739,150043,32,50558,422
18,8,safari,Single-stranded,125,0.5,150043,283,150043,139,0,50381,32,177,0.9997867732800266,0.9971953610474197,0.999367463925677,0.9984893857722765,0.9977419114172739,150043,32,50558,422
18,8,giraffe,Single-stranded,125,0.65,195134,379,195134,181,0,65463,37,238,0.9998104226550051,0.9971383895265057,0.9994371596336974,0.9984726184232408,0.9977164233911686,195134,37,65701,560
18,8,safari,Single-stranded,125,0.65,195134,379,195134,181,0,65463,37,238,0.9998104226550051,0.9971383895265057,0.9994371596336974,0.9984726184232408,0.9977164233911686,195134,37,65701,560
18,8,giraffe,Single-stranded,125,0.6,180048,348,180048,166,0,60359,35,210,0.999805645174725,0.9971533323733676,0.9994224803643323,0.9984777274050659,0.9977235597057629,180048,35,60569,514
18,8,safari,Single-stranded,125,0.6,180048,348,180048,166,0,60359,35,210,0.999805645174725,0.9971533323733676,0.9994224803643323,0.9984777274050659,0.9977235597057629,180048,35,60569,514
18,8,giraffe,Single-stranded,125,0.75,224908,450,224908,208,0,75414,43,277,0.99980884726007,0.9970828936985184,0.9994322233078934,0.9984440098819801,0.9976734152007966,224908,43,75691,658
18,8,safari,Single-stranded,125,0.75,224908,450,224908,208,0,75414,43,277,0.99980884726007,0.9970828936985184,0.9994322233078934,0.9984440098819801,0.9976734152007966,224908,43,75691,658
18,8,giraffe,Single-stranded,125,0.7,210104,413,210104,193,0,70490,40,257,0.9998096543322674,0.997124009301884,0.9994349244917852,0.998465025875957,0.9977051265199984,210104,40,70747,606
18,8,safari,Single-stranded,125,0.7,210104,413,210104,193,0,70490,40,257,0.9998096543322674,0.997124009301884,0.9994349244917852,0.998465025875957,0.9977051265199984,210104,40,70747,606
18,8,giraffe,Single-stranded,125,0.85,254918,499,254918,226,0,85292,49,324,0.9998078182666776,0.9971640138787293,0.999428004435884,0.9984841659975323,0.9977322535656943,254918,49,85616,725
18,8,safari,Single-stranded,125,0.85,254918,499,254918,226,0,85292,49,324,0.9998078182666776,0.9971640138787293,0.999428004435884,0.9984841659975323,0.9977322535656943,254918,49,85616,725
18,8,giraffe,Single-stranded,125,0.8,239781,470,239781,220,0,80300,46,298,0.9998081950739491,0.9971306311363948,0.9994295917861217,0.998467618020479,0.9977079862354609,239781,46,80598,690
18,8,safari,Single-stranded,125,0.8,239781,470,239781,220,0,80300,46,298,0.9998081950739491,0.9971306311363948,0.9994295917861217,0.998467618020479,0.9977079862354609,239781,46,80598,690
18,8,giraffe,Single-stranded,125,0.95,284773,554,284773,255,1,95218,51,354,0.9998174317563416,0.997167188408233,0.9994562034635657,0.9984905514834145,0.9977413786771457,284773,52,95572,809
18,8,safari,Single-stranded,125,0.95,284773,554,284773,255,1,95218,51,354,0.9998174317563416,0.997167188408233,0.9994562034635657,0.9984905514834145,0.9977413786771457,284773,52,95572,809
18,8,giraffe,Single-stranded,125,0.9,269768,530,269768,243,0,90239,51,339,0.9998109844006537,0.9971427620952092,0.9994372662172153,0.9984750906802873,0.9977185259019299,269768,51,90578,773
18,8,safari,Single-stranded,125,0.9,269768,530,269768,243,0,90239,51,339,0.9998109844006537,0.9971427620952092,0.9994372662172153,0.9984750906802873,0.9977185259019299,269768,51,90578,773
20,15,giraffe,High,125,0.15,36242,63,36242,8655,0,14956,2,58,0.9999448184527094,0.806094306049822,0.9998668087373468,0.8926161272843701,0.8546085100706949,36242,2,15014,8718
20,15,safari,High,125,0.15,36261,63,36261,8636,0,14956,2,58,0.9999448473650828,0.8065169039145907,0.9998668087373468,0.8928751708259974,0.8549253034547152,36261,2,15014,8699
20,15,giraffe,High,125,0.1,24234,44,24234,5676,0,10014,1,32,0.9999587373633175,0.8090405288108433,0.9999004678013337,0.8944250678181919,0.8569785755356116,24234,1,10046,5720
20,15,safari,High,125,0.1,24243,44,24243,5667,0,10014,1,32,0.9999587526810757,0.8093409895172597,0.9999004678013337,0.89460865714602,0.8572035699107522,24243,1,10046,5711
20,15,giraffe,High,125,0.25,60485,119,60485,14395,0,24986,6,102,0.9999008116909953,0.8064774196989293,0.999760899019686,0.8928334194405491,0.8549349105332041,60485,6,25088,14514
20,15,safari,High,125,0.25,60517,119,60517,14363,0,24986,6,102,0.999900864134296,0.8069040920545607,0.999760899019686,0.8930948480689482,0.855254613209715,60517,6,25088,14482
20,15,giraffe,High,125,0.2,48361,89,48361,11542,0,19910,3,82,0.9999379703912,0.8061241498866516,0.9998499624906226,0.8926316955221678,0.854551364596747,48361,3,19992,11631
20,15,safari,High,125,0.2,48386,89,48386,11517,0,19910,3,82,0.9999380024385708,0.8065408721162822,0.9998499624906226,0.8928871296629483,0.8548639153862503,48386,3,19992,11606
20,15,giraffe,High,125,0.35,84777,170,84777,19997,0,35010,9,140,0.9998938503998301,0.8078308431163287,0.9997440200233226,0.8936594107415801,0.8559916632763038,84777,9,35150,20167
20,15,safari,High,125,0.35,84839,171,84839,19934,0,35010,9,140,0.9998939279653026,0.8084216343954871,0.9997440200233226,0.8940208227954812,0.8564341948423659,84839,9,35150,20105
20,15,giraffe,High,125,0.3,72455,147,72455,17197,0,29885,8,126,0.9998895988297476,0.8068575373890577,0.999733502115327,0.893061838261577,0.8551803568745932,72455,8,30011,17344
20,15,safari,High,125,0.3,72502,148,72502,17149,0,29885,8,126,0.999889670390291,0.8073809285181349,0.999733502115327,0.8933823755922345,0.8555726184713482,72502,8,30011,17297
20,15,giraffe,High,125,0.45,109344,218,109344,25782,0,45255,13,172,0.9998811232934335,0.8078969145289041,0.9997139084507042,0.8936947540059093,0.8561100539870785,109344,13,45427,26000
20,15,safari,High,125,0.45,109427,219,109427,25698,0,45255,13,172,0.9998812134502923,0.8085101666863695,0.9997139084507042,0.8940698738479638,0.8565691654128684,109427,13,45427,25917
20,15,giraffe,High,125,0.4,96897,191,96897,22855,0,40042,11,154,0.9998864902794403,0.8078587328981266,0.9997264157982441,0.8936735362068886,0.8560287230721199,96897,11,40196,23046
20,15,safari,High,125,0.4,96971,192,96971,22780,0,40042,11,154,0.999886576890557,0.8084756926206614,0.9997264157982441,0.8940509392647228,0.8564907898844834,96971,11,40196,22972
20,15,giraffe,High,125,0.55,133605,265,133605,31563,0,55338,17,207,0.9998727754411698,0.8076079137777832,0.999694035491883,0.8935145708983296,0.8559017172334216,133605,17,55545,31828
20,15,safari,High,125,0.55,133711,266,133711,31456,0,55338,17,207,0.9998728762861929,0.8082486565558262,0.999694035491883,0.8939066255293971,0.8563813660942555,133711,17,55545,31722
20,15,giraffe,High,125,0.5,121550,242,121550,28671,0,50381,17,192,0.9998601594182632,0.8078398011471258,0.9996639652105159,0.8936514355034371,0.8561075935201166,121550,17,50573,28913
20,15,safari,High,125,0.5,121646,243,121646,28574,0,50381,17,192,0.9998602697615545,0.808477831759303,0.9996639652105159,0.8940417306688814,0.8565850795561369,121646,17,50573,28817
20,15,giraffe,High,125,0.65,158007,317,158007,37369,0,65462,18,257,0.9998860939724727,0.8074228510984042,0.9997261816024461,0.8934066120468848,0.8557778372795777,158007,18,65719,37686
20,15,safari,High,125,0.65,158136,318,158136,37239,0,65462,18,257,0.9998861868811412,0.8080820468795511,0.9997261816024461,0.8938100365412169,0.8562712772061355,158136,18,65719,37557
20,15,giraffe,High,125,0.6,145722,300,145722,34539,0,60358,17,228,0.9998833531175595,0.807051356605247,0.9997194858340346,0.8931780570027582,0.8554676485710968,145722,17,60586,34839
20,15,safari,High,125,0.6,145842,301,145842,34418,0,60358,17,228,0.9998834490843898,0.8077159519497565,0.9997194858340346,0.8935849519024569,0.8559652352755801,145842,17,60586,34719
20,15,giraffe,High,125,0.75,182126,355,182126,43086,0,75413,19,301,0.9998956875017156,0.8074142050920569,0.9997491186140784,0.8934051487324386,0.8557583803518088,182126,19,75714,43441
20,15,safari,High,125,0.75,182265,356,182265,42946,0,75413,19,301,0.9998957670448312,0.8080304299831093,0.9997491186140784,0.8937822881395412,0.8562197145701959,182265,19,75714,43302
20,15,giraffe,High,125,0.7,170119,333,170119,40259,0,70489,19,278,0.9998883259471723,0.8073569960751931,0.9997315853417342,0.8933671875205135,0.855732032668199,170119,19,70767,40592
20,15,safari,High,125,0.7,170250,334,170250,40127,0,70489,19,278,0.9998884118659298,0.8079787006848242,0.9997315853417342,0.8937477032915114,0.8561974017485089,170250,19,70767,40461
20,15,giraffe,High,125,0.85,206437,402,206437,48807,0,85287,21,352,0.9998982843968265,0.8075111677867051,0.9997548447349989,0.8934655402247113,0.855759933900957,206437,21,85639,49209
20,15,safari,High,125,0.85,206594,403,206594,48649,0,85287,21,352,0.999898361687196,0.8081252982640057,0.9997548447349989,0.8938413580206854,0.8562199316742161,206594,21,85639,49052
20,15,giraffe,High,125,0.8,194170,377,194170,45927,0,80297,19,325,0.9999021571767711,0.8074469589227942,0.9997643878424126,0.8934277819828235,0.8557432695451785,194170,19,80622,46304
20,15,safari,High,125,0.8,194317,378,194317,45779,0,80297,19,325,0.9999022311872221,0.8080582516197177,0.9997643878424126,0.8938018904808996,0.856201049468259,194317,19,80622,46157
20,15,giraffe,High,125,0.95,230569,464,230569,54553,0,95215,21,384,0.9999089292683985,0.8073540019468741,0.9997803806734993,0.8933735780044015,0.855621370072874,230569,21,95599,55017
20,15,safari,High,125,0.95,230729,465,230729,54392,0,95215,21,384,0.9999089924160347,0.8079142534998214,0.9997803806734993,0.8937164946856311,0.8560410906439038,230729,21,95599,54857
20,15,giraffe,High,125,0.9,218427,435,218427,51683,0,90235,21,369,0.999903867281916,0.8073592193535272,0.999768275862069,0.8933747517858129,0.8556386189329125,218427,21,90604,52118
20,15,safari,High,125,0.9,218578,436,218578,51531,0,90235,21,369,0.9999039336867964,0.8079173520116801,0.999768275862069,0.8937163698215659,0.8560567045989423,218578,21,90604,51967
20,15,giraffe,Mid,125,0.15,44111,84,44111,764,0,14956,3,64,0.9999319943782019,0.9811383705153585,0.9998003061971643,0.9904460386424617,0.9858124103897836,44111,3,15020,848
20,15,safari,Mid,125,0.15,44111,84,44111,764,0,14956,3,64,0.9999319943782019,0.9811383705153585,0.9998003061971643,0.9904460386424617,0.9858124103897836,44111,3,15020,848
20,15,giraffe,Mid,125,0.1,29396,60,29396,497,0,10014,2,44,0.9999319681610994,0.9814041999131974,0.9998011928429423,0.990581456083301,0.9860295403993702,29396,2,10058,557
20,15,safari,Mid,125,0.1,29396,60,29396,497,0,10014,2,44,0.9999319681610994,0.9814041999131974,0.9998011928429423,0.990581456083301,0.9860295403993702,29396,2,10058,557
20,15,giraffe,Mid,125,0.25,73562,142,73562,1293,0,24986,12,101,0.9998368989045043,0.9808659013027188,0.9995218933025221,0.9902605488285063,0.9855438778772379,73562,12,25087,1435
20,15,safari,Mid,125,0.25,73562,142,73562,1293,0,24986,12,101,0.9998368989045043,0.9808659013027188,0.9995218933025221,0.9902605488285063,0.9855438778772379,73562,12,25087,1435
20,15,giraffe,Mid,125,0.2,58847,109,58847,1034,0,19910,7,84,0.9998810616100859,0.9809468244707451,0.9996500174991251,0.9903234492275588,0.9856233826305459,58847,7,19994,1143
20,15,safari,Mid,125,0.2,58847,109,58847,1034,0,19910,7,84,0.9998810616100859,0.9809468244707451,0.9996500174991251,0.9903234492275588,0.9856233826305459,58847,7,19994,1143
20,15,giraffe,Mid,125,0.35,102943,187,102943,1813,0,35010,17,137,0.9998348873348873,0.980942035200061,0.9995165510180867,0.9902983602930212,0.985603859907071,102943,17,35147,2000
20,15,safari,Mid,125,0.35,102944,187,102944,1812,0,35010,17,137,0.9998348889385301,0.980951564182461,0.9995165510180867,0.9903032168693243,0.9856109973091994,102944,17,35147,1999
20,15,giraffe,Mid,125,0.3,88091,167,88091,1539,0,29885,16,121,0.9998184026240821,0.9810015924808179,0.9994670574911731,0.9903206223581258,0.9856283227201028,88091,16,30006,1706
20,15,safari,Mid,125,0.3,88091,167,88091,1539,0,29885,16,121,0.9998184026240821,0.9810015924808179,0.9994670574911731,0.9903206223581258,0.9856283227201028,88091,16,30006,1706
20,15,giraffe,Mid,125,0.45,132721,252,132721,2369,0,45257,18,178,0.9998643955431336,0.9806342450976046,0.9996039865355422,0.990155960325424,0.9854033573937332,132721,18,45435,2621
20,15,safari,Mid,125,0.45,132723,252,132723,2367,0,45257,18,178,0.999864397586277,0.9806490224763932,0.9996039865355422,0.9901634941417397,0.9854144196465611,132723,18,45435,2619
20,15,giraffe,Mid,125,0.4,117634,221,117634,2086,0,40042,18,156,0.9998470064257301,0.9807655430586705,0.9995524169484782,0.9902143581671178,0.9854829948113414,117634,18,40198,2307
20,15,safari,Mid,125,0.4,117635,221,117635,2085,0,40042,18,156,0.9998470077261098,0.9807738804912415,0.9995524169484782,0.9902186082140121,0.9854892386845407,117635,18,40198,2306
20,15,giraffe,Mid,125,0.55,162178,309,162178,2944,0,55340,20,219,0.9998766939173109,0.9803362126808156,0.9996401518559168,0.9900100418461124,0.9851907153522466,162178,20,55559,3253
20,15,safari,Mid,125,0.55,162180,309,162180,2942,0,55340,20,219,0.9998766954377312,0.9803483023133512,0.9996401518559168,0.990016207257555,0.9851997647165287,162180,20,55559,3251
20,15,giraffe,Mid,125,0.5,147525,276,147525,2660,0,50383,19,201,0.9998712248549585,0.9804866377333661,0.9996245281900282,0.9900840589922988,0.985303187044921,147525,19,50584,2936
20,15,safari,Mid,125,0.5,147527,276,147527,2658,0,50383,19,201,0.9998712266005179,0.9804999302144742,0.9996245281900282,0.9900908367924244,0.9853131341264473,147527,19,50584,2934
20,15,giraffe,Mid,125,0.65,191854,358,191854,3481,0,65462,23,264,0.9998801315426028,0.9803825379548579,0.9996501847936851,0.9900353484531825,0.9852280811805295,191854,23,65726,3839
20,15,safari,Mid,125,0.65,191856,358,191856,3479,0,65462,23,264,0.9998801327920199,0.980392758044488,0.9996501847936851,0.9900405602055876,0.9852357310608089,191856,23,65726,3837
20,15,giraffe,Mid,125,0.6,177035,334,177035,3191,0,60360,23,237,0.9998700990635837,0.9804774036331413,0.9996205872649291,0.9900787991655902,0.9852889957707937,177035,23,60597,3525
20,15,safari,Mid,125,0.6,177037,334,177037,3189,0,60360,23,237,0.9998701005308935,0.9804884802835623,0.9996205872649291,0.9900844471785694,0.9852972883323659,177037,23,60597,3523
20,15,giraffe,Mid,125,0.75,221111,406,221111,4045,0,75413,26,303,0.9998824258265239,0.980267066261161,0.9996567294235695,0.9899775911743703,0.9851412526883148,221111,26,75716,4451
20,15,safari,Mid,125,0.75,221114,406,221114,4042,0,75413,26,303,0.9998824274215429,0.9802803663737686,0.9996567294235695,0.9899843743703856,0.9851512094097655,221114,26,75716,4448
20,15,giraffe,Mid,125,0.7,206554,388,206554,3764,0,70489,23,283,0.9998886613708206,0.9802948183725191,0.9996751182993149,0.9899947996922952,0.9851687915851098,206554,23,70772,4152
20,15,safari,Mid,125,0.7,206557,388,206557,3761,0,70489,23,283,0.9998886629877045,0.9803090562205158,0.9996751182993149,0.9900020609366238,0.9851794487408571,206557,23,70772,4149
20,15,giraffe,Mid,125,0.85,250614,456,250614,4568,0,85287,27,335,0.9998922762038134,0.9803472097262536,0.9996847598921178,0.9900232875548858,0.9852001394720572,250614,27,85622,5024
20,15,safari,Mid,125,0.85,250617,456,250617,4565,0,85287,27,335,0.9998922774931776,0.9803589450707642,0.9996847598921178,0.9900292722237805,0.9852089297277657,250617,27,85622,5021
20,15,giraffe,Mid,125,0.8,235750,429,235750,4289,0,80297,26,322,0.9998897258414766,0.9803799258113346,0.9996775993551987,0.9900387196479116,0.9852263844814754,235750,26,80619,4718
20,15,safari,Mid,125,0.8,235753,429,235753,4286,0,80297,26,322,0.9998897272445807,0.9803924014837733,0.9996775993551987,0.9900450816488082,0.9852357269870731,235753,26,80619,4715
20,15,giraffe,Mid,125,0.95,279899,511,279899,5167,0,95213,30,371,0.9998928299675989,0.980117446433011,0.9996862384169682,0.9899063847244768,0.9850258794147816,279899,30,95584,5678
20,15,safari,Mid,125,0.95,279902,511,279902,5164,0,95213,30,371,0.9998928311161283,0.9801279514806864,0.9996862384169682,0.9899117432260142,0.9850337494851662,279902,30,95584,5675
20,15,giraffe,Mid,125,0.9,265188,488,265188,4860,0,90235,28,355,0.9998944256756757,0.980231836058787,0.9996910106159924,0.9899655064283475,0.9851143833378558,265188,28,90590,5348
20,15,safari,Mid,125,0.9,265191,488,265191,4857,0,90235,28,355,0.9998944268698698,0.9802429251559867,0.9996910106159924,0.9899711621916735,0.9851226900435825,265191,28,90590,5345
20,15,giraffe,None,125,0.15,44824,73,44824,64,0,14958,3,57,0.9999330760479176,0.9969529147483375,0.9998002397123452,0.9984407715953134,0.9976658497140666,44824,3,15015,137
20,15,safari,None,125,0.15,44824,73,44824,64,0,14958,3,57,0.9999330760479176,0.9969529147483375,0.9998002397123452,0.9984407715953134,0.9976658497140666,44824,3,15015,137
20,15,giraffe,None,125,0.1,29865,46,29865,44,0,10014,2,31,0.9999330364616467,0.9969954932398598,0.9998009356026675,0.9984621042425863,0.9977001149942503,29865,2,10045,90
20,15,safari,None,125,0.1,29865,46,29865,44,0,10014,2,31,0.9999330364616467,0.9969954932398598,0.9998009356026675,0.9984621042425863,0.9977001149942503,29865,2,10045,90
20,15,giraffe,None,125,0.25,74778,123,74778,99,0,24988,8,100,0.9998930281068649,0.99704,0.999681224099458,0.9984644759857396,0.9977022058823529,74778,8,25088,222
20,15,safari,None,125,0.25,74778,123,74778,99,0,24988,8,100,0.9998930281068649,0.99704,0.999681224099458,0.9984644759857396,0.9977022058823529,74778,8,25088,222
20,15,giraffe,None,125,0.2,59820,97,59820,76,0,19912,4,81,0.9999331372024606,0.9971163302385279,0.9997999699954994,0.998522747189464,0.9977872234029254,59820,4,19993,173
20,15,safari,None,125,0.2,59820,97,59820,76,0,19912,4,81,0.9999331372024606,0.9971163302385279,0.9997999699954994,0.998522747189464,0.9977872234029254,59820,4,19993,173
20,15,giraffe,None,125,0.35,104630,178,104630,138,0,35012,13,136,0.9998757680876886,0.9969889276389763,0.9996302721765593,0.9984302611301166,0.9976517946997652,104630,13,35148,316
20,15,safari,None,125,0.35,104630,178,104630,138,0,35012,13,136,0.9998757680876886,0.9969889276389763,0.9996302721765593,0.9984302611301166,0.9976517946997652,104630,13,35148,316
20,15,giraffe,None,125,0.3,89528,151,89528,121,0,29887,11,123,0.9998771485051207,0.9969710467706013,0.999633589820459,0.9984219829484942,0.9976381435641498,89528,11,30010,272
20,15,safari,None,125,0.3,89528,151,89528,121,0,29887,11,123,0.9998771485051207,0.9969710467706013,0.999633589820459,0.9984219829484942,0.9976381435641498,89528,11,30010,272
20,15,giraffe,None,125,0.45,134939,239,134939,168,0,45257,18,167,0.9998666241839993,0.9969928922908693,0.9996038906738259,0.9984276904066918,0.9976491802553267,134939,18,45424,407
20,15,safari,None,125,0.45,134939,239,134939,168,0,45257,18,167,0.9998666241839993,0.9969928922908693,0.9996038906738259,0.9984276904066918,0.9976491802553267,134939,18,45424,407
20,15,giraffe,None,125,0.4,119592,202,119592,151,0,40044,15,150,0.9998745892798916,0.9970569844512068,0.9996269491904798,0.9984637990916376,0.9977022116213144,119592,15,40194,353
20,15,safari,None,125,0.4,119592,202,119592,151,0,40044,15,150,0.9998745892798916,0.9970569844512068,0.9996269491904798,0.9984637990916376,0.9977022116213144,119592,15,40194,353
20,15,giraffe,None,125,0.55,164925,295,164925,215,0,55340,24,200,0.9998545004819671,0.9969172182428144,0.9995680656540206,0.998383698968473,0.9975836994737532,164925,24,55540,510
20,15,safari,None,125,0.55,164925,295,164925,215,0,55340,24,200,0.9998545004819671,0.9969172182428144,0.9995680656540206,0.998383698968473,0.9975836994737532,164925,24,55540,510
20,15,giraffe,None,125,0.5,150009,264,150009,192,0,50383,22,187,0.9998533636381814,0.9969693948758848,0.9995651486401012,0.9984092966295725,0.997622564745321,150009,22,50570,456
20,15,safari,None,125,0.5,150009,264,150009,192,0,50383,22,187,0.9998533636381814,0.9969693948758848,0.9995651486401012,0.9984092966295725,0.997622564745321,150009,22,50570,456
20,15,giraffe,None,125,0.65,195074,359,195074,262,0,65464,26,249,0.9998667350076884,0.9968266946012928,0.9996044965697684,0.998344400516895,0.9975251880015606,195074,26,65713,621
20,15,safari,None,125,0.65,195074,359,195074,262,0,65464,26,249,0.9998667350076884,0.9968266946012928,0.9996044965697684,0.998344400516895,0.9975251880015606,195074,26,65713,621
20,15,giraffe,None,125,0.6,179995,325,179995,243,0,60360,25,220,0.9998611265414954,0.996854283546463,0.9995874927811237,0.9983554410496336,0.9975411331519937,179995,25,60580,568
20,15,safari,None,125,0.6,179995,325,179995,243,0,60360,25,220,0.9998611265414954,0.996854283546463,0.9995874927811237,0.9983554410496336,0.9975411331519937,179995,25,60580,568
20,15,giraffe,None,125,0.75,224871,402,224871,294,0,75415,29,291,0.9998710538016896,0.9969144422721409,0.9996170858915957,0.9983905591308575,0.9975937763440004,224871,29,75706,696
20,15,safari,None,125,0.75,224871,402,224871,294,0,75415,29,291,0.9998710538016896,0.9969144422721409,0.9996170858915957,0.9983905591308575,0.9975937763440004,224871,29,75706,696
20,15,giraffe,None,125,0.7,210048,384,210048,279,0,70491,27,270,0.9998714744734024,0.9968535102581261,0.9996185794202407,0.9983602116039982,0.9975488367631856,210048,27,70761,663
20,15,safari,None,125,0.7,210048,384,210048,279,0,70491,27,270,0.9998714744734024,0.9968535102581261,0.9996185794202407,0.9983602116039982,0.9975488367631856,210048,27,70761,663
20,15,giraffe,None,125,0.85,254868,452,254868,324,0,85291,33,340,0.9998705379735662,0.9969645287978596,0.999614774000747,0.9984154188171465,0.9976297068923085,254868,33,85631,776
20,15,safari,None,125,0.85,254868,452,254868,324,0,85291,33,340,0.9998705379735662,0.9969645287978596,0.999614774000747,0.9984154188171465,0.9976297068923085,254868,33,85631,776
20,15,giraffe,None,125,0.8,239741,425,239741,306,0,80299,30,314,0.9998748806152538,0.9969601450480722,0.9996279900301328,0.9984153855444015,0.9976301325070458,239741,30,80613,731
20,15,safari,None,125,0.8,239741,425,239741,306,0,80299,30,314,0.9998748806152538,0.9969601450480722,0.9996279900301328,0.9984153855444015,0.9976301325070458,239741,30,80613,731
20,15,giraffe,None,125,0.95,284707,515,284707,362,0,95218,34,371,0.9998805932408751,0.9969290996694493,0.9996444370078329,0.9984026651470652,0.9976102222676918,284707,34,95589,877
20,15,safari,None,125,0.95,284707,515,284707,362,0,95218,34,371,0.9998805932408751,0.9969290996694493,0.9996444370078329,0.9984026651470652,0.9976102222676918,284707,34,95589,877
20,15,giraffe,None,125,0.9,269714,487,269714,342,0,90238,34,356,0.9998739564334119,0.9969357920921997,0.9996248400052964,0.9984027126122775,0.9976105501272251,269714,34,90594,829
20,15,safari,None,125,0.9,269714,487,269714,342,0,90238,34,356,0.9998739564334119,0.9969357920921997,0.9996248400052964,0.9984027126122775,0.9976105501272251,269714,34,90594,829
20,15,giraffe,Single-stranded,125,0.15,44650,87,44650,224,0,14958,3,57,0.9999328152643719,0.9930828940637442,0.9998002397123452,0.9964960832012856,0.9947648343586922,44650,3,15015,311
20,15,safari,Single-stranded,125,0.15,44650,87,44650,224,0,14958,3,57,0.9999328152643719,0.9930828940637442,0.9998002397123452,0.9964960832012856,0.9947648343586922,44650,3,15015,311
20,15,giraffe,Single-stranded,125,0.1,29745,60,29745,150,0,10014,2,31,0.9999327663293778,0.9929894842263395,0.9998009356026675,0.9964490301832435,0.9947002649867507,29745,2,10045,210
20,15,safari,Single-stranded,125,0.1,29745,60,29745,150,0,10014,2,31,0.9999327663293778,0.9929894842263395,0.9998009356026675,0.9964490301832435,0.9947002649867507,29745,2,10045,210
20,15,giraffe,Single-stranded,125,0.25,74529,145,74529,326,0,24987,8,100,0.9998926707541221,0.99372,0.9996812113966925,0.9967967793923912,0.9952145461811279,74529,8,25087,471
20,15,safari,Single-stranded,125,0.25,74529,145,74529,326,0,24987,8,100,0.9998926707541221,0.99372,0.9996812113966925,0.9967967793923912,0.9952145461811279,74529,8,25087,471
20,15,giraffe,Single-stranded,125,0.2,59622,104,59622,267,0,19911,4,81,0.9999329151712341,0.9938159451936059,0.9997999599919984,0.9968650465227097,0.9953118553801148,59622,4,19992,371
20,15,safari,Single-stranded,125,0.2,59622,104,59622,267,0,19911,4,81,0.9999329151712341,0.9938159451936059,0.9997999599919984,0.9968650465227097,0.9953118553801148,59622,4,19992,371
20,15,giraffe,Single-stranded,125,0.35,104315,193,104315,438,0,35010,13,136,0.999875392991335,0.9939873839879557,0.9996302511447993,0.9969226946491203,0.9954034474144392,104315,13,35146,631
20,15,safari,Single-stranded,125,0.35,104315,193,104315,438,0,35010,13,136,0.999875392991335,0.9939873839879557,0.9996302511447993,0.9969226946491203,0.9954034474144392,104315,13,35146,631
20,15,giraffe,Single-stranded,125,0.3,89235,176,89235,389,0,29885,11,123,0.9998767451762544,0.9937082405345211,0.9996335654085746,0.9967829496330551,0.9951927490631702,89235,11,30008,565
20,15,safari,Single-stranded,125,0.3,89235,176,89235,389,0,29885,11,123,0.9998767451762544,0.9937082405345211,0.9996335654085746,0.9967829496330551,0.9951927490631702,89235,11,30008,565
20,15,giraffe,Single-stranded,125,0.45,134563,235,134563,548,0,45255,18,167,0.9998662515511105,0.9942148271836626,0.9996038732394367,0.9970325310176456,0.9955693471839634,134563,18,45422,783
20,15,safari,Single-stranded,125,0.45,134563,235,134563,548,0,45255,18,167,0.9998662515511105,0.9942148271836626,0.9996038732394367,0.9970325310176456,0.9955693471839634,134563,18,45422,783
20,15,giraffe,Single-stranded,125,0.4,119238,216,119238,491,0,40042,15,150,0.9998742170008301,0.9941056317478845,0.9996269306339692,0.9969815801135461,0.995491782806334,119238,15,40192,707
20,15,safari,Single-stranded,125,0.4,119238,216,119238,491,0,40042,15,150,0.9998742170008301,0.9941056317478845,0.9996269306339692,0.9969815801135461,0.995491782806334,119238,15,40192,707
20,15,giraffe,Single-stranded,125,0.55,164461,297,164461,675,0,55339,24,200,0.9998540900386054,0.9941245096202088,0.999568057880244,0.9969810680229633,0.9954931310973955,164461,24,55539,972
20,15,safari,Single-stranded,125,0.55,164461,297,164461,675,0,55339,24,200,0.9998540900386054,0.9941245096202088,0.999568057880244,0.9969810680229633,0.9954931310973955,164461,24,55539,972
20,15,giraffe,Single-stranded,125,0.5,149586,262,149586,617,0,50381,22,187,0.9998529490401583,0.9941581098594358,0.9995651314489029,0.9969973972999904,0.9955186391783343,149586,22,50568,879
20,15,safari,Single-stranded,125,0.5,149586,262,149586,617,0,50381,22,187,0.9998529490401583,0.9941581098594358,0.9995651314489029,0.9969973972999904,0.9955186391783343,149586,22,50568,879
20,15,giraffe,Single-stranded,125,0.65,194542,350,194542,802,0,65463,26,249,0.9998663706262078,0.9941132584545259,0.9996044905534089,0.9969815149822426,0.9954940481654886,194542,26,65712,1152
20,15,safari,Single-stranded,125,0.65,194542,350,194542,802,0,65463,26,249,0.9998663706262078,0.9941132584545259,0.9996044905534089,0.9969815149822426,0.9954940481654886,194542,26,65712,1152
20,15,giraffe,Single-stranded,125,0.6,179508,324,179508,730,0,60359,25,220,0.9998607498342923,0.994162669886244,0.9995874859745232,0.9970035685027562,0.9955259033197051,179508,25,60579,1054
20,15,safari,Single-stranded,125,0.6,179508,324,179508,730,0,60359,25,220,0.9998607498342923,0.994162669886244,0.9995874859745232,0.9970035685027562,0.9955259033197051,179508,25,60579,1054
20,15,giraffe,Single-stranded,125,0.75,224225,418,224225,923,0,75414,29,291,0.9998706823512624,0.9940549550907495,0.999617080835556,0.9969543372904717,0.9954530368403585,224225,29,75705,1341
20,15,safari,Single-stranded,125,0.75,224225,418,224225,923,0,75414,29,291,0.9998706823512624,0.9940549550907495,0.999617080835556,0.9969543372904717,0.9954530368403585,224225,29,75705,1341
20,15,giraffe,Single-stranded,125,0.7,209471,383,209471,856,0,70490,27,270,0.9998711204880237,0.9941198804043472,0.999618574031955,0.9969872063359099,0.9955026163689134,209471,27,70760,1239
20,15,safari,Single-stranded,125,0.7,209471,383,209471,856,0,70490,27,270,0.9998711204880237,0.9941198804043472,0.999618574031955,0.9969872063359099,0.9955026163689134,209471,27,70760,1239
20,15,giraffe,Single-stranded,125,0.85,254143,464,254143,1036,0,85292,33,340,0.9998701687020017,0.9941324425077158,0.9996147784976361,0.9969930504747764,0.9955084557056969,254143,33,85632,1500
20,15,safari,Single-stranded,125,0.85,254143,464,254143,1036,0,85292,33,340,0.9998701687020017,0.9941324425077158,0.9996147784976361,0.9969930504747764,0.9955084557056969,254143,33,85632,1500
20,15,giraffe,Single-stranded,125,0.8,239054,438,239054,979,0,80300,30,314,0.9998745210888224,0.9941073975656108,0.9996279946431229,0.9969826193033124,0.9954938261993367,239054,30,80614,1417
20,15,safari,Single-stranded,125,0.8,239054,438,239054,979,0,80300,30,314,0.9998745210888224,0.9941073975656108,0.9996279946431229,0.9969826193033124,0.9954938261993367,239054,30,80614,1417
20,15,giraffe,Single-stranded,125,0.95,283902,515,283902,1165,0,95219,34,371,0.9998802547052857,0.9941172762989264,0.9996444407261775,0.9969904375278745,0.9955037433828429,283902,34,95590,1680
20,15,safari,Single-stranded,125,0.95,283902,515,283902,1165,0,95219,34,371,0.9998802547052857,0.9941172762989264,0.9996444407261775,0.9969904375278745,0.9955037433828429,283902,34,95590,1680
20,15,giraffe,Single-stranded,125,0.9,268932,492,268932,1117,0,90239,34,356,0.9998735899704796,0.9940526574530293,0.9996248441448101,0.9969546270947365,0.9954508957000858,268932,34,90595,1609
20,15,safari,Single-stranded,125,0.9,268932,492,268932,1117,0,90239,34,356,0.9998735899704796,0.9940526574530293,0.9996248441448101,0.9969546270947365,0.9954508957000858,268932,34,90595,1609
20,5,giraffe,High,125,0.15,40945,83,40945,3932,0,14956,3,57,0.9999267363485396,0.9106983985765125,0.9998002131060203,0.9532290357126227,0.9330065359477124,40945,3,15013,4015
20,5,safari,High,125,0.15,41014,83,41014,3863,0,14956,3,57,0.9999268595948022,0.9122330960854093,0.9998002131060203,0.9540691115065658,0.934156996131786,41014,3,15013,3946
20,5,giraffe,High,125,0.1,27326,52,27326,2576,0,10014,2,31,0.9999268149882904,0.9122654737263804,0.9998009356026675,0.9540867986452987,0.9342516437089072,27326,2,10045,2628
20,5,safari,High,125,0.1,27367,52,27367,2535,0,10014,2,31,0.9999269246227483,0.9136342391667223,0.9998009356026675,0.954834883031244,0.9352766180845479,27367,2,10045,2587
20,5,giraffe,High,125,0.25,68232,144,68232,6623,0,24986,9,99,0.9998681144766343,0.9097721302950706,0.999641348529529,0.9526947779949735,0.9323029582488286,68232,9,25085,6767
20,5,safari,High,125,0.25,68341,144,68341,6514,0,24986,9,99,0.9998683247988296,0.9112254830064401,0.999641348529529,0.9534911300392748,0.9333919454906937,68341,9,25085,6658
20,5,giraffe,High,125,0.2,54649,112,54649,5231,0,19910,5,80,0.9999085153877117,0.9109381250833445,0.9997499374843711,0.9533520576382952,0.9331391351094552,54649,5,19990,5343
20,5,safari,High,125,0.2,54732,112,54732,5148,0,19910,5,80,0.9999086541096516,0.912321642885718,0.9997499374843711,0.9541092487514053,0.9341768037306062,54732,5,19990,5260
20,5,giraffe,High,125,0.35,95598,201,95598,9145,0,35010,13,136,0.9998640323812114,0.9109429791126696,0.9996302511447993,0.9533344967714592,0.9331991463423338,95598,13,35146,9346
20,5,safari,High,125,0.35,95775,201,95775,8968,0,35010,13,136,0.9998642836263415,0.9126295929257509,0.9996302511447993,0.9542574178506665,0.9344625025873822,95775,13,35146,9169
20,5,giraffe,High,125,0.3,81755,176,81755,7868,0,29885,11,123,0.999865469755155,0.9104221650575174,0.9996335654085746,0.953049864482849,0.9327730391093157,81755,11,30008,8044
20,5,safari,High,125,0.3,81900,176,81900,7723,0,29885,11,123,0.9998657079024795,0.9120368823706277,0.9996335654085746,0.9539339584182633,0.9339832078652623,81900,11,30008,7899
20,5,giraffe,High,125,0.45,123365,257,123365,11722,0,45255,18,167,0.9998541128032225,0.9114921976592978,0.9996038732394367,0.9536306608896636,0.9336390388529958,123365,18,45422,11979
20,5,safari,High,125,0.45,123595,257,123595,11492,0,45255,18,167,0.9998543842476115,0.913191571107696,0.9996038732394367,0.9545600234788014,0.9349112753341003,123595,18,45422,11749
20,5,giraffe,High,125,0.4,109316,226,109316,10401,0,40042,16,149,0.9998536567519116,0.9113995814678639,0.9996020593429005,0.9535797622941883,0.9335435529191383,109316,16,40191,10627
20,5,safari,High,125,0.4,109516,226,109516,10201,0,40042,16,149,0.999853923967425,0.9130670401774176,0.9996020593429005,0.9544917747031267,0.9347923821417421,109516,16,40191,10427
20,5,giraffe,High,125,0.55,150797,312,150797,14324,0,55338,22,202,0.9998541297847088,0.911529138684543,0.9996040459306721,0.953650886002302,0.9336727075273196,150797,22,55540,14636
20,5,safari,High,125,0.55,151072,312,151072,14049,0,55338,22,202,0.9998543952771123,0.9131914430615415,0.9996040459306721,0.9545599585501394,0.934917079571936,151072,22,55540,14361
20,5,giraffe,High,125,0.5,137152,283,137152,13028,0,50381,22,187,0.9998396197530144,0.9115330679303217,0.9995651314489029,0.9536464363068728,0.9336841529347983,137152,22,50568,13311
20,5,safari,High,125,0.5,137399,283,137399,12781,0,50381,22,187,0.9998399080198805,0.9131746675262357,0.9995651314489029,0.9545441914104292,0.9349126847149757,137399,22,50568,13064
20,5,giraffe,High,125,0.65,178357,374,178357,16962,0,65462,24,251,0.999865456522836,0.9114122630855472,0.9996349088032614,0.9535920700182317,0.9335959912787362,178357,24,65713,17336
20,5,safari,High,125,0.65,178684,374,178684,16635,0,65462,24,251,0.999865702710567,0.9130832477400826,0.9996349088032614,0.9545059975801347,0.9348468041158245,178684,24,65713,17009
20,5,giraffe,High,125,0.6,164503,350,164503,15708,0,60358,22,223,0.9998662817201033,0.9110660663155388,0.9996369816675742,0.9534029198518631,0.9333233815992437,164503,22,60581,16058
20,5,safari,High,125,0.6,164810,350,164810,15401,0,60358,22,223,0.9998665307707242,0.9127663227385758,0.9996369816675742,0.9543331798849427,0.9345963742515466,164810,22,60581,15751
20,5,giraffe,High,125,0.75,205563,418,205563,19586,0,75413,25,295,0.9998783975718427,0.911316814959635,0.999669892913261,0.9535457086198699,0.933524726186525,205563,25,75708,20004
20,5,safari,High,125,0.75,205926,418,205926,19223,0,75413,25,295,0.9998786119028312,0.9129260929125271,0.999669892913261,0.9544260030867774,0.9347295054762695,205926,25,75708,19641
20,5,giraffe,High,125,0.7,192016,392,192016,18303,0,70489,25,272,0.9998698194656349,0.9112765826178985,0.9996468228180714,0.9535197838868583,0.9334984031801404,192016,25,70761,18695
20,5,safari,High,125,0.7,192362,392,192362,17957,0,70489,25,272,0.9998700535898996,0.9129186421211992,0.9996468228180714,0.9544180323395304,0.934727545941875,192362,25,70761,18349
20,5,giraffe,High,125,0.85,232971,474,232971,22201,0,85287,29,344,0.9998755364806867,0.9113031301096047,0.9996614522530937,0.9535369162952321,0.9334790481269007,232971,29,85631,22675
20,5,safari,High,125,0.85,233382,474,233382,21790,0,85287,29,344,0.9998757556413366,0.9129108219960415,0.9996614522530937,0.9544163563756373,0.9346832461193182,233382,29,85631,22264
20,5,giraffe,High,125,0.8,219160,443,219160,20871,0,80297,27,317,0.9998768175119874,0.911366717399802,0.9996651827234285,0.9535723065476513,0.9335409432757735,219160,27,80614,21314
20,5,safari,High,125,0.8,219557,443,219557,20474,0,80297,27,317,0.9998770402215098,0.9130176235268678,0.9996651827234285,0.9544753052875941,0.9347772604830046,219557,27,80614,20917
20,5,giraffe,High,125,0.95,260249,544,260249,24793,0,95215,30,375,0.9998847390684612,0.9112806650185934,0.999686258104999,0.9535288029091443,0.9334559267167883,260249,30,95590,25337
20,5,safari,High,125,0.95,260711,544,260711,24331,0,95215,30,375,0.9998849432962211,0.9128983913777285,0.999686258104999,0.9544137485425396,0.934667869865637,260711,30,95590,24875
20,5,giraffe,High,125,0.9,246532,514,246532,23499,0,90235,30,360,0.9998783267494585,0.911242122382598,0.9996689655172414,0.9535047872103839,0.9334302406069164,246532,30,90595,24013
20,5,safari,High,125,0.9,246975,514,246975,23056,0,90235,30,360,0.9998785449687253,0.9128795579293648,0.9996689655172414,0.9544005410105304,0.9346568098125536,246975,30,90595,23570
20,5,giraffe,Mid,125,0.15,44678,86,44678,195,0,14956,5,62,0.9998881006199226,0.9937498609844525,0.999667176995274,0.996809531246514,0.9952319029042046,44678,5,15018,281
20,5,safari,Mid,125,0.15,44682,86,44682,191,0,14956,5,62,0.999888110636203,0.9938388309348517,0.999667176995274,0.9968542935546484,0.9952985895768731,44682,5,15018,277
20,5,giraffe,Mid,125,0.1,29758,61,29758,134,0,10014,4,42,0.9998656004300787,0.9934898006877442,0.9996023856858847,0.9966675039772251,0.9950266163496864,29758,4,10056,195
20,5,safari,Mid,125,0.1,29760,61,29760,132,0,10014,4,42,0.9998656094610939,0.9935565719627416,0.9996023856858847,0.9967011068874859,0.9950766001049659,29760,4,10056,193
20,5,giraffe,Mid,125,0.25,74513,150,74513,334,0,24986,15,98,0.9997987333619579,0.9935464085230076,0.9994023666281525,0.9966627654238421,0.9950147858056266,74513,15,25084,484
20,5,safari,Mid,125,0.25,74517,150,74517,330,0,24986,15,98,0.9997987441635807,0.9935997439897596,0.9994023666281525,0.996689605360833,0.9950547474424553,74517,15,25084,480
20,5,giraffe,Mid,125,0.2,59620,114,59620,256,0,19910,9,82,0.999849066729276,0.9938323053842307,0.999550022498875,0.9968316070189518,0.9952619669712842,59620,9,19992,370
20,5,safari,Mid,125,0.2,59624,114,59624,252,0,19910,9,82,0.9998490768534201,0.9938989831638606,0.999550022498875,0.9968651513504929,0.9953119725969172,59624,9,19992,366
20,5,giraffe,Mid,125,0.35,104296,199,104296,448,0,35010,20,134,0.9998082748571647,0.9938347483872197,0.9994312364918667,0.9968125624226437,0.995239352780375,104296,20,35144,647
20,5,safari,Mid,125,0.35,104300,199,104300,444,0,35010,20,134,0.999808282208589,0.9938728643168196,0.9994312364918667,0.9968317380521162,0.9952679023888885,104300,20,35144,643
20,5,giraffe,Mid,125,0.3,89232,179,89232,386,0,29885,19,118,0.9997871172311795,0.9937080303350891,0.9993671307707681,0.9967383048121173,0.9951259816890476,89232,19,30003,565
20,5,safari,Mid,125,0.3,89236,179,89236,382,0,29885,19,118,0.9997871267716094,0.9937525752530708,0.9993671307707681,0.9967607175569108,0.9951593653761089,89236,19,30003,561
20,5,giraffe,Mid,125,0.45,134475,268,134475,599,0,45257,22,174,0.9998364275783103,0.9935940062951634,0.9995159835434405,0.9967054428751959,0.9950828286180481,134475,22,45431,867
20,5,safari,Mid,125,0.45,134479,268,134479,595,0,45257,22,174,0.9998364324428815,0.9936235610527404,0.9995159835434405,0.9967203151462146,0.9951049531237036,134479,22,45431,863
20,5,giraffe,Mid,125,0.4,119180,235,119180,526,0,40042,21,153,0.9998238269813172,0.9936552138134583,0.9994778197732246,0.9967299763320537,0.9951172911580511,119180,21,40195,761
20,5,safari,Mid,125,0.4,119184,235,119184,522,0,40042,21,153,0.9998238328929155,0.9936885635437424,0.9994778197732246,0.9967467572110761,0.9951422666508488,119184,21,40195,757
20,5,giraffe,Mid,125,0.55,164338,329,164338,764,0,55340,25,214,0.9998478976411966,0.9933930158192842,0.999550189819896,0.9966100050334452,0.9949414053662731,164338,25,55554,1093
20,5,safari,Mid,125,0.55,164343,329,164343,759,0,55340,25,214,0.9998479022680814,0.9934232399006232,0.999550189819896,0.9966252171777356,0.9949640287769784,164343,25,55554,1088
20,5,giraffe,Mid,125,0.5,149492,293,149492,676,0,50383,24,196,0.9998394820621205,0.9935597929031443,0.9995257198189831,0.9966897462138764,0.9950612740222019,149492,24,50579,969
20,5,safari,Mid,125,0.5,149497,293,149497,671,0,50383,24,196,0.9998394874298594,0.9935930241059144,0.9995257198189831,0.99670646905481,0.9950861417260176,149497,24,50579,964
20,5,giraffe,Mid,125,0.65,194405,386,194405,902,0,65462,30,257,0.9998457067914728,0.9934182622781602,0.999543719296111,0.9966216216216217,0.9949587288958928,194405,30,65719,1288
20,5,safari,Mid,125,0.65,194410,386,194410,897,0,65462,30,257,0.9998457107591031,0.9934438125022357,0.999543719296111,0.9966344810615867,0.9949778535965912,194410,30,65719,1283
20,5,giraffe,Mid,125,0.6,179378,355,179378,827,0,60360,28,232,0.9998439294115024,0.9934536996012406,0.9995381062355658,0.9966385714206343,0.9949830002487768,179378,28,60592,1182
20,5,safari,Mid,125,0.6,179383,355,179383,822,0,60360,28,232,0.9998439337610291,0.9934813912272928,0.9995381062355658,0.9966525081187094,0.9950037316527075,179383,28,60592,1177
20,5,giraffe,Mid,125,0.75,224066,438,224066,1058,0,75413,34,295,0.9998482820169567,0.9933676771796668,0.9995511077077447,0.9965974443026095,0.9949220720601121,224066,34,75708,1496
20,5,safari,Mid,125,0.75,224073,438,224073,1051,0,75413,34,295,0.99984828675588,0.9933987107757513,0.9995511077077447,0.9966130642761677,0.9949453044101638,224073,34,75708,1489
20,5,giraffe,Mid,125,0.7,209308,417,209308,981,0,70489,31,275,0.9998519148367003,0.9933651628335216,0.9995621159686419,0.9965979835493817,0.9949236414790711,209308,31,70764,1398
20,5,safari,Mid,125,0.7,209315,417,209315,974,0,70489,31,275,0.999851919788293,0.9933983844788473,0.9995621159686419,0.9966147048460666,0.9949485081758147,209315,31,70764,1391
20,5,giraffe,Mid,125,0.85,253924,490,253924,1224,0,85287,37,325,0.9998543083386819,0.9932952065029456,0.9995680042966059,0.9965639649999313,0.9948694207514497,253924,37,85612,1714
20,5,safari,Mid,125,0.85,253933,490,253933,1215,0,85287,37,325,0.9998543135015947,0.9933304125364774,0.9995680042966059,0.9965816863157564,0.9948957915185753,253933,37,85612,1705
20,5,giraffe,Mid,125,0.8,238869,461,238869,1138,0,80297,35,313,0.999853497639219,0.9933504665901493,0.9995659991319983,0.9965913737139425,0.9949114486177763,238869,35,80610,1599
20,5,safari,Mid,125,0.8,238877,461,238877,1130,0,80297,35,313,0.99985350254487,0.9933837350499859,0.9995659991319983,0.9966081188201427,0.9949363619660369,238877,35,80610,1591
20,5,giraffe,Mid,125,0.95,283642,548,283642,1387,0,95213,42,359,0.9998519479420764,0.9932242442493618,0.9995607337837555,0.9965270763322975,0.9948136236165072,283642,42,95572,1935
20,5,safari,Mid,125,0.95,283651,548,283651,1378,0,95213,42,359,0.9998519526389442,0.9932557593923881,0.9995607337837555,0.9965429409594745,0.9948372338276612,283651,42,95572,1926
20,5,giraffe,Mid,125,0.9,268707,525,268707,1304,0,90235,40,343,0.9998511611292406,0.9932393470739569,0.9995585865942749,0.9965342871924389,0.9948249223323015,268707,40,90578,1829
20,5,safari,Mid,125,0.9,268716,525,268716,1295,0,90235,40,343,0.9998511661135007,0.9932726143655558,0.9995585865942749,0.996551033577357,0.9948498424494814,268716,40,90578,1820
20,5,giraffe,None,125,0.15,44865,79,44865,17,0,14958,6,54,0.9998662833455907,0.9978648161740175,0.9996004794246903,0.9988645471546888,0.9982994047916771,44865,6,15012,96
20,5,safari,None,125,0.15,44865,79,44865,17,0,14958,6,54,0.9998662833455907,0.9978648161740175,0.9996004794246903,0.9988645471546888,0.9982994047916771,44865,6,15012,96
20,5,giraffe,None,125,0.1,29895,49,29895,11,0,10014,4,29,0.9998662162614135,0.9979969954932398,0.999601871205335,0.9989307314465199,0.9984000799960002,29895,4,10043,60
20,5,safari,None,125,0.1,29895,49,29895,11,0,10014,4,29,0.9998662162614135,0.9979969954932398,0.999601871205335,0.9989307314465199,0.9984000799960002,29895,4,10043,60
20,5,giraffe,None,125,0.25,74845,133,74845,22,0,24988,12,96,0.9998396943505617,0.9979333333333333,0.9995218361491871,0.9988856042760765,0.9983316016624041,74845,12,25084,155
20,5,safari,None,125,0.25,74845,133,74845,22,0,24988,12,96,0.9998396943505617,0.9979333333333333,0.9995218361491871,0.9988856042760765,0.9983316016624041,74845,12,25084,155
20,5,giraffe,None,125,0.2,59869,105,59869,19,0,19912,8,77,0.999866392771849,0.9979330921940893,0.9995999399909986,0.9988988070409611,0.9983497937242155,59869,8,19989,124
20,5,safari,None,125,0.2,59869,105,59869,19,0,19912,8,77,0.999866392771849,0.9979330921940893,0.9995999399909986,0.9988988070409611,0.9983497937242155,59869,8,19989,124
20,5,giraffe,None,125,0.35,104725,190,104725,31,0,35012,19,130,0.9998186053616436,0.997894155089284,0.9994596285657404,0.9988554532881874,0.9982870234891904,104725,19,35142,221
20,5,safari,None,125,0.35,104725,190,104725,31,0,35012,19,130,0.9998186053616436,0.997894155089284,0.9994596285657404,0.9988554532881874,0.9982870234891904,104725,19,35142,221
20,5,giraffe,None,125,0.3,89611,163,89611,26,0,29887,15,119,0.9998326378506237,0.9978953229398664,0.9995003497551714,0.9988630410308428,0.9982974603783977,89611,15,30006,189
20,5,safari,None,125,0.3,89611,163,89611,26,0,29887,15,119,0.9998326378506237,0.9978953229398664,0.9995003497551714,0.9988630410308428,0.9982974603783977,89611,15,30006,189
20,5,giraffe,None,125,0.45,135056,253,135056,37,0,45257,26,159,0.999807524318562,0.9978573434013566,0.9994278420844153,0.9988314819471358,0.9982520963780782,135056,26,45416,290
20,5,safari,None,125,0.45,135056,253,135056,37,0,45257,26,159,0.999807524318562,0.9978573434013566,0.9994278420844153,0.9988314819471358,0.9982520963780782,135056,26,45416,290
20,5,giraffe,None,125,0.4,119697,214,119697,34,0,40044,23,142,0.9998078850651521,0.9979323856767686,0.9994279887587356,0.9988692550017733,0.9983078786667832,119697,23,40186,248
20,5,safari,None,125,0.4,119697,214,119697,34,0,40044,23,142,0.9998078850651521,0.9979323856767686,0.9994279887587356,0.9988692550017733,0.9983078786667832,119697,23,40186,248
20,5,giraffe,None,125,0.55,165079,312,165079,44,0,55340,32,192,0.9998061909866696,0.9978480974400822,0.9994240875386942,0.9988261845552511,0.9982443359472215,165079,32,55532,356
20,5,safari,None,125,0.55,165079,312,165079,44,0,55340,32,192,0.9998061909866696,0.9978480974400822,0.9994240875386942,0.9988261845552511,0.9982443359472215,165079,32,55532,356
20,5,giraffe,None,125,0.5,150145,281,150145,39,0,50383,30,179,0.9998002330614283,0.9978732595620244,0.9994070208728653,0.9988358169238957,0.998259200127327,150145,30,50562,320
20,5,safari,None,125,0.5,150145,281,150145,39,0,50383,30,179,0.9998002330614283,0.9978732595620244,0.9994070208728653,0.9988358169238957,0.998259200127327,150145,30,50562,320
20,5,giraffe,None,125,0.65,195256,383,195256,56,0,65464,35,240,0.9998207802714922,0.9977567132527658,0.9994675915362266,0.9987876803773026,0.9981869228944973,195256,35,65704,439
20,5,safari,None,125,0.65,195256,383,195256,56,0,65464,35,240,0.9998207802714922,0.9977567132527658,0.9994675915362266,0.9987876803773026,0.9981869228944973,195256,35,65704,439
20,5,giraffe,None,125,0.6,180166,346,180166,51,0,60360,33,212,0.9998168691280196,0.9978013214224398,0.9994554904710833,0.9988080784561567,0.9982170105486632,180166,33,60572,397
20,5,safari,None,125,0.6,180166,346,180166,51,0,60360,33,212,0.9998168691280196,0.9978013214224398,0.9994554904710833,0.9988080784561567,0.9982170105486632,180166,33,60572,397
20,5,giraffe,None,125,0.75,225076,427,225076,64,0,75415,39,281,0.9998267552140018,0.9978232631546281,0.99948504654387,0.9988240045087223,0.9982409675342347,225076,39,75696,491
20,5,safari,None,125,0.75,225076,427,225076,64,0,75415,39,281,0.9998267552140018,0.9978232631546281,0.99948504654387,0.9988240045087223,0.9982409675342347,225076,39,75696,491
20,5,giraffe,None,125,0.7,210245,408,210245,58,0,70491,37,260,0.9998240458051569,0.9977884400909303,0.9994773125388484,0.9988052057872697,0.9982131375244673,210245,37,70751,466
20,5,safari,None,125,0.7,210245,408,210245,58,0,70491,37,260,0.9998240458051569,0.9977884400909303,0.9994773125388484,0.9988052057872697,0.9982131375244673,210245,37,70751,466
20,5,giraffe,None,125,0.85,255092,479,255092,73,0,85291,45,328,0.9998236241705437,0.997840747289199,0.9994746918192006,0.9988312016304444,0.9982508467425316,255092,45,85619,552
20,5,safari,None,125,0.85,255092,479,255092,73,0,85291,45,328,0.9998236241705437,0.997840747289199,0.9994746918192006,0.9988312016304444,0.9982508467425316,255092,45,85619,552
20,5,giraffe,None,125,0.8,239952,451,239952,69,0,80299,42,302,0.9998249956248906,0.9978375860807079,0.9994791860421859,0.9988303022482341,0.9982498481852295,239952,42,80601,520
20,5,safari,None,125,0.8,239952,451,239952,69,0,80299,42,302,0.9998249956248906,0.9978375860807079,0.9994791860421859,0.9988303022482341,0.9982498481852295,239952,42,80601,520
20,5,giraffe,None,125,0.95,284954,545,284954,85,0,95218,47,358,0.9998350882979358,0.997793994061292,0.9995084864520042,0.998813498427053,0.9982240619925657,284954,47,95576,630
20,5,safari,None,125,0.95,284954,545,284954,85,0,95218,47,358,0.9998350882979358,0.997793994061292,0.9995084864520042,0.998813498427053,0.9982240619925657,284954,47,95576,630
20,5,giraffe,None,125,0.9,269948,516,269948,79,0,90238,47,343,0.9998259227022722,0.9978007192941603,0.9994813964779097,0.9988122944177839,0.9982224486462091,269948,47,90581,595
20,5,safari,None,125,0.9,269948,516,269948,79,0,90238,47,343,0.9998259227022722,0.9978007192941603,0.9994813964779097,0.9988122944177839,0.9982224486462091,269948,47,90581,595
20,5,giraffe,Single-stranded,125,0.15,44826,92,44826,43,0,14958,6,54,0.9998661670235546,0.9969973977447121,0.9996004794246903,0.9984297216932276,0.9976491772120242,44826,6,15012,135
20,5,safari,Single-stranded,125,0.15,44826,92,44826,43,0,14958,6,54,0.9998661670235546,0.9969973977447121,0.9996004794246903,0.9984297216932276,0.9976491772120242,44826,6,15012,135
20,5,giraffe,Single-stranded,125,0.1,29862,65,29862,28,0,10014,4,29,0.9998660684390277,0.9968953430145218,0.999601871205335,0.9983784958459403,0.9975751212439378,29862,4,10043,93
20,5,safari,Single-stranded,125,0.1,29862,65,29862,28,0,10014,4,29,0.9998660684390277,0.9968953430145218,0.999601871205335,0.9983784958459403,0.9975751212439378,29862,4,10043,93
20,5,giraffe,Single-stranded,125,0.25,74775,152,74775,73,0,24987,12,96,0.9998395443058286,0.997,0.9995218170950388,0.9984177532095576,0.997632249363105,74775,12,25083,225
20,5,safari,Single-stranded,125,0.25,74775,152,74775,73,0,24987,12,96,0.9998395443058286,0.997,0.9995218170950388,0.9984177532095576,0.997632249363105,74775,12,25083,225
20,5,giraffe,Single-stranded,125,0.2,59832,109,59832,52,0,19911,8,77,0.9998663101604278,0.9973163535745837,0.9995999199839968,0.9985897040047399,0.997887209491305,59832,8,19988,161
20,5,safari,Single-stranded,125,0.2,59832,109,59832,52,0,19911,8,77,0.9998663101604278,0.9973163535745837,0.9995999199839968,0.9985897040047399,0.997887209491305,59832,8,19988,161
20,5,giraffe,Single-stranded,125,0.35,104637,206,104637,103,0,35010,19,130,0.9998184528359578,0.9970556286089989,0.9994595978270144,0.9984351294357878,0.9976588986831305,104637,19,35140,309
20,5,safari,Single-stranded,125,0.35,104637,206,104637,103,0,35010,19,130,0.9998184528359578,0.9970556286089989,0.9994595978270144,0.9984351294357878,0.9976588986831305,104637,19,35140,309
20,5,giraffe,Single-stranded,125,0.3,89523,185,89523,92,0,29885,15,119,0.9998324733632648,0.9969153674832962,0.999500316466238,0.9983717895816838,0.9975629908445238,89523,15,30004,277
20,5,safari,Single-stranded,125,0.3,89523,185,89523,92,0,29885,15,119,0.9998324733632648,0.9969153674832962,0.999500316466238,0.9983717895816838,0.9975629908445238,89523,15,30004,277
20,5,giraffe,Single-stranded,125,0.45,134961,251,134961,134,0,45255,26,159,0.999807388859668,0.9971554386535251,0.9994278169014085,0.9984796528725683,0.9977265938734194,134961,26,45414,385
20,5,safari,Single-stranded,125,0.45,134961,251,134961,134,0,45255,26,159,0.999807388859668,0.9971554386535251,0.9994278169014085,0.9984796528725683,0.9977265938734194,134961,26,45414,385
20,5,giraffe,Single-stranded,125,0.4,119595,231,119595,119,0,40042,23,142,0.9998077212459663,0.9970819959147943,0.9994279603054195,0.9984429982927246,0.9976709625855438,119595,23,40184,350
20,5,safari,Single-stranded,125,0.4,119595,231,119595,119,0,40042,23,142,0.9998077212459663,0.9970819959147943,0.9994279603054195,0.9984429982927246,0.9976709625855438,119595,23,40184,350
20,5,giraffe,Single-stranded,125,0.55,164951,314,164951,168,0,55339,32,192,0.9998060406223671,0.9970864337828608,0.9994240771736588,0.9984443852597936,0.9976741660482543,164951,32,55531,482
20,5,safari,Single-stranded,125,0.55,164951,314,164951,168,0,55339,32,192,0.9998060406223671,0.9970864337828608,0.9994240771736588,0.9984443852597936,0.9976741660482543,164951,32,55531,482
20,5,giraffe,Single-stranded,125,0.5,150032,279,150032,154,0,50381,30,179,0.9998000826325119,0.9971222543448642,0.9994069974303222,0.9984593730347023,0.9976971475466913,150032,30,50560,433
20,5,safari,Single-stranded,125,0.5,150032,279,150032,154,0,50381,30,179,0.9998000826325119,0.9971222543448642,0.9994069974303222,0.9984593730347023,0.9976971475466913,150032,30,50560,433
20,5,giraffe,Single-stranded,125,0.65,195127,374,195127,193,0,65463,35,240,0.9998206618091636,0.997102619395587,0.9994675834372814,0.9984597908181018,0.9976972979589339,195127,35,65703,567
20,5,safari,Single-stranded,125,0.65,195127,374,195127,193,0,65463,35,240,0.9998206618091636,0.997102619395587,0.9994675834372814,0.9984597908181018,0.9976972979589339,195127,35,65703,567
20,5,giraffe,Single-stranded,125,0.6,180042,343,180042,177,0,60359,33,212,0.9998167430237401,0.9971201027901774,0.9994554814863705,0.9984666021511936,0.9977069736198303,180042,33,60571,520
20,5,safari,Single-stranded,125,0.6,180042,343,180042,177,0,60359,33,212,0.9998167430237401,0.9971201027901774,0.9994554814863705,0.9984666021511936,0.9977069736198303,180042,33,60571,520
20,5,giraffe,Single-stranded,125,0.75,224891,445,224891,230,0,75414,39,281,0.9998266127239586,0.997007527730243,0.9994850397443684,0.9984150802670834,0.9976302688350481,224891,39,75695,675
20,5,safari,Single-stranded,125,0.75,224891,445,224891,230,0,75414,39,281,0.9998266127239586,0.997007527730243,0.9994850397443684,0.9984150802670834,0.9976302688350481,224891,39,75695,675
20,5,giraffe,Single-stranded,125,0.7,210093,408,210093,209,0,70490,37,260,0.9998239185266263,0.9970718048502681,0.9994773051549013,0.9984459652124322,0.997676707034178,210093,37,70750,617
20,5,safari,Single-stranded,125,0.7,210093,408,210093,209,0,70490,37,260,0.9998239185266263,0.9970718048502681,0.9994773051549013,0.9984459652124322,0.997676707034178,210093,37,70750,617
20,5,giraffe,Single-stranded,125,0.85,254894,493,254894,256,0,85292,45,328,0.999823487187131,0.9970701329588528,0.999474697951322,0.9984449118848686,0.9976736554666167,254894,45,85620,749
20,5,safari,Single-stranded,125,0.85,254894,493,254894,256,0,85292,45,328,0.999823487187131,0.9970701329588528,0.999474697951322,0.9984449118848686,0.9976736554666167,254894,45,85620,749
20,5,giraffe,Single-stranded,125,0.8,239759,465,239759,247,0,80300,42,302,0.9998248547754179,0.9970391440132074,0.999479192500372,0.9984300563014291,0.997651931551002,239759,42,80602,712
20,5,safari,Single-stranded,125,0.8,239759,465,239759,247,0,80300,42,302,0.9998248547754179,0.9970391440132074,0.999479192500372,0.9984300563014291,0.997651931551002,239759,42,80602,712
20,5,giraffe,Single-stranded,125,0.95,284748,548,284748,286,0,95219,47,358,0.9998349690127987,0.997079647876967,0.9995084915920689,0.9984554075637692,0.997688913605767,284748,47,95577,834
20,5,safari,Single-stranded,125,0.95,284748,548,284748,286,0,95219,47,358,0.9998349690127987,0.997079647876967,0.9995084915920689,0.9984554075637692,0.997688913605767,284748,47,95577,834
20,5,giraffe,Single-stranded,125,0.9,269742,524,269742,275,0,90239,47,343,0.9998257897838682,0.9970466583623184,0.9994814022001788,0.9984342901560157,0.9976576127585348,269742,47,90582,799
20,5,safari,Single-stranded,125,0.9,269742,524,269742,275,0,90239,47,343,0.9998257897838682,0.9970466583623184,0.9994814022001788,0.9984342901560157,0.9976576127585348,269742,47,90582,799
30,10,giraffe,High,125,0.15,26805,46,26805,18109,0,14956,1,59,0.999962694919048,0.5961966192170819,0.9999334043686734,0.7470111194716161,0.6972789115646258,26805,1,15015,18155
30,10,safari,High,125,0.15,29867,50,29867,15043,0,14956,1,59,0.9999665193518147,0.6643016014234876,0.9999334043686734,0.7982840647885819,0.7483326663998933,29867,1,15015,15093
30,10,giraffe,High,125,0.1,17923,31,17923,12000,0,10014,0,33,1.0,0.5983508045670027,1.0,0.7487102366480773,0.6992325191870203,17923,0,10047,12031
30,10,safari,High,125,0.1,19924,35,19924,9995,0,10014,0,33,1.0,0.6651532349602725,1.0,0.7989093387866394,0.7492562685932852,19924,0,10047,10030
30,10,giraffe,High,125,0.25,44752,96,44752,30151,0,24986,2,106,0.9999553112570944,0.5967012893505247,0.9999202996732287,0.7474050754469617,0.6977910543194829,44752,2,25092,30247
30,10,safari,High,125,0.25,49869,101,49869,25029,0,24986,5,103,0.9998997473633556,0.6649288657182095,0.9998007491830716,0.798715494942862,0.7488835383093723,49869,5,25089,25130
30,10,giraffe,High,125,0.2,35756,67,35756,24169,0,19910,1,84,0.9999720334479962,0.5960128017068943,0.9999499874968742,0.7468694190017651,0.6969882605923463,35756,1,19994,24236
30,10,safari,High,125,0.2,39834,73,39834,20085,0,19910,2,83,0.9999497941560398,0.6639885318042406,0.9998999749937484,0.7980526505589615,0.7479590433445434,39834,2,19993,20158
30,10,giraffe,High,125,0.35,62627,135,62627,42182,0,35010,3,146,0.9999520996327639,0.5967658941911876,0.9999146733411075,0.7474548557652141,0.6979365181330878,62627,3,35156,42317
30,10,safari,High,125,0.35,69738,147,69738,35059,0,35010,6,143,0.9999139710942877,0.6645258423540173,0.9998293466822151,0.7984291994870856,0.7486706209003376,69738,6,35153,35206
30,10,giraffe,High,125,0.3,53557,117,53557,36125,0,29885,3,131,0.9999439880507842,0.5964097595741601,0.9999000632932477,0.7471731806164943,0.6974995409704718,53557,3,30016,36242
30,10,safari,High,125,0.3,59664,125,59664,30010,0,29885,6,128,0.9998994469582705,0.6644171984097819,0.9998001265864952,0.7983461453545553,0.7484434726001101,59664,6,30013,30135
30,10,giraffe,High,125,0.45,80693,171,80693,54480,0,45255,6,179,0.9999256496363028,0.5962067029199669,0.9998679577464789,0.7470086973426585,0.6976668289229135,80693,6,45434,54651
30,10,safari,High,125,0.45,89954,190,89954,45200,0,45255,9,176,0.9998999588719807,0.6646323442487292,0.9998019366197183,0.7985016000390579,0.7488771130188512,89954,9,45431,45390
30,10,giraffe,High,125,0.4,71544,151,71544,48248,0,40042,4,161,0.9999440934757086,0.5964833295815513,0.9999005148357252,0.7472309403575104,0.6977645956915391,71544,4,40203,48399
30,10,safari,High,125,0.4,79713,168,79713,40062,0,40042,7,158,0.9999121926743603,0.6645906805732723,0.999825900962519,0.7984754311014058,0.7487542928504527,79713,7,40200,40230
30,10,giraffe,High,125,0.55,98594,214,98594,66625,0,55338,7,217,0.9999290068052048,0.5959754099847068,0.9998740146143047,0.7468280600225728,0.6975225683839001,98594,7,55555,66839
30,10,safari,High,125,0.55,109902,233,109902,55298,0,55338,10,214,0.9999090181235898,0.6643293659668869,0.9998200208775782,0.7982857869218617,0.7486775718907668,109902,10,55552,55531
30,10,giraffe,High,125,0.5,89673,190,89673,60600,0,50381,7,202,0.999921944692239,0.5959804071432844,0.9998616327337418,0.7468300137834539,0.6976070986257356,89673,7,50583,60790
30,10,safari,High,125,0.5,99957,210,99957,50296,0,50381,10,199,0.9998999669891064,0.6643294364727541,0.9998023324767741,0.7982829533202892,0.7487428687957902,99957,10,50580,50506
30,10,giraffe,High,125,0.65,116586,256,116586,78851,0,65462,7,268,0.9999399620903485,0.5957596848124358,0.9998935150676179,0.7466617139417073,0.6973797957388211,116586,7,65730,79107
30,10,safari,High,125,0.65,129945,277,129945,65471,0,65462,11,264,0.9999153559666348,0.6640247734972635,0.9998326665348282,0.798067858338272,0.7484642160425353,129945,11,65726,65748
30,10,giraffe,High,125,0.6,107548,242,107548,72771,0,60358,7,238,0.9999349170191995,0.5956325009276643,0.9998844941669555,0.7465604131669189,0.6972184903219386,107548,7,60596,73013
30,10,safari,High,125,0.6,119882,263,119882,60416,0,60358,10,235,0.9999165915991058,0.6639418257541773,0.9998349916670792,0.7980083407388177,0.7483496707634638,119882,10,60593,60679
30,10,giraffe,High,125,0.75,134422,290,134422,90855,0,75413,7,313,0.9999479279024616,0.5959293691009766,0.9999075700157131,0.7467971866354072,0.6974709591769,134422,7,75726,91145
30,10,safari,High,125,0.75,149820,311,149820,75436,0,75413,11,309,0.9999265839512518,0.6641929005572623,0.9998547528818349,0.7981928513204652,0.7485628941254564,149820,11,75722,75747
30,10,giraffe,High,125,0.7,125591,270,125591,84850,0,70489,7,290,0.9999442666284495,0.5960343788411616,0.9999011103890599,0.7468786146073998,0.6975918038202894,125591,7,70779,85120
30,10,safari,High,125,0.7,139978,292,139978,70441,0,70489,11,286,0.9999214223974741,0.6643127316561547,0.9998446020399514,0.7982777302537782,0.7486864868897359,139978,11,70775,70733
30,10,giraffe,High,125,0.85,152450,333,152450,102863,0,85287,9,364,0.9999409677355879,0.5963324284361969,0.9998949334578566,0.7471116501880644,0.6976173873298448,152450,9,85651,103196
30,10,safari,High,125,0.85,169817,356,169817,85473,0,85287,14,359,0.9999175651088434,0.664266211871103,0.9998365631566659,0.7982429132479546,0.748486695223641,169817,14,85646,85829
30,10,giraffe,High,125,0.8,143323,311,143323,96840,0,80297,7,337,0.9999511616549223,0.5960020625930454,0.9999131955208889,0.746855165657471,0.6974354981860081,143323,7,80634,97151
30,10,safari,High,125,0.8,159690,332,159690,80452,0,80297,12,332,0.9999248600518466,0.6640634746375907,0.9998511923215238,0.7980988365119348,0.7483892063590926,159690,12,80629,80784
30,10,giraffe,High,125,0.95,170260,385,170260,114941,0,95215,9,396,0.9999471424628088,0.5961776837800172,0.9999058774314997,0.7469919162891709,0.697447049626711,170260,9,95611,115326
30,10,safari,High,125,0.95,189657,410,189657,95519,0,95215,15,390,0.9999209161078072,0.6640976798582564,0.9998431290524995,0.7981222830546777,0.7483145595819584,189657,15,95605,95929
30,10,giraffe,High,125,0.9,161369,363,161369,108813,0,90235,9,381,0.9999442303164,0.5964589994270824,0.9999006896551724,0.747211887303987,0.6976908381094775,161369,9,90616,109176
30,10,safari,High,125,0.9,179719,388,179719,90438,0,90235,15,375,0.9999165433362636,0.6642850542423626,0.9998344827586206,0.7982561922719025,0.748481324583991,179719,15,90610,90826
30,10,giraffe,Mid,125,0.15,39447,77,39447,5435,0,14956,2,65,0.9999493016299525,0.8773994083498299,0.9998668707981095,0.9346744384418538,0.9080724217265179,39447,2,15021,5512
30,10,safari,Mid,125,0.15,39743,76,39743,5140,0,14956,3,64,0.9999245207064862,0.8839831846793745,0.9998003061971643,0.9383861637447612,0.9129905638358174,39743,3,15020,5216
30,10,giraffe,Mid,125,0.1,26347,53,26347,3553,0,10014,1,45,0.9999620464551389,0.8796113911795146,0.9999005964214712,0.9359336423864585,0.9098542973533602,26347,1,10059,3606
30,10,safari,Mid,125,0.1,26524,53,26524,3376,0,10014,2,44,0.9999246022770112,0.885520649016793,0.9998011928429423,0.9392517572903202,0.9142528678179591,26524,2,10058,3429
30,10,giraffe,Mid,125,0.25,65737,134,65737,9126,0,24986,5,108,0.9999239451187977,0.8765283944691121,0.9998007888760508,0.9341689226156218,0.9074388586956522,65737,5,25094,9260
30,10,safari,Mid,125,0.25,66224,133,66224,8640,0,24986,7,106,0.9998943093113497,0.8830219875461686,0.9997211044264712,0.937831025009205,0.9122842071611253,66224,7,25092,8773
30,10,giraffe,Mid,125,0.2,52557,101,52557,7332,0,19910,3,88,0.9999429223744293,0.8760960160026671,0.999850007499625,0.9339315859617948,0.9070395419484693,52557,3,19998,7433
30,10,safari,Mid,125,0.2,52937,100,52937,6953,0,19910,5,86,0.9999055570246685,0.8824304050675112,0.999750012499375,0.9375022137215315,0.9117650735707767,52937,5,19996,7053
30,10,giraffe,Mid,125,0.35,91996,179,91996,12768,0,35010,7,147,0.9999239155244938,0.8766282648675948,0.9998009327721533,0.9342256252983051,0.9075420928290521,91996,7,35157,12947
30,10,safari,Mid,125,0.35,92672,178,92672,12093,0,35010,9,145,0.9999028927180328,0.8830698569699742,0.99974405642134,0.9378617981621665,0.9123527018635756,92672,9,35155,12271
30,10,giraffe,Mid,125,0.3,78724,160,78724,10913,0,29885,7,130,0.9999110896597274,0.8766885307972426,0.9997668376523883,0.9342542485521694,0.9075271868401505,78724,7,30015,11073
30,10,safari,Mid,125,0.3,79309,159,79309,10329,0,29885,9,128,0.9998865326911924,0.8832032250520618,0.9997002198387849,0.9379298110753037,0.9123928592293375,79309,9,30013,10488
30,10,giraffe,Mid,125,0.45,118598,239,118598,16505,0,45257,7,189,0.9999409805657434,0.8762837847822553,0.999845994763822,0.9340374172563566,0.9073481014408584,118598,7,45446,16744
30,10,safari,Mid,125,0.45,119482,238,119482,15622,0,45257,10,186,0.9999163123891139,0.8828153862067947,0.9997799925197457,0.9377241655352112,0.9122210238114992,119482,10,45443,15860
30,10,giraffe,Mid,125,0.4,105186,210,105186,14545,0,40042,7,167,0.9999334556481895,0.8769811824146873,0.9998259399244082,0.9344301615926515,0.9078279438301167,105186,7,40209,14755
30,10,safari,Mid,125,0.4,105956,209,105956,13776,0,40042,10,164,0.9999056301077704,0.8834010054943681,0.9997513427491546,0.9380497284280699,0.9126169945740742,105956,10,40206,13985
30,10,giraffe,Mid,125,0.55,144882,297,144882,20252,0,55340,8,231,0.9999447856994962,0.8757850705127818,0.9998560607423668,0.9337556916869951,0.9069861092258269,144882,8,55571,20549
30,10,safari,Mid,125,0.55,145981,297,145981,19153,0,55340,11,228,0.999924653405666,0.8824283235911045,0.9998020835207543,0.9375094325081962,0.9119451608524501,145981,11,55568,19450
30,10,giraffe,Mid,125,0.5,131824,263,131824,18374,0,50383,7,213,0.9999469017150746,0.8761340147945315,0.9998616682805367,0.9339549119351593,0.9072733060120161,131824,7,50596,18637
30,10,safari,Mid,125,0.5,132814,263,132814,17384,0,50383,10,210,0.9999247124013733,0.8827137929430218,0.9998023832579096,0.937670543798648,0.9121821907452353,132814,10,50593,17647
30,10,giraffe,Mid,125,0.65,171307,344,171307,24042,0,65462,8,279,0.9999533023961708,0.8753864471391414,0.9998783251456296,0.9335327840265062,0.9066944102324799,171307,8,65741,24386
30,10,safari,Mid,125,0.65,172638,344,172638,22711,0,65462,11,276,0.9999362869173873,0.8821879167880302,0.9998326970752407,0.9373788490044578,0.911773930737984,172638,11,65738,23055
30,10,giraffe,Mid,125,0.6,158101,320,158101,22139,0,60360,8,252,0.9999494019948264,0.8756147540983606,0.9998680303530189,0.9336608901316625,0.9068455095779087,158101,8,60612,22459
30,10,safari,Mid,125,0.6,159301,320,159301,20939,0,60360,11,249,0.9999309530983228,0.8822607443509083,0.9998185417354009,0.937417616043687,0.911808607678912,159301,11,60609,21259
30,10,giraffe,Mid,125,0.75,197438,391,197438,27733,0,75413,9,320,0.9999544181476548,0.875315877674431,0.9998811755696971,0.9334931408078788,0.9066291851419165,197438,9,75733,28124
30,10,safari,Mid,125,0.75,198972,392,198972,26198,0,75413,12,317,0.99993969364371,0.882116668587794,0.9998415674262628,0.9373401233317473,0.9117104319889546,198972,12,75730,26590
30,10,giraffe,Mid,125,0.7,184475,373,184475,25858,0,70489,8,298,0.9999566355707572,0.8755090030658833,0.999886997669327,0.9336039211617732,0.9067889634495082,184475,8,70787,26231
30,10,safari,Mid,125,0.7,185908,374,185908,24424,0,70489,11,295,0.9999408344494107,0.8823099484589902,0.9998446217953245,0.9374497321147179,0.9118688743556861,185908,11,70784,24798
30,10,giraffe,Mid,125,0.85,223684,437,223684,31517,0,85287,10,352,0.9999552960741013,0.8750029338361276,0.9998832444044881,0.9333155307803359,0.9063427555107578,223684,10,85639,31954
30,10,safari,Mid,125,0.85,225424,438,225424,29776,0,85287,13,349,0.9999423342219778,0.8818094336522739,0.9998482177258345,0.9371678012783871,0.9114323135660016,225424,13,85636,30214
30,10,giraffe,Mid,125,0.8,210483,411,210483,29574,0,80297,9,339,0.999957243030614,0.8753056539747492,0.9998883997767996,0.9334885577434806,0.9065936290340161,210483,9,80636,29985
30,10,safari,Mid,125,0.8,212129,412,212129,27927,0,80297,12,336,0.9999434338482425,0.8821506395861404,0.9998511997023994,0.9373609450983078,0.9117102079330329,212129,12,80633,28339
30,10,giraffe,Mid,125,0.95,249844,488,249844,35245,0,95213,12,389,0.9999519723360656,0.8748743771382149,0.9998744953667873,0.933240947046596,0.9062281113667426,249844,12,95602,35733
30,10,safari,Mid,125,0.95,251804,491,251804,33282,0,95213,15,386,0.999940433406534,0.8817376749528149,0.9998431192084841,0.9371264393482645,0.9113620206143377,251804,15,95599,33773
30,10,giraffe,Mid,125,0.9,236722,467,236722,33347,0,90235,11,372,0.9999535341502874,0.8750110890971996,0.9998786113134256,0.9333194025260758,0.906341892932101,236722,11,90607,33814
30,10,safari,Mid,125,0.9,238574,469,238574,31493,0,90235,14,369,0.9999413214411454,0.8818567584351066,0.9998455053079962,0.937194082384645,0.911461592561622,238574,14,90604,31962
30,10,giraffe,None,125,0.15,40788,70,40788,4103,0,14958,2,58,0.9999509683746016,0.9071862280643224,0.9998668264748968,0.9513125211367798,0.9303923039730573,40788,2,15016,4173
30,10,safari,None,125,0.15,40788,70,40788,4103,0,14958,2,58,0.9999509683746016,0.9071862280643224,0.9998668264748968,0.9513125211367798,0.9303923039730573,40788,2,15016,4173
30,10,giraffe,None,125,0.1,27197,44,27197,2714,0,10014,1,32,0.9999632325906317,0.9079285595059255,0.9999004678013337,0.9517260686228194,0.9310284485775712,27197,1,10046,2758
30,10,safari,None,125,0.1,27197,44,27197,2714,0,10014,1,32,0.9999632325906317,0.9079285595059255,0.9999004678013337,0.9517260686228194,0.9310284485775712,27197,1,10046,2758
30,10,giraffe,None,125,0.25,68118,118,68118,6764,0,24988,4,104,0.9999412818179149,0.90824,0.9998406120497291,0.9518872011291067,0.9312060421994884,68118,4,25092,6882
30,10,safari,None,125,0.25,68118,118,68118,6764,0,24988,4,104,0.9999412818179149,0.90824,0.9998406120497291,0.9518872011291067,0.9312060421994884,68118,4,25092,6882
30,10,giraffe,None,125,0.2,54463,94,54463,5436,0,19912,2,83,0.9999632791701093,0.9078225793009185,0.9998999849977497,0.9516678606999949,0.9308413551693961,54463,2,19995,5530
30,10,safari,None,125,0.2,54463,94,54463,5436,0,19912,2,83,0.9999632791701093,0.9078225793009185,0.9998999849977497,0.9516678606999949,0.9308413551693961,54463,2,19995,5530
30,10,giraffe,None,125,0.35,95285,169,95285,9492,0,35012,6,143,0.9999370349770702,0.9079431326587006,0.9998293563891812,0.9517222091821191,0.9310027336250152,95285,6,35155,9661
30,10,safari,None,125,0.35,95285,169,95285,9492,0,35012,6,143,0.9999370349770702,0.9079431326587006,0.9998293563891812,0.9517222091821191,0.9310027336250152,95285,6,35155,9661
30,10,giraffe,None,125,0.3,81545,145,81545,8110,0,29887,5,129,0.9999386879215205,0.9080734966592428,0.9998334499183905,0.9517945725124014,0.9310638368900276,81545,5,30016,8255
30,10,safari,None,125,0.3,81545,145,81545,8110,0,29887,5,129,0.9999386879215205,0.9080734966592428,0.9998334499183905,0.9517945725124014,0.9310638368900276,81545,5,30016,8255
30,10,giraffe,None,125,0.45,122881,229,122881,12236,0,45257,10,175,0.9999186270760267,0.9079027086134795,0.9997799392632366,0.9516916630846859,0.9309965263181185,122881,10,45432,12465
30,10,safari,None,125,0.45,122881,229,122881,12236,0,45257,10,175,0.9999186270760267,0.9079027086134795,0.9997799392632366,0.9516916630846859,0.9309965263181185,122881,10,45432,12465
30,10,giraffe,None,125,0.4,108901,192,108901,10852,0,40044,7,158,0.9999357255665332,0.9079244653799659,0.9998259096222238,0.9517113605677008,0.9309976647476803,108901,7,40202,11044
30,10,safari,None,125,0.4,108901,192,108901,10852,0,40044,7,158,0.9999357255665332,0.9079244653799659,0.9998259096222238,0.9517113605677008,0.9309976647476803,108901,7,40202,11044
30,10,giraffe,None,125,0.55,150168,281,150168,14986,0,55340,12,212,0.999920095884938,0.9077160213981322,0.9997840328270103,0.9515897533387196,0.930863940560817,150168,12,55552,15267
30,10,safari,None,125,0.55,150168,281,150168,14986,0,55340,12,212,0.999920095884938,0.9077160213981322,0.9997840328270103,0.9515897533387196,0.930863940560817,150168,12,55552,15267
30,10,giraffe,None,125,0.5,136589,252,136589,13624,0,50383,12,197,0.999912152912497,0.9077792177582826,0.9997628083491461,0.9516208816091073,0.9309250610523384,136589,12,50580,13876
30,10,safari,None,125,0.5,136589,252,136589,13624,0,50383,12,197,0.999912152912497,0.9077792177582826,0.9997628083491461,0.9516208816091073,0.9309250610523384,136589,12,50580,13876
30,10,giraffe,None,125,0.65,177576,345,177576,17774,0,65464,12,263,0.9999324278667477,0.9074120442525359,0.9998174599552777,0.9514282729189382,0.9306478881859284,177576,12,65727,18119
30,10,safari,None,125,0.65,177576,345,177576,17774,0,65464,12,263,0.9999324278667477,0.9074120442525359,0.9998174599552777,0.9514282729189382,0.9306478881859284,177576,12,65727,18119
30,10,giraffe,None,125,0.6,163828,311,163828,16424,0,60360,12,233,0.9999267578125,0.9073176675177085,0.9998019965349394,0.9513738265926835,0.9305587806010748,163828,12,60593,16735
30,10,safari,None,125,0.6,163828,311,163828,16424,0,60360,12,233,0.9999267578125,0.9073176675177085,0.9998019965349394,0.9513738265926835,0.9305587806010748,163828,12,60593,16735
30,10,giraffe,None,125,0.75,204681,386,204681,20500,0,75415,12,308,0.999941375621052,0.9074066685286412,0.9998415527827292,0.9514293682889416,0.9306410179819583,204681,12,75723,20886
30,10,safari,None,125,0.75,204681,386,204681,20500,0,75415,12,308,0.999941375621052,0.9074066685286412,0.9998415527827292,0.9514293682889416,0.9306410179819583,204681,12,75723,20886
30,10,giraffe,None,125,0.7,191189,369,191189,19153,0,70491,12,285,0.9999372388219727,0.9073517756548068,0.9998304797423292,0.9513973208065447,0.9306072135247372,191189,12,70776,19522
30,10,safari,None,125,0.7,191189,369,191189,19153,0,70491,12,285,0.9999372388219727,0.9073517756548068,0.9998304797423292,0.9513973208065447,0.9306072135247372,191189,12,70776,19522
30,10,giraffe,None,125,0.85,231971,437,231971,23236,0,85291,14,359,0.9999396512705563,0.9073985698862481,0.9998365707881958,0.9514241359722249,0.9305993413573663,231971,14,85650,23673
30,10,safari,None,125,0.85,231971,437,231971,23236,0,85291,14,359,0.9999396512705563,0.9073985698862481,0.9998365707881958,0.9514241359722249,0.9305993413573663,231971,14,85650,23673
30,10,giraffe,None,125,0.8,218221,410,218221,21841,0,80299,12,332,0.9999450128990575,0.9074694766958316,0.9998511960120531,0.9514655388539475,0.9306696977718263,218221,12,80631,22251
30,10,safari,None,125,0.8,218221,410,218221,21841,0,80299,12,332,0.9999450128990575,0.9074694766958316,0.9998511960120531,0.9514655388539475,0.9306696977718263,218221,12,80631,22251
30,10,giraffe,None,125,0.95,259109,497,259109,25978,0,95218,15,390,0.9999421126564888,0.9072952266233403,0.9998431339740439,0.9513684396043386,0.930510195248251,259109,15,95608,26475
30,10,safari,None,125,0.95,259109,497,259109,25978,0,95218,15,390,0.9999421126564888,0.9072952266233403,0.9998431339740439,0.9513684396043386,0.930510195248251,259109,15,95608,26475
30,10,giraffe,None,125,0.9,245446,472,245446,24625,0,90238,15,375,0.9999388904958425,0.9072347094546893,0.9998344882376308,0.9513337105913908,0.9304706081053019,245446,15,90613,25097
30,10,safari,None,125,0.9,245446,472,245446,24625,0,90238,15,375,0.9999388904958425,0.9072347094546893,0.9998344882376308,0.9513337105913908,0.9304706081053019,245446,15,90613,25097
30,10,giraffe,Single-stranded,125,0.15,40554,83,40554,4324,0,14958,2,58,0.99995068547194,0.90198171748849,0.9998668264748968,0.948442999637499,0.92649093849514,40554,2,15016,4407
30,10,safari,Single-stranded,125,0.15,40615,83,40615,4263,0,14958,2,58,0.9999507595341852,0.9033384488779164,0.9998668264748968,0.9491925494870177,0.9275079611197252,40615,2,15016,4346
30,10,giraffe,Single-stranded,125,0.1,26994,57,26994,2904,0,10014,1,32,0.999962956102982,0.9011517275913871,0.9999004678013337,0.9479894644424933,0.9259537023148843,26994,1,10046,2961
30,10,safari,Single-stranded,125,0.1,27031,57,27031,2867,0,10014,1,32,0.9999630068067475,0.9023869137038891,0.9999004678013337,0.9486725042553564,0.9268786560671967,27031,1,10046,2924
30,10,giraffe,Single-stranded,125,0.25,67703,138,67703,7159,0,24987,4,104,0.9999409219135392,0.9027066666666667,0.9998406056983463,0.9488392300307623,0.9270592936710126,67703,4,25091,7297
30,10,safari,Single-stranded,125,0.25,67801,138,67801,7061,0,24987,5,103,0.9999262602129605,0.9040133333333333,0.9998007571229328,0.9495539403106313,0.9280283730456067,67801,5,25090,7199
30,10,giraffe,Single-stranded,125,0.2,54146,99,54146,5748,0,19911,2,83,0.99996306419443,0.9025386295067758,0.9998999799959992,0.948756362744325,0.9268774456487767,54146,2,19994,5847
30,10,safari,Single-stranded,125,0.2,54225,99,54225,5669,0,19911,3,82,0.999944678026112,0.903855449802477,0.9998499699939988,0.9494751402981939,0.9278525797297128,54225,3,19993,5768
30,10,giraffe,Single-stranded,125,0.35,94659,182,94659,10105,0,35010,6,143,0.9999366186024402,0.9019781601966725,0.9998293466822151,0.9484347055022018,0.92653367117519,94659,6,35153,10287
30,10,safari,Single-stranded,125,0.35,94791,182,94791,9973,0,35010,7,142,0.9999261587797211,0.9032359499171002,0.9998009044625843,0.9491248798462032,0.9274686842011348,94791,7,35152,10155
30,10,giraffe,Single-stranded,125,0.3,81004,166,81004,8630,0,29885,5,129,0.9999382784628869,0.9020489977728285,0.9998334388220793,0.9484746119935134,0.9265475425433362,81004,5,30014,8796
30,10,safari,Single-stranded,125,0.3,81115,166,81115,8519,0,29885,6,128,0.9999260364147384,0.9032850779510022,0.9998001265864952,0.9491519473908998,0.9274655939375225,81115,6,30013,8685
30,10,giraffe,Single-stranded,125,0.45,122143,222,122143,12981,0,45255,10,175,0.9999181354530793,0.9024500169934834,0.9997799295774648,0.9486871793676869,0.9269135884415829,122143,10,45430,13203
30,10,safari,Single-stranded,125,0.45,122307,222,122307,12817,0,45255,12,173,0.999901895862458,0.9036617262423714,0.9997359154929577,0.9493489608600314,0.9278096755279723,122307,12,45428,13039
30,10,giraffe,Single-stranded,125,0.4,108221,203,108221,11521,0,40042,7,158,0.9999353217282034,0.9022552003001376,0.999825900962519,0.9485872561608956,0.9267508367051301,108221,7,40200,11724
30,10,safari,Single-stranded,125,0.4,108366,203,108366,11376,0,40042,9,156,0.999916955017301,0.9034640877068656,0.9997761583803815,0.9492466713384723,0.9276437384484739,108366,9,40198,11579
30,10,giraffe,Single-stranded,125,0.55,149203,283,149203,15947,0,55339,12,212,0.9999195791307844,0.9018938180411405,0.999784028940122,0.9483804123973457,0.9265054571123459,149203,12,55551,16230
30,10,safari,Single-stranded,125,0.55,149348,283,149348,15802,0,55339,13,211,0.9999129625538126,0.9027703058035579,0.9997660313517989,0.9488617953328208,0.927157052616337,149348,13,55550,16085
30,10,giraffe,Single-stranded,125,0.5,135727,249,135727,14489,0,50381,12,197,0.9999115950463757,0.9020503107034858,0.9997627989721288,0.9484633338457883,0.9266369898783915,135727,12,50578,14738
30,10,safari,Single-stranded,125,0.5,135910,249,135910,14306,0,50381,14,195,0.999897001265413,0.9032665403914532,0.9997232654674837,0.9491286327337991,0.927537241053443,135910,14,50576,14555
30,10,giraffe,Single-stranded,125,0.65,176432,335,176432,18927,0,65463,12,263,0.9999319897531228,0.9015708197492003,0.9998174571784965,0.9482073854322859,0.9262752838214143,176432,12,65726,19262
30,10,safari,Single-stranded,125,0.65,176607,335,176607,18752,0,65463,13,262,0.9999263956516816,0.9024650730221673,0.9998022452767045,0.9486992162529478,0.9269408488631843,176607,13,65725,19087
30,10,giraffe,Single-stranded,125,0.6,162790,309,162790,17463,0,60359,12,233,0.999926290831808,0.9015739745904454,0.9998019932677711,0.9482065679570368,0.9262582619440551,162790,12,60592,17772
30,10,safari,Single-stranded,125,0.6,162818,309,162818,17435,0,60359,12,233,0.9999263035067248,0.9017290459786667,0.9998019932677711,0.9482923306308825,0.9263743645455828,162818,12,60592,17744
30,10,giraffe,Single-stranded,125,0.75,203420,401,203420,21745,0,75414,12,308,0.999941012230131,0.9018203097984625,0.9998415506905749,0.9483494095543569,0.9264586790574179,203420,12,75722,22146
30,10,safari,Single-stranded,125,0.75,203519,401,203519,21646,0,75414,12,308,0.999941040922513,0.9022592057313602,0.9998415506905749,0.9485920432909108,0.9267872552273482,203519,12,75722,22047
30,10,giraffe,Single-stranded,125,0.7,190005,368,190005,20337,0,70490,12,285,0.9999368477557271,0.9017369844810403,0.9998304773475356,0.9483014620926465,0.9264041890322099,190005,12,70775,20705
30,10,safari,Single-stranded,125,0.7,190191,368,190191,20151,0,70490,13,284,0.9999316523311813,0.9026197142992739,0.9998163504598302,0.9487870216555171,0.927061389641808,190191,13,70774,20519
30,10,giraffe,Single-stranded,125,0.85,230446,448,230446,24749,0,85292,14,359,0.9999392519309208,0.9014367692446107,0.9998365726959668,0.9481365060491296,0.9261341662076482,230446,14,85651,25197
30,10,safari,Single-stranded,125,0.85,230486,448,230486,24709,0,85292,14,359,0.999939262472885,0.9015932374444049,0.9998365726959668,0.9482230537105337,0.9262513624058035,230486,14,85651,25157
30,10,giraffe,Single-stranded,125,0.8,216832,420,216832,23219,0,80300,12,332,0.9999446606777223,0.9016970861351264,0.9998511978572492,0.9482829122158687,0.9263472587702225,216832,12,80632,23639
30,10,safari,Single-stranded,125,0.8,217030,420,217030,23021,0,80300,13,331,0.9999401040346844,0.9025204702438132,0.9998387976786866,0.9487359949640884,0.9269607461501331,217030,13,80631,23441
30,10,giraffe,Single-stranded,125,0.95,257466,499,257466,27617,0,95219,15,390,0.999941743274261,0.9015484169170326,0.9998431356144901,0.9481993801824098,0.9262052538522478,257466,15,95609,28116
30,10,safari,Single-stranded,125,0.95,257511,499,257511,27572,0,95219,15,390,0.9999417534540201,0.9017059898733113,0.9998431356144901,0.9482865286462361,0.92632330026285,257511,15,95609,28071
30,10,giraffe,Single-stranded,125,0.9,243889,476,243889,26176,0,90239,15,375,0.9999385003935974,0.9014862811921298,0.9998344900638868,0.9481635548989688,0.9261649638674309,243889,15,90614,26652
30,10,safari,Single-stranded,125,0.9,243933,476,243933,26132,0,90239,15,375,0.9999385114860544,0.9016489182785604,0.9998344900638868,0.9482535097932123,0.926286790154221,243933,15,90614,26608
30,2,giraffe,High,125,0.15,32473,51,32473,12436,0,14956,2,58,0.9999384141647422,0.7222642348754449,0.9998668087373468,0.8387163427390716,0.791766706682673,32473,2,15014,12487
30,2,safari,High,125,0.15,42670,66,42670,2224,0,14956,3,57,0.9999296979354627,0.9490658362989324,0.9998002131060203,0.9738340579462076,0.9617680405495531,42670,3,15013,2290
30,2,giraffe,High,125,0.1,21672,35,21672,8247,0,10014,1,32,0.999953859641028,0.7235093810509448,0.9999004678013337,0.8395606949851822,0.7929301767455813,21672,1,10046,8282
30,2,safari,High,125,0.1,28412,41,28412,1501,0,10014,2,31,0.9999296121630182,0.9485210656339721,0.9998009356026675,0.973547149122807,0.9614009649758756,28412,2,10045,1542
30,2,giraffe,High,125,0.25,54151,104,54151,20744,0,24986,3,105,0.9999446024301067,0.7220229603061374,0.999880449509843,0.8385558213901343,0.7916837341272617,54151,3,25091,20848
30,2,safari,High,125,0.25,71227,125,71227,3647,0,24986,7,101,0.9999017323188365,0.9497059960799478,0.9997210488563003,0.9741576798670615,0.9622451120457974,71227,7,25087,3772
30,2,giraffe,High,125,0.2,43337,75,43337,16580,0,19910,2,83,0.9999538521885599,0.7223796506200827,0.9998999749937484,0.8387995857970987,0.7917536599697451,43337,2,19993,16655
30,2,safari,High,125,0.2,56995,94,56995,2903,0,19910,4,81,0.9999298233302338,0.9500433391118815,0.9997999499874969,0.974348454154593,0.9624814032280246,56995,4,19991,2997
30,2,giraffe,High,125,0.35,75917,149,75917,28878,0,35010,4,145,0.9999473136549835,0.7234048635462723,0.9998862311214767,0.8394880159234789,0.7927881629943684,75917,4,35155,29027
30,2,safari,High,125,0.35,99668,176,99668,5100,0,35010,9,140,0.9999097083579963,0.9497255679219393,0.9997440200233226,0.9741717614516594,0.9622777527961571,99668,9,35150,5276
30,2,giraffe,High,125,0.3,64889,127,64889,24783,0,29885,4,130,0.9999383600696531,0.7226027015891046,0.9998667510576634,0.8389444832311947,0.7920679697541271,64889,4,30015,24910
30,2,safari,High,125,0.3,85269,153,85269,4377,0,29885,8,126,0.9999061880694677,0.9495540039421374,0.999733502115327,0.9740798281889009,0.9621258909345841,85269,8,30011,4530
30,2,giraffe,High,125,0.45,97863,193,97863,37288,0,45255,7,178,0.9999284765505262,0.7230686251329944,0.9998459507042253,0.8392549332372843,0.7926365165058855,97863,7,45433,37481
30,2,safari,High,125,0.45,128580,230,128580,6534,0,45255,15,170,0.9998833547183017,0.9500236434566733,0.9996698943661971,0.9743160351444842,0.9625022125851845,128580,15,45425,6764
30,2,giraffe,High,125,0.4,86748,169,86748,33026,0,40042,5,160,0.9999423651055295,0.7232435406818238,0.9998756435446564,0.8393776367225296,0.7926943490477677,86748,5,40202,33195
30,2,safari,High,125,0.4,113947,200,113947,5796,0,40042,12,153,0.9998946989706824,0.9500095878875799,0.9997015445071754,0.9743140289522962,0.9624851701529816,113947,12,40195,5996
30,2,giraffe,High,125,0.55,119534,235,119534,45664,0,55338,9,215,0.9999247132830864,0.7225523323641595,0.9998380187898204,0.8389057324125541,0.7922667933663657,119534,9,55553,45899
30,2,safari,High,125,0.55,157135,282,157135,8016,0,55338,18,206,0.9998854619383658,0.9498407210169676,0.9996760375796407,0.9742208279342564,0.9623701893708002,157135,18,55544,8298
30,2,giraffe,High,125,0.5,108772,212,108772,41479,0,50381,9,200,0.9999172649635506,0.7229152682054725,0.9998220992290967,0.8391476755489037,0.7925920031036592,108772,9,50581,41691
30,2,safari,High,125,0.5,142919,254,142919,7290,0,50381,18,191,0.9998740703946494,0.9498614277264178,0.9996441984581933,0.9742263122017724,0.9623880270376468,142919,18,50572,7544
30,2,giraffe,High,125,0.65,141379,281,141379,54033,0,65462,9,266,0.9999363453758452,0.7224530259130373,0.999863090801223,0.8388428893945373,0.7922082392992388,141379,9,65728,54314
30,2,safari,High,125,0.65,185865,335,185865,9493,0,65462,22,253,0.999881648528407,0.9497784795572657,0.9996653330696563,0.974186278106819,0.9623226102589604,185865,22,65715,9828
30,2,giraffe,High,125,0.6,130373,267,130373,49921,0,60358,9,236,0.9999309720666963,0.7220440737479301,0.9998514925003713,0.8385652675892368,0.7918553349587832,130373,9,60594,50188
30,2,safari,High,125,0.6,171499,318,171499,8744,0,60358,19,226,0.9998892244545762,0.9498119749004491,0.9996864841674504,0.97420749320465,0.9623451261382295,171499,19,60584,9062
30,2,giraffe,High,125,0.75,162969,313,162969,62285,0,75413,10,310,0.9999386424017819,0.7224860019417734,0.9998679571653044,0.8388659257848492,0.7922071025555925,162969,10,75723,62598
30,2,safari,High,125,0.75,214280,377,214280,10910,0,75413,23,297,0.9998926753241905,0.9499616521920317,0.9996963014802002,0.9742878577761611,0.9624626617988715,214280,23,75710,11287
30,2,giraffe,High,125,0.7,152286,293,152286,58132,0,70489,10,287,0.9999343383936544,0.7227244899411991,0.9998587291272285,0.839025142765842,0.7924134182602302,152286,10,70776,58425
30,2,safari,High,125,0.7,200165,353,200165,10193,0,70489,23,274,0.9998851079984814,0.949950406006331,0.9996750769926257,0.9742783506409117,0.9624543067954543,200165,23,70763,10546
30,2,giraffe,High,125,0.85,184741,359,184741,70546,0,85287,12,361,0.9999350484159932,0.7226438121464838,0.9998599112771422,0.8389710240032334,0.792218712826613,184741,12,85648,70905
30,2,safari,High,125,0.85,242805,433,242805,12408,0,85287,29,344,0.9998805768549709,0.9497703856113532,0.9996614522530937,0.9741815117958594,0.9622919022812374,242805,29,85631,12841
30,2,giraffe,High,125,0.8,173730,336,173730,66408,0,80297,10,334,0.9999424427305169,0.7224481648743731,0.9998759936012698,0.8388417581250273,0.79211808853526,173730,10,80631,66744
30,2,safari,High,125,0.8,228394,403,228394,11677,0,80297,27,317,0.9998817972077874,0.949765879055532,0.9996651827234285,0.9741797204064877,0.9622969964031578,228394,27,80614,12080
30,2,giraffe,High,125,0.95,206292,417,206292,78877,0,95215,12,393,0.9999418334108888,0.7223463335037432,0.9998745032419996,0.8387728963792718,0.7919602524619235,206292,12,95608,79294
30,2,safari,High,125,0.95,271188,499,271188,13899,0,95215,30,375,0.9998893878724864,0.9495843633791572,0.999686258104999,0.9740878298288087,0.9621516975073845,271188,30,95590,14398
30,2,giraffe,High,125,0.9,195465,392,195465,74688,0,90235,12,378,0.9999386117036787,0.7224860928865808,0.9998675862068965,0.8388659762843814,0.7920868289171304,195465,12,90613,75080
30,2,safari,High,125,0.9,256899,469,256899,13177,0,90235,30,360,0.9998832362247936,0.9495610711711545,0.9996689655172414,0.9740726557138362,0.9621341750422239,256899,30,90595,13646
30,2,giraffe,Mid,125,0.15,43695,79,43695,1185,0,14956,2,65,0.9999542302675241,0.9718854956738362,0.9998668707981095,0.9857200866269626,0.9788936681004301,43695,2,15021,1264
30,2,safari,Mid,125,0.15,44701,79,44701,179,0,14956,3,64,0.9999328919112384,0.9942614381992482,0.9998003061971643,0.9970891002977816,0.9956486946083826,44701,3,15020,258
30,2,giraffe,Mid,125,0.1,29115,54,29115,784,0,10014,1,45,0.9999656546228878,0.9720228357760492,0.9999005964214712,0.9857962721562917,0.9790318146602355,29115,1,10059,838
30,2,safari,Mid,125,0.1,29766,55,29766,132,0,10014,2,44,0.999932813759742,0.9937568857877341,0.9998011928429423,0.9968352840709297,0.995276535126084,29766,2,10058,187
30,2,giraffe,Mid,125,0.25,72896,138,72896,1963,0,24986,6,107,0.9999176977312008,0.9719855460885102,0.999760946651261,0.9857537914387522,0.9789502078005116,72896,6,25093,2101
30,2,safari,Mid,125,0.25,74554,137,74554,306,0,24986,9,104,0.9998792967021177,0.9940930970572156,0.9996414199768915,0.9969778015512168,0.9954843350383632,74554,9,25090,443
30,2,giraffe,Mid,125,0.2,58303,104,58303,1583,0,19910,3,88,0.9999485473193154,0.9718786464410735,0.999850007499625,0.9857138026645026,0.9788726231701066,58303,3,19998,1687
30,2,safari,Mid,125,0.2,59635,104,59635,251,0,19910,5,86,0.9999161636485581,0.9940823470578429,0.999750012499375,0.9969907213909553,0.9954994936930405,59635,5,19996,355
30,2,giraffe,Mid,125,0.35,101988,182,101988,2773,0,35010,9,145,0.9999117621106504,0.9718418570080901,0.99974405642134,0.9856770078283562,0.9788447400915015,101988,9,35155,2955
30,2,safari,Mid,125,0.35,104338,182,104338,423,0,35010,12,142,0.9998850023957834,0.9942349656480185,0.99965874189512,0.9970519797604315,0.9955962228867936,104338,12,35152,605
30,2,giraffe,Mid,125,0.3,87281,162,87281,2354,0,29885,9,128,0.9998968954061176,0.9719812465895297,0.9997002198387849,0.9857414717059976,0.9789265475425434,87281,9,30013,2516
30,2,safari,Mid,125,0.3,89272,162,89272,363,0,29885,12,125,0.9998655974194705,0.9941534795149058,0.9996002931183798,0.9970013569278706,0.9955182400120182,89272,12,30010,525
30,2,giraffe,Mid,125,0.45,131512,245,131512,3585,0,45257,10,186,0.9999239670929578,0.9717013196199258,0.9997799925197457,0.9856106481203909,0.9787604745706463,131512,10,45443,3830
30,2,safari,Mid,125,0.45,134534,246,134534,562,0,45257,13,183,0.9999033794882086,0.9940299389694256,0.9997139902756693,0.9969580086628206,0.9954589452141929,134534,13,45440,808
30,2,giraffe,Mid,125,0.4,116543,215,116543,3183,0,40042,10,164,0.9999142021226395,0.9716694041236942,0.9997513427491546,0.9855894864140317,0.9787208801363662,116543,10,40206,3398
30,2,safari,Mid,125,0.4,119232,216,119232,493,0,40042,13,161,0.99989098075391,0.994088760307151,0.999676745573901,0.9969814286789361,0.9954919235500166,119232,13,40203,709
30,2,giraffe,Mid,125,0.55,160699,302,160699,4430,0,55340,12,227,0.9999253318067836,0.9713959294207253,0.99978409111355,0.9854541886662864,0.9785349079227185,160699,12,55567,4732
30,2,safari,Mid,125,0.55,164420,303,164420,708,0,55340,16,223,0.9999026977060984,0.9938886907532446,0.9997121214847334,0.9968866240030073,0.9953531514411113,164420,16,55563,1011
30,2,giraffe,Mid,125,0.5,146173,269,146173,4019,0,50383,11,209,0.99992475236688,0.9715009205043167,0.9997826215837006,0.985507930354464,0.9786187482592608,146173,11,50592,4288
30,2,safari,Mid,125,0.5,149551,270,149551,640,0,50383,15,205,0.9998997098270997,0.9939519210958322,0.9997035748868645,0.996916944141694,0.9953994747940954,149551,15,50588,910
30,2,giraffe,Mid,125,0.65,190105,350,190105,5238,0,65462,12,275,0.9999368809732954,0.9714450695732602,0.9998174877184444,0.9854850833311734,0.9785803352177539,190105,12,65737,5588
30,2,safari,Mid,125,0.65,194494,351,194494,848,0,65462,16,271,0.9999177420184052,0.9938730562667034,0.9997566502912592,0.9968862361386253,0.9953526977302806,194494,16,65733,1199
30,2,giraffe,Mid,125,0.6,175429,326,175429,4805,0,60360,12,248,0.9999316009370671,0.9715828533451484,0.9998020455295282,0.9855534113668221,0.9786756779169086,175429,12,60608,5131
30,2,safari,Mid,125,0.6,179461,327,179461,772,0,60360,16,244,0.9999108520868969,0.9939133805937085,0.9997360607060376,0.9969030960706816,0.9953768969234597,179461,16,60604,1099
30,2,giraffe,Mid,125,0.75,219074,397,219074,6091,0,75413,14,315,0.9999360987365807,0.971236289800587,0.9998151619973067,0.9853772630158552,0.9784204657090513,219074,14,75728,6488
30,2,safari,Mid,125,0.75,224175,399,224175,988,0,75413,19,310,0.9999152519692767,0.9938509146044103,0.9997491484249161,0.9968738604932453,0.9953336165467435,224175,19,75723,1387
30,2,giraffe,Mid,125,0.7,204659,379,204659,5668,0,70489,12,294,0.9999413693195421,0.9713012443879149,0.9998304965039904,0.9854132510947886,0.9784760977758516,204659,12,70783,6047
30,2,safari,Mid,125,0.7,209406,380,209406,920,0,70489,17,289,0.9999188245799172,0.9938302658680815,0.9997598700473197,0.9968652485308085,0.9953215086269676,209406,17,70778,1300
30,2,giraffe,Mid,125,0.85,248292,444,248292,6902,0,85287,15,347,0.9999395909096401,0.9712640530750515,0.9998248666067321,0.9853932472789689,0.9784316425764825,248292,15,85634,7346
30,2,safari,Mid,125,0.85,254061,446,254061,1131,0,85287,20,342,0.9999212849445649,0.9938311205689295,0.9997664888089761,0.996866901174961,0.9953206538778213,254061,20,85629,1577
30,2,giraffe,Mid,125,0.8,233585,418,233585,6465,0,80297,14,334,0.9999400682365934,0.9713766488680406,0.9998263996527993,0.9854514235329604,0.9785215796308465,233585,14,80631,6883
30,2,safari,Mid,125,0.8,238995,420,238995,1053,0,80297,19,329,0.9999205067485587,0.9938744448325765,0.999764399528799,0.9968883086330667,0.9953536605494017,238995,19,80626,1473
30,2,giraffe,Mid,125,0.95,277263,497,277263,7817,0,95213,17,384,0.9999386901327179,0.9708870112088859,0.9998222017696153,0.9851987272077989,0.9781448145417914,277263,17,95597,8314
30,2,safari,Mid,125,0.95,283820,500,283820,1257,0,95213,25,376,0.9999119237612077,0.9938475437447694,0.9997385320141402,0.9968705107986695,0.9953251781915103,283820,25,95589,1757
30,2,giraffe,Mid,125,0.9,262699,475,262699,7362,0,90235,16,367,0.9999390975010943,0.9710315817488245,0.99982343463771,0.9852733515736491,0.9782558133095577,262699,16,90602,7837
30,2,safari,Mid,125,0.9,268873,477,268873,1186,0,90235,24,359,0.9999107464940107,0.9938529437856699,0.9997351519565649,0.9968726422002362,0.9953288624797177,268873,24,90594,1663
30,2,giraffe,None,125,0.15,44791,73,44791,97,0,14958,3,57,0.9999330267446533,0.9962189453081559,0.9998002397123452,0.9980725307782297,0.997115657146668,44791,3,15015,170
30,2,safari,None,125,0.15,44791,73,44791,97,0,14958,3,57,0.9999330267446533,0.9962189453081559,0.9998002397123452,0.9980725307782297,0.997115657146668,44791,3,15015,170
30,2,giraffe,None,125,0.1,29841,46,29841,68,0,10014,2,31,0.999932982608987,0.9961942914371558,0.9998009356026675,0.9980601357904948,0.9971001449927503,29841,2,10045,114
30,2,safari,None,125,0.1,29841,46,29841,68,0,10014,2,31,0.999932982608987,0.9961942914371558,0.9998009356026675,0.9980601357904948,0.9971001449927503,29841,2,10045,114
30,2,giraffe,None,125,0.25,74725,121,74725,154,0,24988,5,103,0.9999330924662116,0.9963333333333333,0.9998007650621613,0.9981299672744273,0.9972026854219949,74725,5,25091,275
30,2,safari,None,125,0.25,74725,121,74725,154,0,24988,5,103,0.9999330924662116,0.9963333333333333,0.9998007650621613,0.9981299672744273,0.9972026854219949,74725,5,25091,275
30,2,giraffe,None,125,0.2,59776,97,59776,120,0,19912,3,82,0.9999498151524783,0.9963829113396563,0.9998499774966245,0.9981631767024012,0.9972496562070259,59776,3,19994,217
30,2,safari,None,125,0.2,59776,97,59776,120,0,19912,3,82,0.9999498151524783,0.9963829113396563,0.9998499774966245,0.9981631767024012,0.9972496562070259,59776,3,19994,217
30,2,giraffe,None,125,0.35,104569,175,104569,202,0,35012,8,141,0.9999235013435076,0.9964076763287786,0.9997724751855749,0.9981624929005406,0.9972521001805763,104569,8,35153,377
30,2,safari,None,125,0.35,104569,175,104569,202,0,35012,8,141,0.9999235013435076,0.9964076763287786,0.9997724751855749,0.9981624929005406,0.9972521001805763,104569,8,35153,377
30,2,giraffe,None,125,0.3,89466,149,89466,185,0,29887,7,127,0.9999217641076079,0.9962806236080178,0.9997668298857466,0.9980978730762581,0.9971540881815375,89466,7,30014,334
30,2,safari,None,125,0.3,89466,149,89466,185,0,29887,7,127,0.9999217641076079,0.9962806236080178,0.9997668298857466,0.9980978730762581,0.9971540881815375,89466,7,30014,334
30,2,giraffe,None,125,0.45,134864,235,134864,247,0,45257,14,171,0.9998962024941058,0.9964387569636339,0.9996919149685313,0.9981644857599622,0.9972564550744518,134864,14,45428,482
30,2,safari,None,125,0.45,134864,235,134864,247,0,45257,14,171,0.9998962024941058,0.9964387569636339,0.9996919149685313,0.9981644857599622,0.9972564550744518,134864,14,45428,482
30,2,giraffe,None,125,0.4,119528,198,119528,219,0,40044,11,154,0.9999079798224847,0.9965234065613406,0.9997264294063518,0.9982128242387801,0.9973275722117462,119528,11,40198,417
30,2,safari,None,125,0.4,119528,198,119528,219,0,40044,11,154,0.9999079798224847,0.9965234065613406,0.9997264294063518,0.9982128242387801,0.9973275722117462,119528,11,40198,417
30,2,giraffe,None,125,0.55,164825,289,164825,321,0,55340,16,208,0.9999029367693717,0.9963127512316016,0.9997120437693471,0.9981046155336748,0.9971674079973213,164825,16,55548,610
30,2,safari,None,125,0.55,164825,289,164825,321,0,55340,16,208,0.9999029367693717,0.9963127512316016,0.9997120437693471,0.9981046155336748,0.9971674079973213,164825,16,55548,610
30,2,giraffe,None,125,0.5,149924,260,149924,281,0,50383,16,193,0.9998932906495932,0.9964044794470475,0.9996837444655281,0.9981458364541202,0.9972296413454891,149924,16,50576,541
30,2,safari,None,125,0.5,149924,260,149924,281,0,50383,16,193,0.9998932906495932,0.9964044794470475,0.9996837444655281,0.9981458364541202,0.9972296413454891,149924,16,50576,541
30,2,giraffe,None,125,0.65,194953,353,194953,389,0,65464,17,258,0.999912807098528,0.9962083854978411,0.99974140160331,0.9980571589469238,0.9970967815968849,194953,17,65722,742
30,2,safari,None,125,0.65,194953,353,194953,389,0,65464,17,258,0.999912807098528,0.9962083854978411,0.99974140160331,0.9980571589469238,0.9970967815968849,194953,17,65722,742
30,2,giraffe,None,125,0.6,179884,319,179884,360,0,60360,17,228,0.999905503582526,0.996239539662057,0.9997194950911641,0.9980691553109327,0.997114044981092,179884,17,60588,679
30,2,safari,None,125,0.6,179884,319,179884,360,0,60360,17,228,0.999905503582526,0.996239539662057,0.9997194950911641,0.9980691553109327,0.997114044981092,179884,17,60588,679
30,2,giraffe,None,125,0.75,224731,394,224731,442,0,75415,18,302,0.9999199106558873,0.996293784108491,0.9997623291740939,0.9981035539487826,0.9971656344796914,224731,18,75717,836
30,2,safari,None,125,0.75,224731,394,224731,442,0,75415,18,302,0.9999199106558873,0.996293784108491,0.9997623291740939,0.9981035539487826,0.9971656344796914,224731,18,75717,836
30,2,giraffe,None,125,0.7,209916,377,209916,418,0,70491,18,279,0.9999142587670411,0.9962270598117802,0.9997457196134938,0.9980672538601434,0.9971118902731448,209916,18,70770,795
30,2,safari,None,125,0.7,209916,377,209916,418,0,70491,18,279,0.9999142587670411,0.9962270598117802,0.9997457196134938,0.9980672538601434,0.9971118902731448,209916,18,70770,795
30,2,giraffe,None,125,0.85,254714,442,254714,488,0,85291,21,352,0.9999175613873241,0.9963621285850636,0.9997548561822936,0.9981366788210331,0.997213660388857,254714,21,85643,930
30,2,safari,None,125,0.85,254714,442,254714,488,0,85291,21,352,0.9999175613873241,0.9963621285850636,0.9997548561822936,0.9981366788210331,0.997213660388857,254714,21,85643,930
30,2,giraffe,None,125,0.8,239597,417,239597,458,0,80299,19,325,0.9999207064636753,0.9963613227319604,0.9997643936857508,0.9981378413957441,0.9972159506718776,239597,19,80624,875
30,2,safari,None,125,0.8,239597,417,239597,458,0,80299,19,325,0.9999207064636753,0.9963613227319604,0.9997643936857508,0.9981378413957441,0.9972159506718776,239597,19,80624,875
30,2,giraffe,None,125,0.95,284525,501,284525,558,0,95218,22,383,0.9999226841259967,0.9962918090649336,0.9997699298285977,0.9981039445320461,0.9971642703308177,284525,22,95601,1059
30,2,safari,None,125,0.95,284525,501,284525,558,0,95218,22,383,0.9999226841259967,0.9962918090649336,0.9997699298285977,0.9981039445320461,0.9971642703308177,284525,22,95601,1059
30,2,giraffe,None,125,0.9,269546,476,269546,521,0,90238,22,368,0.9999183879392213,0.9963148187164332,0.9997572494151917,0.9981133507741927,0.9971786217608833,269546,22,90606,997
30,2,safari,None,125,0.9,269546,476,269546,521,0,90238,22,368,0.9999183879392213,0.9963148187164332,0.9997572494151917,0.9981133507741927,0.9971786217608833,269546,22,90606,997
30,2,giraffe,Single-stranded,125,0.15,44553,84,44553,324,0,14958,3,57,0.999932669000808,0.9909254687395743,0.9998002397123452,0.9954086933208218,0.9931476016605812,44553,3,15015,408
30,2,safari,Single-stranded,125,0.15,44753,84,44753,124,0,14958,3,57,0.9999329698811332,0.9953737683770378,0.9998002397123452,0.9976481603263596,0.9964821020690575,44753,3,15015,208
30,2,giraffe,Single-stranded,125,0.1,29679,58,29679,218,0,10014,2,31,0.9999326168255787,0.9907861792689033,0.9998009356026675,0.995338386209672,0.9930503474826259,29679,2,10045,276
30,2,safari,Single-stranded,125,0.1,29812,58,29812,85,0,10014,2,31,0.9999329174213457,0.9952261725922217,0.9998009356026675,0.997573993207181,0.9963751812409379,29812,2,10045,143
30,2,giraffe,Single-stranded,125,0.25,74374,141,74374,485,0,24987,5,103,0.9999327767246131,0.9916533333333334,0.9998007571229328,0.995775845333012,0.9936959888106299,74374,5,25090,626
30,2,safari,Single-stranded,125,0.25,74684,141,74684,175,0,24987,7,101,0.9999062805425017,0.9957866666666667,0.999721059972106,0.9978422216432519,0.9967730655876917,74684,7,25088,316
30,2,giraffe,Single-stranded,125,0.2,59496,100,59496,397,0,19911,3,82,0.9999495789845207,0.9917157001650192,0.9998499699939988,0.9958156194556957,0.9937491405068197,59496,3,19993,497
30,2,safari,Single-stranded,125,0.2,59746,100,59746,147,0,19911,4,81,0.9999330543933055,0.9958828529995166,0.9997999599919984,0.9979038440660415,0.9968620685344235,59746,4,19992,247
30,2,giraffe,Single-stranded,125,0.35,104076,186,104076,684,0,35010,8,141,0.9999231390031129,0.9917100222971814,0.9997724622429535,0.9957996459838302,0.9937332714749652,104076,8,35151,870
30,2,safari,Single-stranded,125,0.35,104509,186,104509,251,0,35010,11,138,0.9998947569843092,0.9958359537285842,0.999687135584061,0.9978612280752007,0.996802398201349,104509,11,35148,437
30,2,giraffe,Single-stranded,125,0.3,89039,170,89039,591,0,29885,7,127,0.9999213889450397,0.9915256124721603,0.9997668143509111,0.9957058027576797,0.9935903320842271,89039,7,30012,761
30,2,safari,Single-stranded,125,0.3,89418,170,89418,212,0,29885,9,125,0.9998993592539166,0.9957461024498886,0.9997001898797429,0.9978184090566712,0.9967367445897563,89418,9,30010,382
30,2,giraffe,Single-stranded,125,0.45,134243,227,134243,876,0,45255,14,171,0.9998957223831905,0.991850516454125,0.9996919014084507,0.9958568710288832,0.9938214242253272,134243,14,45426,1103
30,2,safari,Single-stranded,125,0.45,134798,227,134798,321,0,45255,17,168,0.9998739012721136,0.9959511178756668,0.9996258802816902,0.9979086544690019,0.9968747580011726,134798,17,45423,548
30,2,giraffe,Single-stranded,125,0.4,118960,208,118960,777,0,40042,11,154,0.9999075404930613,0.9917879027887782,0.9997264157982441,0.9958311707880593,0.9937809081372696,118960,11,40196,985
30,2,safari,Single-stranded,125,0.4,119448,208,119448,289,0,40042,14,151,0.9998828079221844,0.9958564341990079,0.9996518019250379,0.9978655594865646,0.9968092811828763,119448,14,40193,497
30,2,giraffe,Single-stranded,125,0.55,164075,289,164075,1069,0,55339,16,208,0.9999024931288126,0.9917912387492217,0.9997120385868293,0.995830349231012,0.993782692899419,164075,16,55547,1358
30,2,safari,Single-stranded,125,0.55,164674,289,164674,470,0,55339,17,207,0.999896776387295,0.995412039919484,0.9996940409985062,0.997649368116223,0.9964886242284928,164674,17,55546,759
30,2,giraffe,Single-stranded,125,0.5,149232,254,149232,979,0,50381,16,193,0.9998927958833619,0.9918054032499253,0.9996837319628386,0.9958326799304669,0.9937877695158042,149232,16,50574,1233
30,2,safari,Single-stranded,125,0.5,149844,254,149844,367,0,50381,19,190,0.9998732175386853,0.9958727943375536,0.9996244317058707,0.9978689965637569,0.9968167914252319,149844,19,50571,621
30,2,giraffe,Single-stranded,125,0.65,194074,340,194074,1280,0,65463,17,258,0.9999124122190106,0.9917217697016771,0.9997413976695366,0.9958002488551381,0.9937383334863368,194074,17,65721,1620
30,2,safari,Single-stranded,125,0.65,194822,340,194822,532,0,65463,19,256,0.999902484589999,0.9955440636912731,0.9997109738659528,0.9977185143457052,0.9965918479757643,194822,19,65719,872
30,2,giraffe,Single-stranded,125,0.6,179074,314,179074,1174,0,60359,17,228,0.9999050761903167,0.9917590633688151,0.9997194904626757,0.9958154109655695,0.9937594851678927,179074,17,60587,1488
30,2,safari,Single-stranded,125,0.6,179174,314,179174,1074,0,60359,17,228,0.9999051291638531,0.9923128897553195,0.9997194904626757,0.9960945426445366,0.9941741373162054,179174,17,60587,1388
30,2,giraffe,Single-stranded,125,0.75,223703,407,223703,1456,0,75414,18,302,0.9999195426446332,0.9917407765354708,0.9997623260358623,0.9958133665118287,0.9937570527713243,223703,18,75716,1863
30,2,safari,Single-stranded,125,0.75,224115,407,224115,1044,0,75414,18,302,0.9999196905408843,0.9935672929430854,0.9997623260358623,0.996733370543408,0.9951244606704281,224115,18,75716,1451
30,2,giraffe,Single-stranded,125,0.7,208970,372,208970,1368,0,70490,18,279,0.9999138706528604,0.9917422049262019,0.9997457160213034,0.9958112738206996,0.9937548179909556,208970,18,70769,1740
30,2,safari,Single-stranded,125,0.7,209774,372,209774,564,0,70490,20,277,0.9999046683889911,0.9955578757534052,0.9997174622458926,0.9977265376785951,0.996603871444456,209774,20,70767,936
30,2,giraffe,Single-stranded,125,0.85,253543,452,253543,1648,0,85292,21,352,0.9999171806723351,0.9917854195108021,0.9997548590439502,0.9958346998371979,0.9937856715928135,253543,21,85644,2100
30,2,safari,Single-stranded,125,0.85,253693,452,253693,1498,0,85292,21,352,0.9999172296365199,0.9923721752600306,0.9997548590439502,0.9961304154060904,0.994225157335896,253693,21,85644,1950
30,2,giraffe,Single-stranded,125,0.8,238490,426,238490,1555,0,80300,19,325,0.9999203384358661,0.9917620004075336,0.9997643966073111,0.9958244603114953,0.9937717017267957,238490,19,80625,1981
30,2,safari,Single-stranded,125,0.8,239337,426,239337,708,0,80300,20,324,0.9999164428030097,0.9952842546502488,0.9997519964287486,0.9975949715314655,0.9964062718963611,239337,20,80624,1134
30,2,giraffe,Single-stranded,125,0.95,283234,502,283234,1846,0,95219,22,383,0.9999223317423108,0.9917781933034995,0.9997699322345854,0.9958336116785447,0.9937828890416205,283234,22,95602,2348
30,2,safari,Single-stranded,125,0.95,283408,502,283408,1672,0,95219,22,383,0.9999223794234908,0.9923874754011107,0.9997699322345854,0.9961406789312002,0.9942393351626155,283408,22,95602,2174
30,2,giraffe,Single-stranded,125,0.9,268296,480,268296,1765,0,90239,22,368,0.999918007737088,0.9917018122946245,0.9997572520937007,0.9957929625375098,0.9937231774510619,268296,22,90607,2245
30,2,safari,Single-stranded,125,0.9,268458,480,268458,1603,0,90239,22,368,0.9999180572109654,0.9923006124764823,0.9997572520937007,0.9960947718177956,0.9941717196887893,268458,22,90607,2083
10,15,giraffe,High,125,0.15,43717,92,43717,1151,0,14956,8,52,0.9998170383076044,0.9723532028469751,0.9994672349493873,0.9858938941196369,0.9791416566626651,43717,8,15008,1243
10,15,safari,High,125,0.15,43757,92,43757,1111,0,14956,8,52,0.9998172055295327,0.9732428825622775,0.9994672349493873,0.9863510848126233,0.9798085901027077,43757,8,15008,1203
10,15,giraffe,High,125,0.1,29142,58,29142,754,0,10014,6,27,0.9997941539728283,0.9728917673766442,0.9994028068080024,0.9861595208283983,0.979550511237219,29142,6,10041,812
10,15,safari,High,125,0.1,29165,58,29165,731,0,10014,6,27,0.9997943162730109,0.973659611404153,0.9994028068080024,0.986553911205074,0.9801254968625784,29165,6,10041,789
10,15,giraffe,High,125,0.25,72946,159,72946,1894,2,24984,15,93,0.9997670051944136,0.9726263016840224,0.9993225472224436,0.9860099214663224,0.9793192331132047,72946,17,25077,2053
10,15,safari,High,125,0.25,73015,159,73015,1825,2,24984,15,93,0.9997672253258846,0.9735463139508527,0.9993225472224436,0.9864825610851782,0.9800085920094312,73015,17,25077,1984
10,15,giraffe,High,125,0.2,58342,126,58342,1524,1,19909,10,75,0.999811492125512,0.9724963328443792,0.9994498624656164,0.9859647640373485,0.9792341255454011,58342,11,19984,1650
10,15,safari,High,125,0.2,58401,126,58401,1465,1,19909,10,75,0.9998116825309867,0.9734797973063075,0.9994498624656164,0.9864700516874431,0.9799717454086289,58401,11,19984,1591
10,15,giraffe,High,125,0.35,102151,218,102151,2575,2,35008,24,125,0.9997455396028461,0.9733858057630737,0.9992605022895987,0.9863895983507225,0.9798790889559824,102151,26,35133,2793
10,15,safari,High,125,0.35,102233,218,102233,2493,2,35008,24,125,0.9997457436509256,0.9741671748742187,0.9992605022895987,0.9867907317944238,0.9804643726401291,102233,26,35133,2711
10,15,giraffe,High,125,0.3,87389,194,87389,2216,2,29883,20,114,0.9997483154294082,0.9731622846579583,0.9992671308171491,0.986276169516393,0.9797025488657798,87389,22,29997,2410
10,15,safari,High,125,0.3,87459,194,87459,2146,2,29883,20,114,0.9997485168207954,0.9739418033608392,0.9992671308171491,0.9866764440433213,0.9802867682652022,87459,22,29997,2340
10,15,giraffe,High,125,0.45,131722,281,131722,3341,2,45253,33,152,0.9997343594647723,0.9732385624778342,0.9992297535211268,0.9863085499492701,0.9797714399504381,131722,35,45405,3622
10,15,safari,High,125,0.45,131828,281,131828,3235,2,45253,33,152,0.9997345730037994,0.9740217519801395,0.9992297535211268,0.9867106774897364,0.9803577750243384,131828,35,45405,3516
10,15,giraffe,High,125,0.4,116742,247,116742,2954,2,40040,29,136,0.9997345276733491,0.973312323353593,0.9992289899768697,0.9863465080518427,0.9798189197627224,116742,31,40176,3201
10,15,safari,High,125,0.4,116835,247,116835,2861,2,40040,29,136,0.999734738931768,0.9740876916535355,0.9992289899768697,0.9867445916329193,0.9803996253512333,116835,31,40176,3108
10,15,giraffe,High,125,0.55,160991,338,160991,4104,2,55336,42,182,0.9997267674729096,0.9731492507540818,0.9992080918613441,0.9862589901613634,0.9797008982103668,160991,44,55518,4442
10,15,safari,High,125,0.55,161119,338,161119,3976,2,55336,42,182,0.9997269844815497,0.9739229778822847,0.9992080918613441,0.9866562970765104,0.98028009683477,161119,44,55518,4314
10,15,giraffe,High,125,0.5,146446,308,146446,3709,2,50379,39,170,0.9997201116822653,0.9733024065717153,0.9991895631547737,0.9863343997305944,0.9798162673523897,146446,41,50549,4017
10,15,safari,High,125,0.5,146560,308,146560,3595,2,50379,39,170,0.9997203293292679,0.9740600679236756,0.9991895631547737,0.9867233996714513,0.9803832820201638,146560,41,50549,3903
10,15,giraffe,High,125,0.65,190411,405,190411,4877,2,65460,48,227,0.9997374790639554,0.9730087432866786,0.9992393933401281,0.9861920373736903,0.9796044830356119,190411,50,65687,5282
10,15,safari,High,125,0.65,190562,405,190562,4726,2,65460,48,227,0.9997376870291482,0.9737803600537577,0.9992393933401281,0.9865883175211297,0.9801820755077841,190562,50,65687,5131
10,15,giraffe,High,125,0.6,175682,379,175682,4500,2,60356,43,202,0.9997439209683202,0.9729786609511467,0.9992574625018563,0.9861797197772588,0.9795823588927037,175682,45,60558,4879
10,15,safari,High,125,0.6,175819,379,175819,4363,2,60356,43,202,0.9997441204567166,0.9737374073027952,0.9992574625018563,0.9865694045030513,0.9801504370469888,175819,45,60558,4742
10,15,giraffe,High,125,0.75,219548,457,219548,5562,3,75410,52,268,0.9997495480480686,0.973316132235655,0.9992737644091744,0.9863557741986207,0.979840690341852,219548,55,75678,6019
10,15,safari,High,125,0.75,219710,457,219710,5400,3,75410,52,268,0.9997497326689874,0.9740343223964498,0.9992737644091744,0.9867245111512309,0.9803783604381016,219710,55,75678,5857
10,15,giraffe,High,125,0.7,205051,426,205051,5234,3,70486,51,246,0.9997367202164745,0.9731385641945604,0.9992371372870341,0.986258345037228,0.9797013822527416,205051,54,70732,5660
10,15,safari,High,125,0.7,205206,426,205206,5079,3,70486,51,246,0.9997369190295236,0.9738741688853453,0.9992371372870341,0.9866360876118768,0.9802520097905129,205206,54,70732,5505
10,15,giraffe,High,125,0.85,248809,521,248809,6316,3,85284,65,308,0.9997267726628013,0.9732559867942389,0.9992061639038058,0.9863138053171014,0.9797688877429638,248809,68,85592,6837
10,15,safari,High,125,0.85,248996,521,248996,6129,3,85284,65,308,0.9997269778049016,0.9739874670442722,0.9992061639038058,0.9866893859840306,0.9803167831799031,248996,68,85592,6650
10,15,giraffe,High,125,0.8,234059,484,234059,5931,3,80294,57,287,0.9997437200739795,0.9733235193825528,0.999255961607619,0.9863567309252349,0.9798358843405011,234059,60,80581,6415
10,15,safari,High,125,0.8,234231,484,234231,5759,3,80294,57,287,0.9997439082167049,0.9740387734224906,0.999255961607619,0.9867239581687782,0.9803715179919966,234231,60,80581,6243
10,15,giraffe,High,125,0.95,277935,594,277935,7057,3,95212,68,337,0.9997446098285648,0.9732094710525026,0.9992574775151641,0.986298598986501,0.9797432359406725,277935,71,95549,7651
10,15,safari,High,125,0.95,278143,594,278143,6849,3,95212,68,337,0.9997448007648788,0.9739377980713341,0.9992574775151641,0.9866725789286982,0.9802888726830112,278143,71,95549,7443
10,15,giraffe,High,125,0.9,263311,562,263311,6672,3,90232,68,322,0.9997304295661814,0.9732613798074258,0.9992165517241379,0.9863183543817788,0.9797740676135892,263311,71,90554,7234
10,15,safari,High,125,0.9,263509,562,263509,6474,3,90232,68,322,0.9997306320661659,0.9739932358757323,0.9992165517241379,0.986694125906857,0.9803222859041448,263509,71,90554,7036
10,15,giraffe,Mid,125,0.15,44825,86,44825,48,2,14954,11,56,0.999710067353584,0.9970195066616251,0.9991346601877121,0.9983629742641738,0.9975492647794338,44825,13,15010,134
10,15,safari,Mid,125,0.15,44825,86,44825,48,2,14954,11,56,0.999710067353584,0.9970195066616251,0.9991346601877121,0.9983629742641738,0.9975492647794338,44825,13,15010,134
10,15,giraffe,Mid,125,0.1,29854,61,29854,38,0,10014,9,37,0.999698623714965,0.9966948218876239,0.9991053677932406,0.9981944630199278,0.9973008772149051,29854,9,10051,99
10,15,safari,Mid,125,0.1,29854,61,29854,38,0,10014,9,37,0.999698623714965,0.9966948218876239,0.9991053677932406,0.9981944630199278,0.9973008772149051,29854,9,10051,99
10,15,giraffe,Mid,125,0.25,74770,150,74770,77,3,24983,22,91,0.9996657530583595,0.9969732122618238,0.9990039443802542,0.9983176671651356,0.9974824168797954,74770,25,25074,227
10,15,safari,Mid,125,0.25,74770,150,74770,77,3,24983,22,91,0.9996657530583595,0.9969732122618238,0.9990039443802542,0.9983176671651356,0.9974824168797954,74770,25,25074,227
10,15,giraffe,Mid,125,0.2,59812,114,59812,64,2,19908,15,76,0.999715856858714,0.9970328388064678,0.9991500424978751,0.9983725452557608,0.9975622257503969,59812,17,19984,178
10,15,safari,Mid,125,0.2,59812,114,59812,64,2,19908,15,76,0.999715856858714,0.9970328388064678,0.9991500424978751,0.9983725452557608,0.9975622257503969,59812,17,19984,178
10,15,giraffe,Mid,125,0.35,104631,200,104631,112,4,35006,29,125,0.9996847053428113,0.9970269574912095,0.99906154021158,0.9983540626028711,0.9975375962657113,104631,33,35131,312
10,15,safari,Mid,125,0.35,104631,200,104631,112,4,35006,29,125,0.9996847053428113,0.9970269574912095,0.99906154021158,0.9983540626028711,0.9975375962657113,104631,33,35131,312
10,15,giraffe,Mid,125,0.3,89522,180,89522,95,3,29882,27,110,0.9996649991066643,0.9969375368887602,0.9990007327959496,0.9982994050705608,0.9974544938615746,89522,30,29992,275
10,15,safari,Mid,125,0.3,89522,180,89522,95,3,29882,27,110,0.9996649991066643,0.9969375368887602,0.9990007327959496,0.9982994050705608,0.9974544938615746,89522,30,29992,275
10,15,giraffe,Mid,125,0.45,134924,269,134924,149,5,45252,35,161,0.9997036246702824,0.9969115278331929,0.9991199700789827,0.9983056239965076,0.9974667441024364,134924,40,45413,418
10,15,safari,Mid,125,0.45,134924,269,134924,149,5,45252,35,161,0.9997036246702824,0.9969115278331929,0.9991199700789827,0.9983056239965076,0.9974667441024364,134924,40,45413,418
10,15,giraffe,Mid,125,0.4,119570,236,119570,135,5,40037,31,143,0.9996990117552631,0.9969068125161538,0.9991048338969565,0.9983009597281536,0.9974587436078348,119570,36,40180,371
10,15,safari,Mid,125,0.4,119570,236,119570,135,5,40037,31,143,0.9996990117552631,0.9969068125161538,0.9991048338969565,0.9983009597281536,0.9974587436078348,119570,36,40180,371
10,15,giraffe,Mid,125,0.55,164914,332,164914,185,5,55335,44,195,0.9997029636948892,0.9968748299895425,0.9991183720469962,0.998286893829791,0.9974390299081489,164914,49,55530,517
10,15,safari,Mid,125,0.55,164914,332,164914,185,5,55335,44,195,0.9997029636948892,0.9968748299895425,0.9991183720469962,0.998286893829791,0.9974390299081489,164914,49,55530,517
10,15,giraffe,Mid,125,0.5,150002,294,150002,165,5,50378,40,180,0.9997000939705559,0.9969493755857,0.9991107246605933,0.9983228399909487,0.9974933354553774,150002,45,50558,459
10,15,safari,Mid,125,0.5,150002,294,150002,165,5,50378,40,180,0.9997000939705559,0.9969493755857,0.9991107246605933,0.9983228399909487,0.9974933354553774,150002,45,50558,459
10,15,giraffe,Mid,125,0.65,195086,388,195086,219,6,65456,54,233,0.9996925378947045,0.9968982027972385,0.9990874385922219,0.9982934149355617,0.9974487649268289,195086,60,65689,607
10,15,safari,Mid,125,0.65,195086,388,195086,219,6,65456,54,233,0.9996925378947045,0.9968982027972385,0.9990874385922219,0.9982934149355617,0.9974487649268289,195086,60,65689,607
10,15,giraffe,Mid,125,0.6,179998,358,179998,204,6,60354,48,212,0.9997000866416369,0.9968874612317236,0.9991092048828769,0.9982917928410592,0.997445891035741,179998,54,60566,562
10,15,safari,Mid,125,0.6,179998,358,179998,204,6,60354,48,212,0.9997000866416369,0.9968874612317236,0.9991092048828769,0.9982917928410592,0.997445891035741,179998,54,60566,562
10,15,giraffe,Mid,125,0.75,224870,443,224870,249,6,75407,63,266,0.9996932501700461,0.996932107358509,0.9990890127010114,0.9983107695654393,0.9974743116586571,224870,69,75673,692
10,15,safari,Mid,125,0.75,224870,443,224870,249,6,75407,63,266,0.9996932501700461,0.996932107358509,0.9990890127010114,0.9983107695654393,0.9974743116586571,224870,69,75673,692
10,15,giraffe,Mid,125,0.7,210048,421,210048,237,6,70483,58,248,0.999695400548279,0.9968771653393829,0.9990959813546154,0.9982842939227885,0.9974351778501674,210048,64,70731,658
10,15,safari,Mid,125,0.7,210048,421,210048,237,6,70483,58,248,0.999695400548279,0.9968771653393829,0.9990959813546154,0.9982842939227885,0.9974351778501674,210048,64,70731,658
10,15,giraffe,Mid,125,0.85,254866,495,254866,277,7,85280,69,293,0.9997018929795797,0.996980104679273,0.9991126574741095,0.998339143718908,0.9975152877197198,254866,76,85573,772
10,15,safari,Mid,125,0.85,254866,495,254866,277,7,85280,69,293,0.9997018929795797,0.996980104679273,0.9991126574741095,0.998339143718908,0.9975152877197198,254866,76,85573,772
10,15,giraffe,Mid,125,0.8,239739,466,239739,263,7,80290,65,283,0.9996997635638065,0.9969684115973851,0.9991071982143964,0.9983322193974752,0.9975055510054093,239739,72,80573,729
10,15,safari,Mid,125,0.8,239739,466,239739,263,7,80290,65,283,0.9996997635638065,0.9969684115973851,0.9991071982143964,0.9983322193974752,0.9975055510054093,239739,72,80573,729
10,15,giraffe,Mid,125,0.95,284717,554,284717,306,7,95206,75,326,0.999712077640722,0.9969885529997163,0.9991423850063799,0.998348457859377,0.9975287978992159,284717,82,95532,860
10,15,safari,Mid,125,0.95,284717,554,284717,306,7,95206,75,326,0.999712077640722,0.9969885529997163,0.9991423850063799,0.998348457859377,0.9975287978992159,284717,82,95532,860
10,15,giraffe,Mid,125,0.9,269716,530,269716,290,7,90228,73,310,0.9997034796661181,0.9969689800987669,0.9991171731885498,0.9983343573950829,0.9975079882820072,269716,80,90538,820
10,15,safari,Mid,125,0.9,269716,530,269716,290,7,90228,73,310,0.9997034796661181,0.9969689800987669,0.9991171731885498,0.9983343573950829,0.9975079882820072,269716,80,90538,820
10,15,giraffe,None,125,0.15,44876,82,44876,3,1,14957,11,49,0.9997326679736233,0.998109472654078,0.9992009588493808,0.9989204109116405,0.998382767301889,44876,12,15006,85
10,15,safari,None,125,0.15,44876,82,44876,3,1,14957,11,49,0.9997326679736233,0.998109472654078,0.9992009588493808,0.9989204109116405,0.998382767301889,44876,12,15006,85
10,15,giraffe,None,125,0.1,29904,50,29904,1,1,10013,7,26,0.9997325488098422,0.9982974461692539,0.9992037424106699,0.9990144821019927,0.9985250737463127,29904,8,10039,51
10,15,safari,None,125,0.1,29904,50,29904,1,1,10013,7,26,0.9997325488098422,0.9982974461692539,0.9992037424106699,0.9990144821019927,0.9985250737463127,29904,8,10039,51
10,15,giraffe,None,125,0.25,74860,137,74860,3,1,24987,19,89,0.999732905982906,0.9981333333333333,0.9992030602486452,0.9989324793167866,0.9984015345268542,74860,20,25076,140
10,15,safari,None,125,0.25,74860,137,74860,3,1,24987,19,89,0.999732905982906,0.9981333333333333,0.9992030602486452,0.9989324793167866,0.9984015345268542,74860,20,25076,140
10,15,giraffe,None,125,0.2,59882,108,59882,3,1,19911,14,71,0.9997495700953303,0.9981497841414831,0.9992498874831225,0.9989490366168987,0.9984248031003875,59882,15,19982,111
10,15,safari,None,125,0.2,59882,108,59882,3,1,19911,14,71,0.9997495700953303,0.9981497841414831,0.9992498874831225,0.9989490366168987,0.9984248031003875,59882,15,19982,111
10,15,giraffe,None,125,0.35,104746,195,104746,5,1,35011,29,120,0.9997136748873788,0.998094257999352,0.999146781945906,0.9989033100962227,0.9983583975104742,104746,30,35131,200
10,15,safari,None,125,0.35,104746,195,104746,5,1,35011,29,120,0.9997136748873788,0.998094257999352,0.999146781945906,0.9989033100962227,0.9983583975104742,104746,30,35131,200
10,15,giraffe,None,125,0.3,89628,168,89628,4,1,29886,24,110,0.9997211470893334,0.9980846325167038,0.9991672495919524,0.9989022195226606,0.9983558808556097,89628,25,29996,172
10,15,safari,None,125,0.3,89628,168,89628,4,1,29886,24,110,0.9997211470893334,0.9980846325167038,0.9991672495919524,0.9989022195226606,0.9983558808556097,89628,25,29996,172
10,15,giraffe,None,125,0.45,135082,258,135082,6,3,45254,38,147,0.9996965727522331,0.9980494436481314,0.9990977509792702,0.9988723291763566,0.9983129411244109,135082,41,45401,264
10,15,safari,None,125,0.45,135082,258,135082,6,3,45254,38,147,0.9996965727522331,0.9980494436481314,0.9990977509792702,0.9988723291763566,0.9983129411244109,135082,41,45401,264
10,15,giraffe,None,125,0.4,119720,219,119720,6,2,40042,34,131,0.9996993887571395,0.9981241402309392,0.9991046780571514,0.9989111434662351,0.998370318568378,119720,36,40173,225
10,15,safari,None,125,0.4,119720,219,119720,6,2,40042,34,131,0.9996993887571395,0.9981241402309392,0.9991046780571514,0.9989111434662351,0.998370318568378,119720,36,40173,225
10,15,giraffe,None,125,0.55,165107,318,165107,10,4,55336,50,174,0.9996730463002766,0.9980173482032219,0.9990281477215464,0.9988445111253614,0.9982714853913366,165107,54,55510,328
10,15,safari,None,125,0.55,165107,318,165107,10,4,55336,50,174,0.9996730463002766,0.9980173482032219,0.9990281477215464,0.9988445111253614,0.9982714853913366,165107,54,55510,328
10,15,giraffe,None,125,0.5,150172,286,150172,7,3,50380,46,163,0.9996738139141664,0.9980527032864785,0.9990314674256799,0.9988626008527167,0.9982989898387025,150172,49,50543,293
10,15,safari,None,125,0.5,150172,286,150172,7,3,50380,46,163,0.9996738139141664,0.9980527032864785,0.9990314674256799,0.9988626008527167,0.9982989898387025,150172,49,50543,293
10,15,giraffe,None,125,0.65,195293,389,195293,13,4,65460,59,216,0.9996775118245664,0.9979457829786147,0.9990416647652078,0.9988108967883985,0.9982213484091588,195293,63,65676,402
10,15,safari,None,125,0.65,195293,389,195293,13,4,65460,59,216,0.9996775118245664,0.9979457829786147,0.9990416647652078,0.9988108967883985,0.9982213484091588,195293,63,65676,402
10,15,giraffe,None,125,0.6,180199,352,180199,12,4,60356,52,193,0.9996893290061302,0.9979840831178037,0.9990759838297171,0.998835978249422,0.9982584754196245,180199,56,60549,364
10,15,safari,None,125,0.6,180199,352,180199,12,4,60356,52,193,0.9996893290061302,0.9979840831178037,0.9990759838297171,0.998835978249422,0.9982584754196245,180199,56,60549,364
10,15,giraffe,None,125,0.75,225121,433,225121,13,4,75411,67,253,0.9996847134889338,0.9980227604215156,0.9990625206311481,0.998853045640797,0.9982841136135837,225121,71,75664,446
10,15,safari,None,125,0.75,225121,433,225121,13,4,75411,67,253,0.9996847134889338,0.9980227604215156,0.9990625206311481,0.998853045640797,0.9982841136135837,225121,71,75664,446
10,15,giraffe,None,125,0.7,210284,414,210284,13,4,70487,64,233,0.9996767323343728,0.9979735277228051,0.9990393852065321,0.9988244039490527,0.9982415568083723,210284,68,70720,427
10,15,safari,None,125,0.7,210284,414,210284,13,4,70487,64,233,0.9996767323343728,0.9979735277228051,0.9990393852065321,0.9988244039490527,0.9982415568083723,210284,68,70720,427
10,15,giraffe,None,125,0.85,255143,485,255143,16,5,85286,81,292,0.9996630476944235,0.9980402434635666,0.9989960776989167,0.9988509864486869,0.9982801457920705,255143,86,85578,501
10,15,safari,None,125,0.85,255143,485,255143,16,5,85286,81,292,0.9996630476944235,0.9980402434635666,0.9989960776989167,0.9988509864486869,0.9982801457920705,255143,86,85578,501
10,15,giraffe,None,125,0.8,240000,457,240000,15,4,80295,73,271,0.9996792695676804,0.9980371935194118,0.9990451744106742,0.9988575566695591,0.9982903321240054,240000,77,80566,472
10,15,safari,None,125,0.8,240000,457,240000,15,4,80295,73,271,0.9996792695676804,0.9980371935194118,0.9990451744106742,0.9988575566695591,0.9982903321240054,240000,77,80566,472
10,15,giraffe,None,125,0.95,285015,552,285015,17,5,95213,84,321,0.9996878332117403,0.9980075914617066,0.9990692615793272,0.9988470057194123,0.9982739036796281,285015,89,95534,569
10,15,safari,None,125,0.95,285015,552,285015,17,5,95213,84,321,0.9996878332117403,0.9980075914617066,0.9990692615793272,0.9988470057194123,0.9982739036796281,285015,89,95534,569
10,15,giraffe,None,125,0.9,270005,522,270005,16,5,90233,84,306,0.9996704850903759,0.9980114066895096,0.9990179635432758,0.9988402569561462,0.9982639802198958,270005,89,90539,538
10,15,safari,None,125,0.9,270005,522,270005,16,5,90233,84,306,0.9996704850903759,0.9980114066895096,0.9990179635432758,0.9988402569561462,0.9982639802198958,270005,89,90539,538
10,15,giraffe,Single-stranded,125,0.15,44861,94,44861,6,0,14958,11,49,0.9997548582635051,0.9977758501812682,0.9992675456119323,0.9987643738937807,0.9981493522732956,44861,11,15007,100
10,15,safari,Single-stranded,125,0.15,44861,94,44861,6,0,14958,11,49,0.9997548582635051,0.9977758501812682,0.9992675456119323,0.9987643738937807,0.9981493522732956,44861,11,15007,100
10,15,giraffe,Single-stranded,125,0.1,29883,67,29883,5,0,10014,7,26,0.9997658079625292,0.9975963945918879,0.9993032746093361,0.9986799231347647,0.9980250987450627,29883,7,10040,72
10,15,safari,Single-stranded,125,0.1,29883,67,29883,5,0,10014,7,26,0.9997658079625292,0.9975963945918879,0.9993032746093361,0.9986799231347647,0.9980250987450627,29883,7,10040,72
10,15,giraffe,Single-stranded,125,0.25,74837,154,74837,9,0,24987,19,89,0.9997461793309822,0.9978266666666666,0.9992428770671449,0.9987855007473843,0.9981817273590089,74837,19,25076,163
10,15,safari,Single-stranded,125,0.25,74837,154,74837,9,0,24987,19,89,0.9997461793309822,0.9978266666666666,0.9992428770671449,0.9987855007473843,0.9981817273590089,74837,19,25076,163
10,15,giraffe,Single-stranded,125,0.2,59875,111,59875,7,0,19911,14,71,0.9997662341999366,0.9980331038621173,0.9992998599719944,0.9988989172686474,0.9983497730938004,59875,14,19982,118
10,15,safari,Single-stranded,125,0.2,59875,111,59875,7,0,19911,14,71,0.9997662341999366,0.9980331038621173,0.9992998599719944,0.9988989172686474,0.9983497730938004,59875,14,19982,118
10,15,giraffe,Single-stranded,125,0.35,104721,209,104721,16,1,35009,29,120,0.999713606552682,0.9978560402492711,0.9991467334110754,0.9987839597133006,0.9981799364762143,104721,30,35129,225
10,15,safari,Single-stranded,125,0.35,104721,209,104721,16,1,35009,29,120,0.999713606552682,0.9978560402492711,0.9991467334110754,0.9987839597133006,0.9981799364762143,104721,30,35129,225
10,15,giraffe,Single-stranded,125,0.3,89599,187,89599,14,0,29885,24,110,0.9997322115974694,0.9977616926503341,0.9992005063459809,0.9987459801697665,0.9981221676028009,89599,24,29995,201
10,15,safari,Single-stranded,125,0.3,89599,187,89599,14,0,29885,24,110,0.9997322115974694,0.9977616926503341,0.9992005063459809,0.9987459801697665,0.9981221676028009,89599,24,29995,201
10,15,giraffe,Single-stranded,125,0.45,135073,254,135073,19,2,45253,38,147,0.9997039515072569,0.9979829474088632,0.9991197183098591,0.998842708136908,0.9982686712466673,135073,40,45400,273
10,15,safari,Single-stranded,125,0.45,135073,254,135073,19,2,45253,38,147,0.9997039515072569,0.9979829474088632,0.9991197183098591,0.998842708136908,0.9982686712466673,135073,40,45400,273
10,15,giraffe,Single-stranded,125,0.4,119692,234,119692,19,2,40040,34,131,0.999699318455165,0.9978906999041227,0.9991046335215261,0.9987941904177776,0.9981954643089065,119692,36,40171,253
10,15,safari,Single-stranded,125,0.4,119692,234,119692,19,2,40040,34,131,0.999699318455165,0.9978906999041227,0.9991046335215261,0.9987941904177776,0.9981954643089065,119692,36,40171,253
10,15,giraffe,Single-stranded,125,0.55,165088,318,165088,27,2,55337,50,174,0.9996851156594405,0.9979145635997655,0.9990641254071955,0.9987990549742418,0.998203587395247,165088,52,55511,345
10,15,safari,Single-stranded,125,0.55,165088,318,165088,27,2,55337,50,174,0.9996851156594405,0.9979145635997655,0.9990641254071955,0.9987990549742418,0.998203587395247,165088,52,55511,345
10,15,giraffe,Single-stranded,125,0.5,150159,283,150159,23,2,50379,46,163,0.9996804409914318,0.9979663044561858,0.9990511958885155,0.9988226372924649,0.9982392877570814,150159,48,50542,306
10,15,safari,Single-stranded,125,0.5,150159,283,150159,23,2,50379,46,163,0.9996804409914318,0.9979663044561858,0.9990511958885155,0.9988226372924649,0.9982392877570814,150159,48,50542,306
10,15,giraffe,Single-stranded,125,0.65,195279,379,195279,36,2,65461,59,216,0.9996877239684653,0.9978793422383926,0.9990720739906903,0.9987827145465612,0.99817925885125,195279,61,65677,415
10,15,safari,Single-stranded,125,0.65,195279,379,195279,36,2,65461,59,216,0.9996877239684653,0.9978793422383926,0.9990720739906903,0.9987827145465612,0.99817925885125,195279,61,65677,415
10,15,giraffe,Single-stranded,125,0.6,180184,348,180184,30,2,60357,52,193,0.9997003961428778,0.9979065362590135,0.99910896970497,0.9988026607538802,0.9982087027192887,180184,54,60550,378
10,15,safari,Single-stranded,125,0.6,180184,348,180184,30,2,60357,52,193,0.9997003961428778,0.9979065362590135,0.99910896970497,0.9988026607538802,0.9982087027192887,180184,54,60550,378
10,15,giraffe,Single-stranded,125,0.75,225076,450,225076,40,3,75411,67,253,0.9996890906345216,0.997827686796769,0.9990757123616869,0.9987575214327554,0.9981413873216064,225076,70,75664,490
10,15,safari,Single-stranded,125,0.75,225076,450,225076,40,3,75411,67,253,0.9996890906345216,0.997827686796769,0.9990757123616869,0.9987575214327554,0.9981413873216064,225076,70,75664,490
10,15,giraffe,Single-stranded,125,0.7,210259,413,210259,38,2,70488,64,233,0.9996861999286818,0.9978596174837454,0.9990676254114456,0.9987720735805812,0.9981633907288532,210259,66,70721,451
10,15,safari,Single-stranded,125,0.7,210259,413,210259,38,2,70488,64,233,0.9996861999286818,0.9978596174837454,0.9990676254114456,0.9987720735805812,0.9981633907288532,210259,66,70721,451
10,15,giraffe,Single-stranded,125,0.85,255102,499,255102,42,4,85288,81,292,0.9996669109319832,0.9978837675977829,0.9990077627969416,0.998774543390169,0.998165879498869,255102,85,85580,541
10,15,safari,Single-stranded,125,0.85,255102,499,255102,42,4,85288,81,292,0.9996669109319832,0.9978837675977829,0.9990077627969416,0.998774543390169,0.998165879498869,255102,85,85580,541
10,15,giraffe,Single-stranded,125,0.8,239959,470,239959,42,4,80296,73,271,0.999679214784449,0.997870845133093,0.9990451862506821,0.9987742114058692,0.9981657661585414,239959,77,80567,512
10,15,safari,Single-stranded,125,0.8,239959,470,239959,42,4,80296,73,271,0.999679214784449,0.997870845133093,0.9990451862506821,0.9987742114058692,0.9981657661585414,239959,77,80567,512
10,15,giraffe,Single-stranded,125,0.95,284981,554,284981,47,5,95214,84,321,0.9996877959799347,0.9978955256283659,0.9990692713126412,0.9987908567743563,0.9981899550374338,284981,89,95535,601
10,15,safari,Single-stranded,125,0.95,284981,554,284981,47,5,95214,84,321,0.9996877959799347,0.9978955256283659,0.9990692713126412,0.9987908567743563,0.9981899550374338,284981,89,95535,601
10,15,giraffe,Single-stranded,125,0.9,269966,530,269966,45,4,90235,84,306,0.9996741392462248,0.9978746289841466,0.9990290083748028,0.9987735735624635,0.998164299360412,269966,88,90541,575
10,15,safari,Single-stranded,125,0.9,269966,530,269966,45,4,90235,84,306,0.9996741392462248,0.9978746289841466,0.9990290083748028,0.9987735735624635,0.998164299360412,269966,88,90541,575
10,5,giraffe,High,125,0.15,44797,92,44797,71,0,14956,10,50,0.9997768205860691,0.9963745551601424,0.9993340436867342,0.9980727884411866,0.9971155128718154,44797,10,15006,163
10,5,safari,High,125,0.15,44812,92,44812,56,0,14956,10,50,0.9997768952746419,0.9967081850533808,0.9993340436867342,0.9982401817736294,0.9973656129118313,44812,10,15006,148
10,5,giraffe,High,125,0.1,29849,57,29849,48,0,10014,6,27,0.9997990286384191,0.9964946250918074,0.9994028068080024,0.9981440920262836,0.9972250693732657,29849,6,10041,105
10,5,safari,High,125,0.1,29856,57,29856,41,0,10014,6,27,0.9997990757484428,0.9967283167523536,0.9994028068080024,0.9982613347599305,0.9974000649983751,29856,6,10041,98
10,5,giraffe,High,125,0.25,74732,157,74732,110,2,24984,20,88,0.9997057013671509,0.9964399525327005,0.9991232964055152,0.9980701555227608,0.9971126852027614,74732,22,25072,267
10,5,safari,High,125,0.25,74751,157,74751,91,2,24984,20,88,0.9997057761491448,0.9966932892438566,0.9991232964055152,0.9981972598349491,0.9973025086669397,74751,22,25072,248
10,5,giraffe,High,125,0.2,59778,124,59778,90,1,19909,15,70,0.9997324146235408,0.996432857714362,0.9991997999499875,0.9980799091713556,0.9971245327365696,59778,16,19979,214
10,5,safari,High,125,0.2,59794,124,59794,74,1,19909,15,70,0.99973248620632,0.9966995599413255,0.9991997999499875,0.9982137193035175,0.9973245652418518,59794,16,19979,198
10,5,giraffe,High,125,0.35,104577,215,104577,152,4,35006,32,117,0.9996558745089043,0.9965028967830462,0.9989760800932905,0.9980768955463192,0.9971235448205963,104577,36,35123,367
10,5,safari,High,125,0.35,104606,215,104606,123,5,35005,32,117,0.9996464168649599,0.9967792346394267,0.9989476378736597,0.9982107668891677,0.9973233977859146,104606,37,35122,338
10,5,giraffe,High,125,0.3,89479,191,89479,129,2,29883,26,108,0.9996871753047247,0.9964364859296874,0.9990672574036443,0.99805918374176,0.9970955949857283,89479,28,29991,320
10,5,safari,High,125,0.3,89503,191,89503,105,2,29883,26,108,0.9996872591616311,0.9967037494849609,0.9990672574036443,0.9981932749679362,0.9972958987798161,89503,28,29991,296
10,5,giraffe,High,125,0.45,134872,275,134872,197,5,45250,42,143,0.9996516428375544,0.9965125901406786,0.9989656690140845,0.9980796483425405,0.9971291707230728,134872,47,45393,472
10,5,safari,High,125,0.45,134910,275,134910,159,7,45248,42,143,0.9996369267703524,0.9967933561886748,0.9989216549295775,0.9982131163916049,0.9973283033896805,134910,49,45391,434
10,5,giraffe,High,125,0.4,119520,242,119520,181,5,40037,37,128,0.9996487178200432,0.996473324829294,0.9989554057751138,0.9980584956472726,0.9970964720574461,119520,42,40165,423
10,5,safari,High,125,0.4,119555,242,119555,146,6,40036,37,128,0.9996404622150872,0.9967651301034658,0.9989305344840451,0.9982007255542892,0.9973087730252888,119555,43,40164,388
10,5,giraffe,High,125,0.55,164852,332,164852,249,6,55332,53,171,0.9996422312641364,0.9964880042071412,0.9989381231777114,0.9980626256266196,0.9971040068779836,164852,59,55503,581
10,5,safari,High,125,0.55,164897,332,164897,204,9,55329,53,171,0.9996241490309713,0.9967600176506501,0.9988841294409848,0.9981900288142571,0.997294056426616,164897,62,55500,536
10,5,giraffe,High,125,0.5,149936,301,149936,226,6,50375,49,160,0.9996333113320133,0.9964974777852362,0.9989128286222574,0.9980629314304352,0.9971052409066266,149936,55,50535,527
10,5,safari,High,125,0.5,149980,301,149980,182,8,50373,49,160,0.9996200937102181,0.996789908482484,0.9988732951176121,0.9982029950083194,0.9973141410473855,149980,57,50533,483
10,5,giraffe,High,125,0.65,194996,397,194996,300,8,65454,61,214,0.9996462717555686,0.9964382987638801,0.9989503628093768,0.9980397074404106,0.9970699613663313,194996,69,65668,697
10,5,safari,High,125,0.65,195049,397,195049,247,11,65451,61,214,0.9996309982011162,0.9967091311390801,0.9989047264097844,0.9981679264304759,0.9972612171518188,195049,72,65665,644
10,5,giraffe,High,125,0.6,179916,371,179916,274,6,60352,54,191,0.9996666222162955,0.9964278000232608,0.9990099500024752,0.9980445834962847,0.9970766781111609,179916,60,60543,645
10,5,safari,High,125,0.6,179963,371,179963,227,9,60349,54,191,0.9996500505482542,0.9966880998665271,0.9989604475025989,0.9981668778963191,0.9972591265694714,179963,63,60540,598
10,5,giraffe,High,125,0.75,224771,447,224771,349,9,75404,71,249,0.9996442088316263,0.996471115012391,0.9989436573224354,0.9980551398922778,0.9970925987387985,224771,80,75653,796
10,5,safari,High,125,0.75,224833,447,224833,287,13,75400,71,249,0.9996265288973266,0.9967459779134359,0.9988908401885571,0.998184175242628,0.9972850979090607,224833,84,75649,734
10,5,giraffe,High,125,0.7,209967,418,209967,326,9,70480,66,231,0.9996429285571458,0.996469097484232,0.9989404684542141,0.9980534898146894,0.9970905551391311,209967,75,70711,744
10,5,safari,High,125,0.7,210027,418,210027,266,12,70477,66,231,0.9996287570500464,0.9967538476871165,0.9988980871923827,0.9981892323485799,0.9972930439756019,210027,78,70708,684
10,5,giraffe,High,125,0.85,254746,510,254746,390,10,85277,87,286,0.9996193734966234,0.9964795068180218,0.9988676161568993,0.9980469706497104,0.997078867643698,254746,97,85563,900
10,5,safari,High,125,0.85,254813,510,254813,323,14,85273,87,286,0.9996037879441694,0.9967415879771246,0.9988209199159468,0.9981706361642119,0.9972634527374262,254813,101,85559,833
10,5,giraffe,High,125,0.8,239634,474,239634,366,10,80287,76,268,0.99964124812281,0.9965068988747224,0.9989335449709205,0.9980716127231911,0.9971162978995064,239634,86,80555,840
10,5,safari,High,125,0.8,239698,474,239698,302,14,80283,76,268,0.9996246684571372,0.9967730399128388,0.9988839424114284,0.9981968175704095,0.9973031468477025,239698,90,80551,776
10,5,giraffe,High,125,0.95,284557,582,284557,447,11,95204,92,313,0.9996381648282161,0.9963968822001078,0.9989228194938298,0.9980148918186186,0.9970304769599639,284557,103,95517,1029
10,5,safari,High,125,0.95,284632,582,284632,372,16,95199,92,313,0.9996207066095385,0.9966595001155519,0.9988705291779962,0.9981379070917334,0.9972141047097894,284632,108,95512,954
10,5,giraffe,High,125,0.9,269574,551,269574,420,10,90225,90,300,0.9996291819011103,0.9964109482710825,0.9988965517241379,0.9980174706924414,0.9970346374283579,269574,100,90525,971
10,5,safari,High,125,0.9,269644,551,269644,350,14,90221,90,300,0.9996144549727894,0.9966696852649282,0.9988524137931034,0.9981398981663653,0.9972173768585431,269644,104,90521,901
10,5,giraffe,Mid,125,0.15,44873,86,44873,0,4,14952,18,49,0.9995099677024167,0.998087146066416,0.9985355787792052,0.9987980501702761,0.9981994598379513,44873,22,15001,86
10,5,safari,Mid,125,0.15,44873,86,44873,0,4,14952,18,49,0.9995099677024167,0.998087146066416,0.9985355787792052,0.9987980501702761,0.9981994598379513,44873,22,15001,86
10,5,giraffe,Mid,125,0.1,29892,61,29892,0,1,10013,14,32,0.9994984451800581,0.9979634761125764,0.9985089463220675,0.9987303708653524,0.9981006172993777,29892,15,10045,61
10,5,safari,Mid,125,0.1,29892,61,29892,0,1,10013,14,32,0.9994984451800581,0.9979634761125764,0.9985089463220675,0.9987303708653524,0.9981006172993777,29892,15,10045,61
10,5,giraffe,Mid,125,0.25,74847,150,74847,0,7,24979,33,80,0.9994658618985939,0.9979999199967998,0.9984063110084067,0.9987323530196685,0.9981018222506394,74847,40,25059,150
10,5,safari,Mid,125,0.25,74847,150,74847,0,7,24979,33,80,0.9994658618985939,0.9979999199967998,0.9984063110084067,0.9987323530196685,0.9981018222506394,74847,40,25059,150
10,5,giraffe,Mid,125,0.2,59876,114,59876,0,5,19905,25,66,0.9994992154375187,0.9980996832805468,0.9985000749962502,0.9987989590978849,0.9981997974772162,59876,30,19971,114
10,5,safari,Mid,125,0.2,59876,114,59876,0,5,19905,25,66,0.9994992154375187,0.9980996832805468,0.9985000749962502,0.9987989590978849,0.9981997974772162,59876,30,19971,114
10,5,giraffe,Mid,125,0.35,104743,200,104743,0,9,35001,41,113,0.9995228688939146,0.9980942035200061,0.9985780912296667,0.9988080253270779,0.9982156494679066,104743,50,35114,200
10,5,safari,Mid,125,0.35,104743,200,104743,0,9,35001,41,113,0.9995228688939146,0.9980942035200061,0.9985780912296667,0.9988080253270779,0.9982156494679066,104743,50,35114,200
10,5,giraffe,Mid,125,0.3,89617,180,89617,0,7,29878,39,98,0.9994869678685746,0.9979954786908248,0.9984677902871227,0.9987406664437758,0.9981138216810356,89617,46,29976,180
10,5,safari,Mid,125,0.3,89617,180,89617,0,7,29878,39,98,0.9994869678685746,0.9979954786908248,0.9984677902871227,0.9987406664437758,0.9981138216810356,89617,46,29976,180
10,5,giraffe,Mid,125,0.45,135073,269,135073,0,11,45246,53,143,0.9995264065355898,0.99801244255294,0.9985919521263723,0.9987688508165143,0.9981581349041733,135073,64,45389,269
10,5,safari,Mid,125,0.45,135073,269,135073,0,11,45246,53,143,0.9995264065355898,0.99801244255294,0.9985919521263723,0.9987688508165143,0.9981581349041733,135073,64,45389,269
10,5,giraffe,Mid,125,0.4,119705,236,119705,0,10,40032,46,128,0.9995324020340511,0.9980323659132406,0.9986075193952656,0.998781820760778,0.9981767890257685,119705,56,40160,236
10,5,safari,Mid,125,0.4,119705,236,119705,0,10,40032,46,128,0.9995324020340511,0.9980323659132406,0.9986075193952656,0.998781820760778,0.9981767890257685,119705,56,40160,236
10,5,giraffe,Mid,125,0.55,165099,332,165099,0,11,55329,68,171,0.9995217280751674,0.9979931209990872,0.9985785998308714,0.9987568396504632,0.9981403556400162,165099,79,55500,332
10,5,safari,Mid,125,0.55,165099,332,165099,0,11,55329,68,171,0.9995217280751674,0.9979931209990872,0.9985785998308714,0.9987568396504632,0.9981403556400162,165099,79,55500,332
10,5,giraffe,Mid,125,0.5,150167,294,150167,0,11,50372,63,157,0.999507458017452,0.998046005277115,0.9985376361085311,0.9987761970322777,0.9981697369991644,150167,74,50529,294
10,5,safari,Mid,125,0.5,150167,294,150167,0,11,50372,63,157,0.999507458017452,0.998046005277115,0.9985376361085311,0.9987761970322777,0.9981697369991644,150167,74,50529,294
10,5,giraffe,Mid,125,0.65,195304,389,195304,0,14,65448,82,205,0.9995087001023542,0.9980121925669289,0.9985399017475551,0.9987598857560733,0.9981449040322519,195304,96,65653,389
10,5,safari,Mid,125,0.65,195304,389,195304,0,14,65448,82,205,0.9995087001023542,0.9980121925669289,0.9985399017475551,0.9987598857560733,0.9981449040322519,195304,96,65653,389
10,5,giraffe,Mid,125,0.6,180202,358,180202,0,13,60347,74,186,0.9995174414412415,0.9980172795746566,0.9985648300890795,0.9987667971921774,0.99815490505017,180202,87,60533,358
10,5,safari,Mid,125,0.6,180202,358,180202,0,13,60347,74,186,0.9995174414412415,0.9980172795746566,0.9985648300890795,0.9987667971921774,0.99815490505017,180202,87,60533,358
10,5,giraffe,Mid,125,0.75,225118,444,225118,0,15,75398,92,237,0.9995249195249195,0.9980315833340723,0.9985873095508436,0.998777693234277,0.9981712821602103,225118,107,75635,444
10,5,safari,Mid,125,0.75,225118,444,225118,0,15,75398,92,237,0.9995249195249195,0.9980315833340723,0.9985873095508436,0.998777693234277,0.9981712821602103,225118,107,75635,444
10,5,giraffe,Mid,125,0.7,210284,422,210284,0,14,70475,86,220,0.9995246786827896,0.9979972093817926,0.9985874708665866,0.9987603600180485,0.9981456548999826,210284,100,70695,422
10,5,safari,Mid,125,0.7,210284,422,210284,0,14,70475,86,220,0.9995246786827896,0.9979972093817926,0.9985874708665866,0.9987603600180485,0.9981456548999826,210284,100,70695,422
10,5,giraffe,Mid,125,0.85,255142,496,255142,0,18,85269,101,261,0.9995338104920062,0.9980597563742479,0.9986106084134082,0.9987962395698562,0.9981979975797496,255142,119,85530,496
10,5,safari,Mid,125,0.85,255142,496,255142,0,18,85269,101,261,0.9995338104920062,0.9980597563742479,0.9986106084134082,0.9987962395698562,0.9981979975797496,255142,119,85530,496
10,5,giraffe,Mid,125,0.8,240001,467,240001,0,17,80280,96,252,0.9995293902063187,0.9980579536570354,0.9985987971975944,0.9987931299965459,0.9981937822511079,240001,113,80532,467
10,5,safari,Mid,125,0.8,240001,467,240001,0,17,80280,96,252,0.9995293902063187,0.9980579536570354,0.9985987971975944,0.9987931299965459,0.9981937822511079,240001,113,80532,467
10,5,giraffe,Mid,125,0.95,285022,555,285022,0,18,95195,109,292,0.9995546188133222,0.9980565661800496,0.9986717426318321,0.9988050307853505,0.9982108706658867,285022,127,95487,555
10,5,safari,Mid,125,0.95,285022,555,285022,0,18,95195,109,292,0.9995546188133222,0.9980565661800496,0.9986717426318321,0.9988050307853505,0.9982108706658867,285022,127,95487,555
10,5,giraffe,Mid,125,0.9,270005,531,270005,0,18,90217,106,277,0.9995409600598233,0.9980372297956649,0.9986316184422521,0.9987885289412114,0.998186369249683,270005,124,90494,531
10,5,safari,Mid,125,0.9,270005,531,270005,0,18,90217,106,277,0.9995409600598233,0.9980372297956649,0.9986316184422521,0.9987885289412114,0.998186369249683,270005,124,90494,531
10,5,giraffe,None,125,0.15,44879,82,44879,0,2,14956,17,43,0.9995768185665286,0.9981761971486399,0.9987348515115195,0.9988760168708753,0.9983160772937195,44879,19,14999,82
10,5,safari,None,125,0.15,44879,82,44879,0,2,14956,17,43,0.9995768185665286,0.9981761971486399,0.9987348515115195,0.9988760168708753,0.9983160772937195,44879,19,14999,82
10,5,giraffe,None,125,0.1,29905,50,29905,0,1,10013,9,24,0.999665719538693,0.9983308295776999,0.9990046780133374,0.9989978286286956,0.9985000749962502,29905,10,10037,50
10,5,safari,None,125,0.1,29905,50,29905,0,1,10013,9,24,0.999665719538693,0.9983308295776999,0.9990046780133374,0.9989978286286956,0.9985000749962502,29905,10,10037,50
10,5,giraffe,None,125,0.25,74863,137,74863,0,4,24984,29,79,0.9995593890194403,0.9981733333333334,0.9986850494102646,0.9988658803437049,0.9983016304347826,74863,33,25063,137
10,5,safari,None,125,0.25,74863,137,74863,0,4,24984,29,79,0.9995593890194403,0.9981733333333334,0.9986850494102646,0.9988658803437049,0.9983016304347826,74863,33,25063,137
10,5,giraffe,None,125,0.2,59885,108,59885,0,3,19909,23,62,0.9995660229340187,0.9981997899754972,0.9986998049707456,0.9988824392847612,0.9983247905988248,59885,26,19971,108
10,5,safari,None,125,0.2,59885,108,59885,0,3,19909,23,62,0.9995660229340187,0.9981997899754972,0.9986998049707456,0.9988824392847612,0.9983247905988248,59885,26,19971,108
10,5,giraffe,None,125,0.35,104751,195,104751,0,6,35006,43,106,0.9995324427480916,0.9981419015493682,0.9986064105116464,0.9988366881847568,0.9982584738806769,104751,49,35112,195
10,5,safari,None,125,0.35,104751,195,104751,0,6,35006,43,106,0.9995324427480916,0.9981419015493682,0.9986064105116464,0.9988366881847568,0.9982584738806769,104751,49,35112,195
10,5,giraffe,None,125,0.3,89632,168,89632,0,5,29882,36,98,0.9995427832234898,0.9981291759465479,0.9986342893308018,0.9988354794314466,0.9982557314661036,89632,41,29980,168
10,5,safari,None,125,0.3,89632,168,89632,0,5,29882,36,98,0.9995427832234898,0.9981291759465479,0.9986342893308018,0.9988354794314466,0.9982557314661036,89632,41,29980,168
10,5,giraffe,None,125,0.45,135088,258,135088,0,11,45246,53,132,0.9995264590979046,0.9980937744743102,0.9985916112847146,0.9988096030284882,0.998218908334624,135088,64,45378,258
10,5,safari,None,125,0.45,135088,258,135088,0,11,45246,53,132,0.9995264590979046,0.9980937744743102,0.9985916112847146,0.9988096030284882,0.998218908334624,135088,64,45378,258
10,5,giraffe,None,125,0.4,119726,219,119726,0,9,40035,48,117,0.9995241394855697,0.9981741631581141,0.998582406923823,0.9988486951878796,0.9982766587159858,119726,57,40152,219
10,5,safari,None,125,0.4,119726,219,119726,0,9,40035,48,117,0.9995241394855697,0.9981741631581141,0.998582406923823,0.9988486951878796,0.9982766587159858,119726,57,40152,219
10,5,giraffe,None,125,0.55,165117,318,165117,0,13,55327,68,156,0.9995096792939382,0.9980777949043431,0.9985422215823195,0.9987932239068695,0.9981945619663437,165117,81,55483,318
10,5,safari,None,125,0.55,165117,318,165117,0,13,55327,68,156,0.9995096792939382,0.9980777949043431,0.9985422215823195,0.9987932239068695,0.9981945619663437,165117,81,55483,318
10,5,giraffe,None,125,0.5,150179,286,150179,0,12,50371,63,146,0.9995008452354014,0.9980992257335592,0.9985175521821632,0.9987995437601215,0.9982044892741859,150179,75,50517,286
10,5,safari,None,125,0.5,150179,286,150179,0,12,50371,63,146,0.9995008452354014,0.9980992257335592,0.9985175521821632,0.9987995437601215,0.9982044892741859,150179,75,50517,286
10,5,giraffe,None,125,0.65,195306,389,195306,0,13,65451,82,193,0.9995138202977467,0.9980122128822914,0.998554891312615,0.9987624521856527,0.9981486723226513,195306,95,65644,389
10,5,safari,None,125,0.65,195306,389,195306,0,13,65451,82,193,0.9995138202977467,0.9980122128822914,0.998554891312615,0.9987624521856527,0.9981486723226513,195306,95,65644,389
10,5,giraffe,None,125,0.6,180211,352,180211,0,13,60347,72,173,0.999528553046102,0.998050541916118,0.9985974754558204,0.9987890006900203,0.9981879851389902,180211,85,60520,352
10,5,safari,None,125,0.6,180211,352,180211,0,13,60347,72,173,0.999528553046102,0.998050541916118,0.9985974754558204,0.9987890006900203,0.9981879851389902,180211,85,60520,352
10,5,giraffe,None,125,0.75,225134,433,225134,0,13,75402,95,225,0.9995205157119897,0.9980803929652831,0.9985739750445632,0.9987999352275576,0.9982044593132472,225134,108,75627,433
10,5,safari,None,125,0.75,225134,433,225134,0,13,75402,95,225,0.9995205157119897,0.9980803929652831,0.9985739750445632,0.9987999352275576,0.9982044593132472,225134,108,75627,433
10,5,giraffe,None,125,0.7,210297,414,210297,0,13,70478,90,207,0.9995104562737642,0.9980352236000968,0.9985449511216591,0.9987722951905792,0.9981634037776334,210297,103,70685,414
10,5,safari,None,125,0.7,210297,414,210297,0,13,70478,90,207,0.9995104562737642,0.9980352236000968,0.9985449511216591,0.9987722951905792,0.9981634037776334,210297,103,70685,414
10,5,giraffe,None,125,0.85,255159,485,255159,0,14,85277,112,261,0.9995064339855456,0.9981028304986622,0.9985291370937617,0.9988041391269629,0.9982098280731773,255159,126,85538,485
10,5,safari,None,125,0.85,255159,485,255159,0,14,85277,112,261,0.9995064339855456,0.9981028304986622,0.9985291370937617,0.9988041391269629,0.9982098280731773,255159,126,85538,485
10,5,giraffe,None,125,0.8,240015,457,240015,0,13,80286,101,243,0.9995252551753433,0.9980995708440068,0.9985863621145047,0.9988119042615393,0.9982218208430002,240015,114,80529,457
10,5,safari,None,125,0.8,240015,457,240015,0,13,80286,101,243,0.9995252551753433,0.9980995708440068,0.9985863621145047,0.9988119042615393,0.9982218208430002,240015,114,80529,457
10,5,giraffe,None,125,0.95,285032,552,285032,0,16,95202,118,287,0.9995300982585582,0.9980671186060843,0.9985986635014589,0.9987980727113447,0.9982004527723782,285032,134,95489,552
10,5,safari,None,125,0.95,285032,552,285032,0,16,95202,118,287,0.9995300982585582,0.9980671186060843,0.9985986635014589,0.9987980727113447,0.9982004527723782,285032,134,95489,552
10,5,giraffe,None,125,0.9,270021,522,270021,0,14,90224,116,274,0.999518787640986,0.9980705470110112,0.9985655647261332,0.9987941423429888,0.998194760930418,270021,130,90498,522
10,5,safari,None,125,0.9,270021,522,270021,0,14,90224,116,274,0.999518787640986,0.9980705470110112,0.9985655647261332,0.9987941423429888,0.998194760930418,270021,130,90498,522
10,5,giraffe,Single-stranded,125,0.15,44867,94,44867,0,2,14956,17,43,0.9995767054315376,0.9979092991703922,0.9987348515115195,0.9987423063652654,0.9981160072692109,44867,19,14999,94
10,5,safari,Single-stranded,125,0.15,44867,94,44867,0,2,14956,17,43,0.9995767054315376,0.9979092991703922,0.9987348515115195,0.9987423063652654,0.9981160072692109,44867,19,14999,94
10,5,giraffe,Single-stranded,125,0.1,29888,67,29888,0,2,10012,9,24,0.9996320947188869,0.9977633116341178,0.998905145814671,0.9986968289504461,0.9980500974951253,29888,11,10036,67
10,5,safari,Single-stranded,125,0.1,29888,67,29888,0,2,10012,9,24,0.9996320947188869,0.9977633116341178,0.998905145814671,0.9986968289504461,0.9980500974951253,29888,11,10036,67
10,5,giraffe,Single-stranded,125,0.25,74846,154,74846,0,3,24984,29,79,0.9995726381580705,0.9979466666666666,0.9987248455867703,0.9987589906457253,0.9981417653229432,74846,32,25063,154
10,5,safari,Single-stranded,125,0.25,74846,154,74846,0,3,24984,29,79,0.9995726381580705,0.9979466666666666,0.9987248455867703,0.9987589906457253,0.9981417653229432,74846,32,25063,154
10,5,giraffe,Single-stranded,125,0.2,59882,111,59882,0,3,19908,23,62,0.9995660012018428,0.9981497841414831,0.9986997399479896,0.9988573906806448,0.9982872644988686,59882,26,19970,111
10,5,safari,Single-stranded,125,0.2,59882,111,59882,0,3,19908,23,62,0.9995660012018428,0.9981497841414831,0.9986997399479896,0.9988573906806448,0.9982872644988686,59882,26,19970,111
10,5,giraffe,Single-stranded,125,0.35,104737,209,104737,0,7,35003,43,106,0.9995228415738594,0.9980084996093229,0.998577889018459,0.9987650965751694,0.9981513864601549,104737,50,35109,209
10,5,safari,Single-stranded,125,0.35,104737,209,104737,0,7,35003,43,106,0.9995228415738594,0.9980084996093229,0.998577889018459,0.9987650965751694,0.9981513864601549,104737,50,35109,209
10,5,giraffe,Single-stranded,125,0.3,89613,187,89613,0,5,29880,36,98,0.9995426863274366,0.9979175946547885,0.9986341983410507,0.9987294794209101,0.9980971298375049,89613,41,29978,187
10,5,safari,Single-stranded,125,0.3,89613,187,89613,0,5,29880,36,98,0.9995426863274366,0.9979175946547885,0.9986341983410507,0.9987294794209101,0.9980971298375049,89613,41,29978,187
10,5,giraffe,Single-stranded,125,0.45,135092,254,135092,0,9,45246,53,132,0.9995412640395401,0.9981233283584295,0.9986355633802817,0.9988317929759705,0.9982520770413639,135092,62,45378,254
10,5,safari,Single-stranded,125,0.45,135092,254,135092,0,9,45246,53,132,0.9995412640395401,0.9981233283584295,0.9986355633802817,0.9988317929759705,0.9982520770413639,135092,62,45378,254
10,5,giraffe,Single-stranded,125,0.4,119711,234,119711,0,9,40033,48,117,0.999524079887783,0.9980491058401767,0.998582336409083,0.9987860483161114,0.998182976172636,119711,57,40150,234
10,5,safari,Single-stranded,125,0.4,119711,234,119711,0,9,40033,48,117,0.999524079887783,0.9980491058401767,0.998582336409083,0.9987860483161114,0.998182976172636,119711,57,40150,234
10,5,giraffe,Single-stranded,125,0.55,165115,318,165115,0,9,55330,67,157,0.9995399265093134,0.9980777716658707,0.9986321832874395,0.9988083139759968,0.9982171623015801,165115,76,55487,318
10,5,safari,Single-stranded,125,0.55,165115,318,165115,0,9,55330,67,157,0.9995399265093134,0.9980777716658707,0.9986321832874395,0.9988083139759968,0.9982171623015801,165115,76,55487,318
10,5,giraffe,Single-stranded,125,0.5,150182,283,150182,0,9,50372,63,146,0.9995208114259854,0.9981191639251653,0.9985767938327733,0.9988194959413937,0.9982343139936833,150182,72,50518,283
10,5,safari,Single-stranded,125,0.5,150182,283,150182,0,9,50372,63,146,0.9995208114259854,0.9981191639251653,0.9985767938327733,0.9988194959413937,0.9982343139936833,150182,72,50518,283
10,5,giraffe,Single-stranded,125,0.65,195315,379,195315,0,10,65453,81,194,0.9995343029384973,0.9980633029116887,0.9986157169369314,0.998798261314242,0.9982022093699318,195315,91,65647,379
10,5,safari,Single-stranded,125,0.65,195315,379,195315,0,10,65453,81,194,0.9995343029384973,0.9980633029116887,0.9986157169369314,0.998798261314242,0.9982022093699318,195315,91,65647,379
10,5,giraffe,Single-stranded,125,0.6,180214,348,180214,0,9,60350,71,174,0.9995562802977359,0.9980726841749649,0.9986799551184741,0.9988139313188641,0.9982252888052213,180214,80,60524,348
10,5,safari,Single-stranded,125,0.6,180214,348,180214,0,9,60350,71,174,0.9995562802977359,0.9980726841749649,0.9986799551184741,0.9988139313188641,0.9982252888052213,180214,80,60524,348
10,5,giraffe,Single-stranded,125,0.75,225116,450,225116,0,13,75401,94,226,0.9995249153061633,0.9980050184868287,0.998587160324293,0.9987643886607704,0.9981513441752407,225116,107,75627,450
10,5,safari,Single-stranded,125,0.75,225116,450,225116,0,13,75401,94,226,0.9995249153061633,0.9980050184868287,0.998587160324293,0.9987643886607704,0.9981513441752407,225116,107,75627,450
10,5,giraffe,Single-stranded,125,0.7,210297,413,210297,0,10,70480,89,208,0.9995294587349569,0.9980399601347824,0.9986014381171684,0.9987841541084667,0.998181152907491,210297,99,70688,413
10,5,safari,Single-stranded,125,0.7,210297,413,210297,0,10,70480,89,208,0.9995294587349569,0.9980399601347824,0.9986014381171684,0.9987841541084667,0.998181152907491,210297,99,70688,413
10,5,giraffe,Single-stranded,125,0.85,255144,499,255144,0,14,85278,111,262,0.9995103204854486,0.9980480592075668,0.9985408276425611,0.9987786546411124,0.9981717393087768,255144,125,85540,499
10,5,safari,Single-stranded,125,0.85,255144,499,255144,0,14,85278,111,262,0.9995103204854486,0.9980480592075668,0.9985408276425611,0.9987786546411124,0.9981717393087768,255144,125,85540,499
10,5,giraffe,Single-stranded,125,0.8,240001,470,240001,0,14,80286,100,244,0.9995252274951586,0.9980455023682689,0.9985863796438669,0.9987848168694053,0.9981813369042244,240001,114,80530,470
10,5,safari,Single-stranded,125,0.8,240001,470,240001,0,14,80286,100,244,0.9995252274951586,0.9980455023682689,0.9985863796438669,0.9987848168694053,0.9981813369042244,240001,114,80530,470
10,5,giraffe,Single-stranded,125,0.95,285028,554,285028,0,16,95203,117,288,0.999533596810223,0.998060101827146,0.9986091357818121,0.9987963058679651,0.9981978247981407,285028,133,95491,554
10,5,safari,Single-stranded,125,0.95,285028,554,285028,0,16,95203,117,288,0.999533596810223,0.998060101827146,0.9986091357818121,0.9987963058679651,0.9981978247981407,285028,133,95491,554
10,5,giraffe,Single-stranded,125,0.9,270011,530,270011,0,14,90225,115,275,0.9995224698304582,0.998040962367996,0.9985766145494268,0.9987811667138293,0.9981753744773929,270011,129,90500,530
10,5,safari,Single-stranded,125,0.9,270011,530,270011,0,14,90225,115,275,0.9995224698304582,0.998040962367996,0.9985766145494268,0.9987811667138293,0.9981753744773929,270011,129,90500,530
10,8,giraffe,High,125,0.15,44655,93,44655,212,0,14956,9,51,0.9997984954325632,0.9932161921708185,0.9994006393180608,0.9964964741587075,0.994764572495665,44655,9,15007,305
10,8,safari,High,125,0.15,44683,93,44683,184,0,14956,9,51,0.9997986216772576,0.9938389679715303,0.9994006393180608,0.9968098871190826,0.9952314259036948,44683,9,15007,277
10,8,giraffe,High,125,0.1,29766,58,29766,130,0,10014,6,27,0.9997984683595325,0.9937237096881886,0.9994028068080024,0.9967518333724006,0.9951501212469688,29766,6,10041,188
10,8,safari,High,125,0.1,29782,58,29782,114,0,10014,6,27,0.9997985766080301,0.9942578620551512,0.9994028068080024,0.9970205215761105,0.9955501112472188,29782,6,10041,172
10,8,giraffe,High,125,0.25,74511,158,74511,330,1,24985,18,90,0.9997450690996914,0.993493246576621,0.9992428468956722,0.9966093533695805,0.9949347107190313,74511,19,25075,488
10,8,safari,High,125,0.25,74554,158,74554,287,1,24985,18,90,0.9997452160969788,0.9940665875545007,0.9992428468956722,0.9968978150990827,0.9953643111905928,74554,19,25075,445
10,8,giraffe,High,125,0.2,59599,125,59599,268,0,19910,13,72,0.999781923102731,0.9934491265502067,0.9993498374593648,0.9966054647001773,0.9949241751784665,59599,13,19982,393
10,8,safari,High,125,0.2,59637,125,59637,230,0,19910,13,72,0.9997820620284996,0.9940825443392453,0.9993498374593648,0.9969241570685881,0.9953992523785115,59637,13,19982,355
10,8,giraffe,High,125,0.35,104293,216,104293,435,3,35007,28,121,0.9997028488171465,0.9937966915688368,0.9991182911914446,0.9967410210830131,0.9951321527733168,104293,31,35128,651
10,8,safari,High,125,0.35,104338,216,104338,390,4,35006,29,120,0.9996838202182599,0.9942254916908065,0.9990614067521829,0.9969471848649165,0.9954390698271985,104338,33,35126,606
10,8,giraffe,High,125,0.3,89222,192,89222,385,1,29884,23,111,0.999731080384555,0.9935745386919677,0.9992005063459809,0.9966433019631936,0.9949840591563872,89222,24,29995,577
10,8,safari,High,125,0.3,89263,192,89263,344,1,29884,24,110,0.9997200071678165,0.9940311139322264,0.9991671941103968,0.9968674443147745,0.9953178988132,89263,25,29994,536
10,8,giraffe,High,125,0.45,134502,278,134502,564,4,45251,38,147,0.9996878344630753,0.9937788154628207,0.9990757042253521,0.9967245672278872,0.9951101867421895,134502,42,45398,842
10,8,safari,High,125,0.45,134558,278,134558,508,5,45250,39,146,0.9996731103549724,0.9941925759546045,0.999031690140845,0.9969253109881235,0.9954088857421011,134558,44,45396,786
10,8,giraffe,High,125,0.4,119196,245,119196,502,4,40038,33,132,0.9996896832252816,0.9937720417198169,0.9990797622304574,0.9967220791383751,0.9951045894473931,119196,37,40170,747
10,8,safari,High,125,0.4,119248,245,119248,450,5,40037,34,131,0.9996730574161476,0.9942055809843009,0.99903001964832,0.9969318229319065,0.9954167967530441,119248,39,40168,695
10,8,giraffe,High,125,0.55,164397,336,164397,700,5,55333,48,176,0.9996777135907571,0.9937376460561073,0.9990461106511644,0.9966988295850346,0.995072286703319,164397,53,55509,1036
10,8,safari,High,125,0.55,164461,336,164461,636,6,55332,49,175,0.9996656860123028,0.9941245096202088,0.9990101148266801,0.9968873977493491,0.9953528360370144,164461,55,55507,972
10,8,giraffe,High,125,0.5,149520,305,149520,638,5,50376,45,164,0.9996657083639767,0.9937326784658023,0.9990116623838703,0.9966903640599535,0.9950610038149145,149520,50,50540,943
10,8,safari,High,125,0.5,149579,305,149579,579,6,50375,46,163,0.9996524784302718,0.9941248014462027,0.9989721288792252,0.9968809772937812,0.9953445111488015,149579,52,50538,884
10,8,giraffe,High,125,0.65,194454,402,194454,837,5,65457,56,219,0.9996863995064648,0.9936686544740997,0.9990720598749563,0.9966684434968016,0.9950273495773247,194454,61,65676,1239
10,8,safari,High,125,0.65,194532,402,194532,759,6,65456,57,218,0.9996762506744777,0.994067237969677,0.9990416356085614,0.9968638543844546,0.9953180583712657,194532,63,65674,1161
10,8,giraffe,High,125,0.6,179415,376,179415,770,5,60353,49,196,0.9996991123815255,0.9936531144599332,0.9991089550022276,0.9966669444212982,0.9950241329551675,179415,54,60549,1146
10,8,safari,High,125,0.6,179486,376,179486,699,6,60352,50,195,0.9996880952646178,0.9940463333721014,0.9990759533356435,0.9968592319419721,0.9953102453102453,179486,56,60547,1075
10,8,giraffe,High,125,0.75,224166,452,224166,949,6,75407,63,257,0.9996922871095056,0.9937889850909043,0.9990889044406005,0.996731895367295,0.9951211417192167,224166,69,75664,1401
10,8,safari,High,125,0.75,224259,452,224259,856,7,75406,64,256,0.9996835019836847,0.9942012794424716,0.9990624958736614,0.9969348539776882,0.9954231662794557,224259,71,75662,1308
10,8,giraffe,High,125,0.7,209391,423,209391,897,6,70483,60,237,0.999684899525917,0.9937354955365406,0.9990676122397084,0.9967013194722112,0.9950763240816065,209391,66,70720,1320
10,8,safari,High,125,0.7,209479,423,209479,809,7,70482,61,236,0.9996754904627602,0.9941531291674378,0.9990393580651541,0.9969066620980445,0.9953818335541764,209479,68,70718,1232
10,8,giraffe,High,125,0.85,254045,516,254045,1085,6,85281,77,296,0.9996733929358433,0.9937374337951699,0.9990310530002334,0.9966965753451529,0.9950660111454237,254045,83,85577,1601
10,8,safari,High,125,0.85,254146,516,254146,984,7,85280,78,295,0.9996656583972844,0.9941325113633697,0.9990077048797572,0.9968914071432915,0.9953560734355681,254146,85,85575,1500
10,8,giraffe,High,125,0.8,238977,479,238977,1018,6,80291,68,276,0.9996904426252139,0.993774794780309,0.9990823526493967,0.9967238413012878,0.995107671706398,238977,74,80567,1497
10,8,safari,High,125,0.8,239076,479,239076,919,7,80290,69,275,0.9996822104770188,0.9941864816986452,0.9990575513696507,0.9969267721099357,0.9954097441726484,239076,76,80565,1398
10,8,giraffe,High,125,0.95,283775,589,283775,1222,6,95209,82,323,0.9996899912986194,0.993658652735078,0.9990796904413303,0.996665197410128,0.9950184414725897,283775,88,95532,1811
10,8,safari,High,125,0.95,283892,589,283892,1105,8,95207,83,322,0.9996795582834184,0.9940683366831707,0.9990483162518302,0.9968660513475978,0.9953174923794483,283892,91,95529,1694
10,8,giraffe,High,125,0.9,268834,557,268834,1154,6,90229,80,310,0.999680202290644,0.9936757286218559,0.9990510344827587,0.9966689219875247,0.9950245036963203,268834,86,90539,1711
10,8,safari,High,125,0.9,268941,557,268941,1047,7,90228,81,309,0.9996728977173465,0.9940712265981629,0.9990289655172414,0.9968641928632588,0.9953152255170695,268941,88,90537,1604
10,8,giraffe,Mid,125,0.15,44872,86,44872,1,2,14954,16,51,0.9995990198262419,0.9980649035788163,0.9988018371829861,0.998831372636312,0.9982494748424527,44872,18,15005,87
10,8,safari,Mid,125,0.15,44872,86,44872,1,2,14954,16,51,0.9995990198262419,0.9980649035788163,0.9988018371829861,0.998831372636312,0.9982494748424527,44872,18,15005,87
10,8,giraffe,Mid,125,0.1,29891,61,29891,1,0,10014,13,33,0.9995652755484216,0.9979300904750776,0.9987077534791252,0.9987470137160231,0.9981256091770174,29891,13,10047,62
10,8,safari,Mid,125,0.1,29891,61,29891,1,0,10014,13,33,0.9995652755484216,0.9979300904750776,0.9987077534791252,0.9987470137160231,0.9981256091770174,29891,13,10047,62
10,8,giraffe,Mid,125,0.25,74845,150,74845,2,4,24982,28,85,0.9995726324505523,0.9979732522634238,0.9987250488067254,0.9987723020670697,0.9981617647058824,74845,32,25067,152
10,8,safari,Mid,125,0.25,74845,150,74845,2,4,24982,28,85,0.9995726324505523,0.9979732522634238,0.9987250488067254,0.9987723020670697,0.9981617647058824,74845,32,25067,152
10,8,giraffe,Mid,125,0.2,59874,114,59874,2,2,19908,21,70,0.9996160074795065,0.9980663443907318,0.9988500574971252,0.9988405748746736,0.9982623045092572,59874,23,19978,116
10,8,safari,Mid,125,0.2,59874,114,59874,2,2,19908,21,70,0.9996160074795065,0.9980663443907318,0.9988500574971252,0.9988405748746736,0.9982623045092572,59874,23,19978,116
10,8,giraffe,Mid,125,0.35,104741,200,104741,2,5,35005,36,118,0.9996087114199004,0.9980751455552062,0.9988340348083267,0.9988413398498034,0.9982656112828053,104741,41,35123,202
10,8,safari,Mid,125,0.35,104741,200,104741,2,5,35005,36,118,0.9996087114199004,0.9980751455552062,0.9988340348083267,0.9988413398498034,0.9982656112828053,104741,41,35123,202
10,8,giraffe,Mid,125,0.3,89615,180,89615,2,4,29881,34,103,0.9995761435757866,0.997973206231834,0.9987342615415362,0.9987740317637225,0.9981638972116276,89615,38,29984,182
10,8,safari,Mid,125,0.3,89615,180,89615,2,4,29881,34,103,0.9995761435757866,0.997973206231834,0.9987342615415362,0.9987740317637225,0.9981638972116276,89615,38,29984,182
10,8,giraffe,Mid,125,0.45,135071,269,135071,2,6,45251,46,150,0.9996151654418567,0.9979976651741514,0.9988559611026775,0.998805760449596,0.9982134461683122,135071,52,45401,271
10,8,safari,Mid,125,0.45,135071,269,135071,2,6,45251,46,150,0.9996151654418567,0.9979976651741514,0.9988559611026775,0.998805760449596,0.9982134461683122,135071,52,45401,271
10,8,giraffe,Mid,125,0.4,119703,236,119703,2,6,40036,40,134,0.9996158631804859,0.9980156910480986,0.998856176646111,0.9988151362176145,0.9982267400113638,119703,46,40170,238
10,8,safari,Mid,125,0.4,119703,236,119703,2,6,40036,40,134,0.9996158631804859,0.9980156910480986,0.998856176646111,0.9988151362176145,0.9982267400113638,119703,46,40170,238
10,8,giraffe,Mid,125,0.55,165097,332,165097,2,6,55334,58,181,0.9996124993188464,0.9979810313665516,0.9988484859389337,0.998796099119156,0.9981991765078503,165097,64,55515,334
10,8,safari,Mid,125,0.55,165097,332,165097,2,6,55334,58,181,0.9996124993188464,0.9979810313665516,0.9988484859389337,0.998796099119156,0.9981991765078503,165097,64,55515,334
10,8,giraffe,Mid,125,0.5,150165,294,150165,2,6,50377,53,167,0.9996072531686016,0.9980327127960069,0.9988340612216667,0.998819362455726,0.9982343930290852,150165,59,50544,296
10,8,safari,Mid,125,0.5,150165,294,150165,2,6,50377,53,167,0.9996072531686016,0.9980327127960069,0.9988340612216667,0.998819362455726,0.9982343930290852,150165,59,50544,296
10,8,giraffe,Mid,125,0.65,195301,389,195301,3,8,65454,69,218,0.9996058921680026,0.9979968624324835,0.9988288795266849,0.9988007292793379,0.9982061030744869,195301,77,65672,392
10,8,safari,Mid,125,0.65,195301,389,195301,3,8,65454,69,218,0.9996058921680026,0.9979968624324835,0.9988288795266849,0.9988007292793379,0.9982061030744869,195301,77,65672,392
10,8,giraffe,Mid,125,0.6,180199,358,180199,3,7,60353,62,198,0.9996172365589012,0.9980006645990253,0.9988617617947873,0.9988082964736662,0.998217099261962,180199,69,60551,361
10,8,safari,Mid,125,0.6,180199,358,180199,3,7,60353,62,198,0.9996172365589012,0.9980006645990253,0.9988617617947873,0.9988082964736662,0.998217099261962,180199,69,60551,361
10,8,giraffe,Mid,125,0.75,225114,444,225114,4,8,75405,79,250,0.9996136784472538,0.9980138498505954,0.9988513638404056,0.9988131235261102,0.9982243846746144,225114,87,75655,448
10,8,safari,Mid,125,0.75,225114,444,225114,4,8,75405,79,250,0.9996136784472538,0.9980138498505954,0.9988513638404056,0.9988131235261102,0.9982243846746144,225114,87,75655,448
10,8,giraffe,Mid,125,0.7,210280,422,210280,4,8,70481,73,233,0.9996149476376325,0.9979782255844637,0.9988558514019351,0.9987959160893636,0.9981989406787187,210280,81,70714,426
10,8,safari,Mid,125,0.7,210280,422,210280,4,8,70481,73,233,0.9996149476376325,0.9979782255844637,0.9988558514019351,0.9987959160893636,0.9981989406787187,210280,81,70714,426
10,8,giraffe,Mid,125,0.85,255138,496,255138,4,10,85277,87,275,0.9996199580778499,0.9980441092482338,0.9988674707235344,0.9988314121122079,0.9982507391140009,255138,97,85552,500
10,8,safari,Mid,125,0.85,255138,496,255138,4,10,85277,87,275,0.9996199580778499,0.9980441092482338,0.9988674707235344,0.9988314121122079,0.9982507391140009,255138,97,85552,500
10,8,giraffe,Mid,125,0.8,239997,467,239997,4,9,80288,83,265,0.999616808766749,0.9980413194271172,0.9988591977183955,0.9988284428278018,0.9982467231161616,239997,92,80553,471
10,8,safari,Mid,125,0.8,239997,467,239997,4,9,80288,83,265,0.999616808766749,0.9980413194271172,0.9988591977183955,0.9988284428278018,0.9982467231161616,239997,92,80553,471
10,8,giraffe,Mid,125,0.95,285017,555,285017,5,10,95203,95,306,0.999631736589951,0.9980390577672572,0.9989018344593887,0.9988347622827445,0.9982554677313997,285017,105,95509,560
10,8,safari,Mid,125,0.95,285017,555,285017,5,10,95203,95,306,0.999631736589951,0.9980390577672572,0.9989018344593887,0.9988347622827445,0.9982554677313997,285017,105,95509,560
10,8,giraffe,Mid,125,0.9,270000,531,270000,5,10,90225,92,291,0.9996223648843771,0.9980187479669989,0.9988743958154009,0.9988199127697276,0.9982334405821339,270000,102,90516,536
10,8,safari,Mid,125,0.9,270000,531,270000,5,10,90225,92,291,0.9996223648843771,0.9980187479669989,0.9988743958154009,0.9988199127697276,0.9982334405821339,270000,102,90516,536
10,8,giraffe,None,125,0.15,44879,82,44879,0,1,14957,14,46,0.9996658796275671,0.9981761971486399,0.999001198561726,0.9989204830003895,0.998382767301889,44879,15,15003,82
10,8,safari,None,125,0.15,44879,82,44879,0,1,14957,14,46,0.9996658796275671,0.9981761971486399,0.999001198561726,0.9989204830003895,0.998382767301889,44879,15,15003,82
10,8,giraffe,None,125,0.1,29905,50,29905,0,0,10014,7,26,0.999765980208612,0.9983308295776999,0.9993032746093361,0.9990478894883659,0.9985750712464376,29905,7,10040,50
10,8,safari,None,125,0.1,29905,50,29905,0,0,10014,7,26,0.999765980208612,0.9983308295776999,0.9993032746093361,0.9990478894883659,0.9985750712464376,29905,7,10040,50
10,8,giraffe,None,125,0.25,74863,137,74863,0,1,24987,24,84,0.999666168144429,0.9981733333333334,0.9990038253108064,0.9989191929974381,0.99838155370844,74863,25,25071,137
10,8,safari,None,125,0.25,74863,137,74863,0,1,24987,24,84,0.999666168144429,0.9981733333333334,0.9990038253108064,0.9989191929974381,0.99838155370844,74863,25,25071,137
10,8,giraffe,None,125,0.2,59885,108,59885,0,1,19911,19,66,0.9996661380519155,0.9981997899754972,0.9989998499774966,0.9989324258953444,0.9983997999749968,59885,20,19977,108
10,8,safari,None,125,0.2,59885,108,59885,0,1,19911,19,66,0.9996661380519155,0.9981997899754972,0.9989998499774966,0.9989324258953444,0.9983997999749968,59885,20,19977,108
10,8,giraffe,None,125,0.35,104751,195,104751,0,1,35011,36,113,0.9996469061342902,0.9981419015493682,0.9989476977332841,0.9988938369553815,0.9983441227062174,104751,37,35124,195
10,8,safari,None,125,0.35,104751,195,104751,0,1,35011,36,113,0.9996469061342902,0.9981419015493682,0.9989476977332841,0.9988938369553815,0.9983441227062174,104751,37,35124,195
10,8,giraffe,None,125,0.3,89632,168,89632,0,1,29886,30,104,0.999654260954909,0.9981291759465479,0.9989673894940209,0.9988911363345091,0.998339189290692,89632,31,29990,168
10,8,safari,None,125,0.3,89632,168,89632,0,1,29886,30,104,0.999654260954909,0.9981291759465479,0.9989673894940209,0.9988911363345091,0.998339189290692,89632,31,29990,168
10,8,giraffe,None,125,0.45,135088,258,135088,0,4,45253,46,139,0.9996300078438337,0.9980937744743102,0.9988996963161832,0.9988613004835776,0.9982963471026838,135088,50,45392,258
10,8,safari,None,125,0.45,135088,258,135088,0,4,45253,46,139,0.9996300078438337,0.9980937744743102,0.9988996963161832,0.9988613004835776,0.9982963471026838,135088,50,45392,258
10,8,giraffe,None,125,0.4,119726,219,119726,0,3,40041,41,124,0.9996326292059782,0.9981741631581141,0.9989057176254073,0.9989028638174499,0.998357830588059,119726,44,40165,219
10,8,safari,None,125,0.4,119726,219,119726,0,3,40041,41,124,0.9996326292059782,0.9981741631581141,0.9989057176254073,0.9989028638174499,0.998357830588059,119726,44,40165,219
10,8,giraffe,None,125,0.55,165117,318,165117,0,6,55334,60,164,0.9996004431448757,0.9980777949043431,0.9988121805485566,0.998838538736548,0.9982624355766315,165117,66,55498,318
10,8,safari,None,125,0.55,165117,318,165117,0,6,55334,60,164,0.9996004431448757,0.9980777949043431,0.9988121805485566,0.998838538736548,0.9982624355766315,165117,66,55498,318
10,8,giraffe,None,125,0.5,150179,286,150179,0,5,50378,56,153,0.9995939829605964,0.9980992257335592,0.998794275774826,0.9988460451272841,0.9982741212690929,150179,61,50531,286
10,8,safari,None,125,0.5,150179,286,150179,0,5,50378,56,153,0.9995939829605964,0.9980992257335592,0.998794275774826,0.9988460451272841,0.9982741212690929,150179,61,50531,286
10,8,giraffe,None,125,0.65,195306,389,195306,0,6,65458,73,202,0.9995956700872636,0.9980122128822914,0.9987982780389114,0.9988033138999692,0.9982098732376049,195306,79,65660,389
10,8,safari,None,125,0.65,195306,389,195306,0,6,65458,73,202,0.9995956700872636,0.9980122128822914,0.9987982780389114,0.9988033138999692,0.9982098732376049,195306,79,65660,389
10,8,giraffe,None,125,0.6,180211,352,180211,0,6,60354,64,181,0.9996117172636052,0.998050541916118,0.9988449797871463,0.998830519559699,0.9982501824454322,180211,70,60535,352
10,8,safari,None,125,0.6,180211,352,180211,0,6,60354,64,181,0.9996117172636052,0.998050541916118,0.9988449797871463,0.998830519559699,0.9982501824454322,180211,70,60535,352
10,8,giraffe,None,125,0.75,225134,433,225134,0,6,75409,84,236,0.9996003978261642,0.9980803929652831,0.9988116458704694,0.9988398171214597,0.9982642000384996,225134,90,75645,433
10,8,safari,None,125,0.75,225134,433,225134,0,6,75409,84,236,0.9996003978261642,0.9980803929652831,0.9988116458704694,0.9988398171214597,0.9982642000384996,225134,90,75645,433
10,8,giraffe,None,125,0.7,210297,414,210297,0,6,70485,80,217,0.9995912217241888,0.9980352236000968,0.998785104820026,0.9988126166604131,0.9982237947559316,210297,86,70702,414
10,8,safari,None,125,0.7,210297,414,210297,0,6,70485,80,217,0.9995912217241888,0.9980352236000968,0.998785104820026,0.9988126166604131,0.9982237947559316,210297,86,70702,414
10,8,giraffe,None,125,0.85,255159,485,255159,0,7,85284,99,274,0.9995847452647248,0.9981028304986622,0.9987626073963392,0.9988432382283341,0.998268426172255,255159,106,85558,485
10,8,safari,None,125,0.85,255159,485,255159,0,7,85284,99,274,0.9995847452647248,0.9981028304986622,0.9987626073963392,0.9988432382283341,0.998268426172255,255159,106,85558,485
10,8,giraffe,None,125,0.8,240015,457,240015,0,6,80293,90,254,0.9996001849144771,0.9980995708440068,0.998809568096425,0.9988493142703758,0.9982778755274591,240015,96,80547,457
10,8,safari,None,125,0.8,240015,457,240015,0,6,80293,90,254,0.9996001849144771,0.9980995708440068,0.998809568096425,0.9988493142703758,0.9982778755274591,240015,96,80547,457
10,8,giraffe,None,125,0.95,285032,552,285032,0,7,95211,105,300,0.9996072160031423,0.9980671186060843,0.9988287336728612,0.9988365736392818,0.9982581641995032,285032,112,95511,552
10,8,safari,None,125,0.95,285032,552,285032,0,7,95211,105,300,0.9996072160031423,0.9980671186060843,0.9988287336728612,0.9988365736392818,0.9982581641995032,285032,112,95511,552
10,8,giraffe,None,125,0.9,270021,522,270021,0,7,90231,103,287,0.9995927901647719,0.9980705470110112,0.9987862470759589,0.9988310886042235,0.9982501363620002,270021,110,90518,522
10,8,safari,None,125,0.9,270021,522,270021,0,7,90231,103,287,0.9995927901647719,0.9980705470110112,0.9987862470759589,0.9988310886042235,0.9982501363620002,270021,110,90518,522
10,8,giraffe,Single-stranded,125,0.15,44867,94,44867,0,1,14957,14,46,0.9996657902945502,0.9979092991703922,0.999001198561726,0.9987867724808832,0.9981826972773804,44867,15,15003,94
10,8,safari,Single-stranded,125,0.15,44867,94,44867,0,1,14957,14,46,0.9996657902945502,0.9979092991703922,0.999001198561726,0.9987867724808832,0.9981826972773804,44867,15,15003,94
10,8,giraffe,Single-stranded,125,0.1,29888,67,29888,0,1,10013,7,26,0.9997324056729997,0.9977633116341178,0.9992037424106699,0.9987468881054619,0.9981250937453128,29888,8,10039,67
10,8,safari,Single-stranded,125,0.1,29888,67,29888,0,1,10013,7,26,0.9997324056729997,0.9977633116341178,0.9992037424106699,0.9987468881054619,0.9981250937453128,29888,8,10039,67
10,8,giraffe,Single-stranded,125,0.25,74846,154,74846,0,1,24986,24,84,0.999666092345501,0.9979466666666666,0.9990037856146643,0.998805639516651,0.9982116988860582,74846,25,25070,154
10,8,safari,Single-stranded,125,0.25,74846,154,74846,0,1,24986,24,84,0.999666092345501,0.9979466666666666,0.9990037856146643,0.998805639516651,0.9982116988860582,74846,25,25070,154
10,8,giraffe,Single-stranded,125,0.2,59882,111,59882,0,1,19910,19,66,0.9996661213315081,0.9981497841414831,0.998999799959992,0.9989073772884607,0.9983622748127867,59882,20,19976,111
10,8,safari,Single-stranded,125,0.2,59882,111,59882,0,1,19910,19,66,0.9996661213315081,0.9981497841414831,0.998999799959992,0.9989073772884607,0.9983622748127867,59882,20,19976,111
10,8,giraffe,Single-stranded,125,0.35,104737,209,104737,0,3,35007,36,113,0.9996277773535924,0.9980084996093229,0.998890753434398,0.9988174821907096,0.9982298990043182,104737,39,35120,209
10,8,safari,Single-stranded,125,0.35,104737,209,104737,0,3,35007,36,113,0.9996277773535924,0.9980084996093229,0.998890753434398,0.9988174821907096,0.9982298990043182,104737,39,35120,209
10,8,giraffe,Single-stranded,125,0.3,89613,187,89613,0,2,29883,30,104,0.9996430364214401,0.9979175946547885,0.9989340084613079,0.9987795703418875,0.9981722431333929,89613,32,29987,187
10,8,safari,Single-stranded,125,0.3,89613,187,89613,0,2,29883,30,104,0.9996430364214401,0.9979175946547885,0.9989340084613079,0.9987795703418875,0.9981722431333929,89613,32,29987,187
10,8,giraffe,Single-stranded,125,0.45,135092,254,135092,0,5,45250,46,139,0.9996226219634017,0.9981233283584295,0.9988776408450705,0.998872412556518,0.99831292246081,135092,51,45389,254
10,8,safari,Single-stranded,125,0.45,135092,254,135092,0,5,45250,46,139,0.9996226219634017,0.9981233283584295,0.9988776408450705,0.998872412556518,0.99831292246081,135092,51,45389,254
10,8,giraffe,Single-stranded,125,0.4,119711,234,119711,0,5,40037,41,124,0.9996158888415708,0.9980491058401767,0.9988559206108389,0.9988318829212939,0.998251660922124,119711,46,40161,234
10,8,safari,Single-stranded,125,0.4,119711,234,119711,0,5,40037,41,124,0.9996158888415708,0.9980491058401767,0.9988559206108389,0.9988318829212939,0.998251660922124,119711,46,40161,234
10,8,giraffe,Single-stranded,125,0.55,165114,318,165114,1,5,55334,60,164,0.9996064875074919,0.9980717269226816,0.9988301567589943,0.9988385176581611,0.9982624119893573,165114,65,55498,319
10,8,safari,Single-stranded,125,0.55,165114,318,165114,1,5,55334,60,164,0.9996064875074919,0.9980717269226816,0.9988301567589943,0.9988385176581611,0.9982624119893573,165114,65,55498,319
10,8,giraffe,Single-stranded,125,0.5,150182,283,150182,0,5,50376,56,153,0.9995939910678034,0.9981191639251653,0.9987942281083219,0.9988560330952285,0.9982890253910621,150182,61,50529,283
10,8,safari,Single-stranded,125,0.5,150182,283,150182,0,5,50376,56,153,0.9995939910678034,0.9981191639251653,0.9987942281083219,0.9988560330952285,0.9982890253910621,150182,61,50529,283
10,8,giraffe,Single-stranded,125,0.65,195314,379,195314,1,5,65458,73,202,0.9996008024893547,0.998058192892986,0.9988134716602269,0.9988289020829179,0.9982481104072952,195314,78,65660,380
10,8,safari,Single-stranded,125,0.65,195314,379,195314,1,5,65458,73,202,0.9996008024893547,0.998058192892986,0.9988134716602269,0.9988289020829179,0.9982481104072952,195314,78,65660,380
10,8,giraffe,Single-stranded,125,0.6,180213,348,180213,1,5,60354,64,181,0.9996172662828235,0.9980671459110998,0.9988614612896839,0.9988416046823557,0.9982667540200526,180213,69,60535,349
10,8,safari,Single-stranded,125,0.6,180213,348,180213,1,5,60354,64,181,0.9996172662828235,0.9980671459110998,0.9988614612896839,0.9988416046823557,0.9982667540200526,180213,69,60535,349
10,8,giraffe,Single-stranded,125,0.75,225115,450,225115,1,7,75407,84,236,0.9995959255082014,0.9980005851945772,0.9987984260701931,0.998797618308147,0.9982011284434119,225115,91,75643,451
10,8,safari,Single-stranded,125,0.75,225115,450,225115,1,7,75407,84,236,0.9995959255082014,0.9980005851945772,0.9987984260701931,0.998797618308147,0.9982011284434119,225115,91,75643,451
10,8,giraffe,Single-stranded,125,0.7,210296,413,210296,1,5,70485,80,217,0.999595971119065,0.9980352142755445,0.9987992145450436,0.9988149829846754,0.9982273345719492,210296,85,70702,414
10,8,safari,Single-stranded,125,0.7,210296,413,210296,1,5,70485,80,217,0.999595971119065,0.9980352142755445,0.9987992145450436,0.9988149829846754,0.9982273345719492,210296,85,70702,414
10,8,giraffe,Single-stranded,125,0.85,255143,499,255143,1,7,85285,99,274,0.9995847192349432,0.998044147502572,0.9987626218408918,0.9988138393241625,0.9982244775979467,255143,106,85559,500
10,8,safari,Single-stranded,125,0.85,255143,499,255143,1,7,85285,99,274,0.9995847192349432,0.998044147502572,0.9987626218408918,0.9988138393241625,0.9982244775979467,255143,106,85559,500
10,8,giraffe,Single-stranded,125,0.8,240000,470,240000,1,7,80293,90,254,0.9995959966180336,0.9980413438626695,0.9987971826794306,0.9988180652894075,0.99823116329041,240000,97,80547,471
10,8,safari,Single-stranded,125,0.8,240000,470,240000,1,7,80293,90,254,0.9995959966180336,0.9980413438626695,0.9987971826794306,0.9988180652894075,0.99823116329041,240000,97,80547,471
10,8,giraffe,Single-stranded,125,0.95,285027,554,285027,1,8,95211,105,300,0.9996037034439222,0.9980566002058954,0.9988182882958253,0.9988295527419655,0.9982476666159504,285027,113,95511,555
10,8,safari,Single-stranded,125,0.95,285027,554,285027,1,8,95211,105,300,0.9996037034439222,0.9980566002058954,0.9988182882958253,0.9988295527419655,0.9982476666159504,285027,113,95511,555
10,8,giraffe,Single-stranded,125,0.9,270010,530,270010,1,7,90232,103,287,0.9995927735821116,0.9980372660705771,0.9987862604685035,0.9988144142077938,0.998225212503807,270010,110,90519,531
10,8,safari,Single-stranded,125,0.9,270010,530,270010,1,7,90232,103,287,0.9995927735821116,0.9980372660705771,0.9987862604685035,0.9988144142077938,0.998225212503807,270010,110,90519,531
11,7,giraffe,High,125,0.15,44589,93,44589,278,0,14956,10,50,0.9997757797260028,0.9917482206405694,0.9993340436867342,0.9957458211905001,0.9936474589835934,44589,10,15006,371
11,7,safari,High,125,0.15,44626,93,44626,241,0,14956,10,50,0.9997759655883144,0.9925711743772242,0.9993340436867342,0.9961605428813786,0.9942643724156329,44626,10,15006,334
11,7,giraffe,High,125,0.1,29720,58,29720,176,0,10014,7,26,0.999764523833552,0.9921880216331709,0.9993032746093361,0.995961863909787,0.9939751506212344,29720,7,10040,234
11,7,safari,High,125,0.1,29744,58,29744,152,0,10014,7,26,0.9997647137911331,0.9929892501836148,0.9993032746093361,0.9963654635290176,0.9945751356216095,29744,7,10040,210
11,7,giraffe,High,125,0.25,74386,158,74386,455,1,24985,18,90,0.9997446408171494,0.9918265576874359,0.9992428468956722,0.9957698589060535,0.9936858721389108,74386,19,25075,613
11,7,safari,High,125,0.25,74445,158,74445,396,1,24985,18,90,0.9997448431456811,0.9926132348431312,0.9992428468956722,0.9961662752654503,0.9942753239487276,74445,19,25075,554
11,7,giraffe,High,125,0.2,59513,125,59513,354,0,19910,13,72,0.9997816080368243,0.9920156020802774,0.9993498374593648,0.995883465252096,0.9938490004625752,59513,13,19982,479
11,7,safari,High,125,0.2,59563,125,59563,304,0,19910,13,72,0.9997817913253659,0.9928490465395386,0.9993498374593648,0.9963033587581961,0.9944741020415817,59563,13,19982,429
11,7,giraffe,High,125,0.35,104133,217,104133,594,3,35007,27,122,0.9997119898620431,0.9922720689129441,0.9991467334110754,0.9959781355956521,0.9939972734345446,104133,30,35129,811
11,7,safari,High,125,0.35,104201,217,104201,526,3,35007,27,122,0.999712177759016,0.9929200335416984,0.9991467334110754,0.9963045297000119,0.994482630636032,104201,30,35129,743
11,7,giraffe,High,125,0.3,89088,192,89088,519,1,29884,23,111,0.9997306760032318,0.9920823171750243,0.9992005063459809,0.9958918121300535,0.9938656963060643,89088,24,29995,711
11,7,safari,High,125,0.3,89149,192,89149,458,1,29884,23,111,0.9997308602379644,0.9927616120446776,0.9992005063459809,0.9962340477840109,0.9943748017827038,89149,24,29995,650
11,7,giraffe,High,125,0.45,134292,279,134292,773,3,45252,36,149,0.9997096723764433,0.9922272136186311,0.9991417253521127,0.9959543895429684,0.9939651739091955,134292,39,45401,1052
11,7,safari,High,125,0.45,134389,279,134389,676,3,45252,36,149,0.9997098818698485,0.9929439058990425,0.9991417253521127,0.996315407084501,0.9945017258164439,134389,39,45401,955
11,7,giraffe,High,125,0.4,119024,246,119024,673,3,40039,31,134,0.9997144249021486,0.9923380272296007,0.9991543761036635,0.996012568985067,0.9940493287542929,119024,34,40173,919
11,7,safari,High,125,0.4,119105,246,119105,592,3,40039,31,134,0.9997146190584107,0.9930133480069699,0.9991543761036635,0.9963527158046194,0.9945551045894474,119105,34,40173,838
11,7,giraffe,High,125,0.55,164156,336,164156,941,3,55335,46,178,0.9997015925215432,0.9922808629475377,0.9991181023001332,0.9959774055175679,0.9939998642503224,164156,49,55513,1277
11,7,safari,High,125,0.55,164269,336,164269,828,3,55335,46,178,0.9997017977336627,0.9929639189279044,0.9991181023001332,0.9963214668037398,0.9945111880359284,164269,49,55513,1164
11,7,giraffe,High,125,0.5,149291,305,149291,867,3,50378,43,166,0.9996919718489055,0.9922107096096715,0.9990907293931607,0.9959372915276851,0.9939418959179918,149291,46,50544,1172
11,7,safari,High,125,0.5,149398,305,149398,760,3,50378,43,166,0.9996921923931372,0.9929218478961606,0.9990907293931607,0.9962955182773326,0.9944740938956395,149398,46,50544,1065
11,7,giraffe,High,125,0.65,194196,402,194196,1095,3,65459,54,221,0.9997065682383284,0.9923502629118057,0.999132908407746,0.9960148328230063,0.9940557701870482,194196,57,65680,1497
11,7,safari,High,125,0.65,194324,402,194324,967,3,65459,55,220,0.9997016184626148,0.9930043486481377,0.9991176962745486,0.9963417291546498,0.9945415598821864,194324,58,65679,1369
11,7,giraffe,High,125,0.6,179163,376,179163,1022,3,60355,47,198,0.9997210023826396,0.992257464236463,0.9991749583353959,0.995975251129876,0.9939957870992354,179163,50,60553,1398
11,7,safari,High,125,0.6,179282,376,179282,903,3,60355,48,197,0.999715612854299,0.992916521286435,0.9991584575021039,0.99630446742652,0.9944850806919773,179282,51,60552,1279
11,7,giraffe,High,125,0.75,223858,453,223858,1256,3,75410,62,258,0.9997097216453871,0.9924235371308746,0.9991417215744788,0.9960533048566154,0.9941121805509459,223858,65,75668,1709
11,7,safari,High,125,0.75,224004,453,224004,1110,3,75410,63,257,0.9997054491899853,0.9930707949301094,0.9991285172910092,0.9963770775091907,0.9945934284766014,224004,66,75667,1563
11,7,giraffe,High,125,0.7,209104,423,209104,1184,3,70486,58,239,0.9997083642100734,0.9923734403994097,0.9991382476760942,0.9960273985652908,0.9940745372064356,209104,61,70725,1607
11,7,safari,High,125,0.7,209246,423,209246,1042,3,70486,59,238,0.9997037858084736,0.9930473492129029,0.9991241205888169,0.9963644501796348,0.9945754306440211,209246,62,70724,1465
11,7,giraffe,High,125,0.85,253705,517,253705,1424,4,85283,78,295,0.9996768944035747,0.9924074697042004,0.9990427270604716,0.9960289184249941,0.9940727675458386,253705,82,85578,1941
11,7,safari,High,125,0.85,253866,517,253866,1263,4,85283,79,294,0.9996731627216489,0.9930372468178653,0.9990310530002334,0.9963441556530186,0.9945415550854658,253866,83,85577,1780
11,7,giraffe,High,125,0.8,238659,480,238659,1335,4,80293,67,277,0.9997025928873623,0.992452406497168,0.9991195545690158,0.9960643066418476,0.9941267147283683,238659,71,80570,1815
11,7,safari,High,125,0.8,238806,480,238806,1188,4,80293,68,276,0.999698590912516,0.9930636991940917,0.9991071539291427,0.9963700996345066,0.9945813805023123,238806,72,80569,1668
11,7,giraffe,High,125,0.95,283412,590,283412,1584,5,95210,83,322,0.999689594356261,0.992387582024329,0.9990796904413303,0.9960252053292472,0.9940662004270657,283412,88,95532,2174
11,7,safari,High,125,0.95,283587,590,283587,1409,5,95210,84,321,0.9996862617916215,0.993000357160365,0.9990692323781636,0.9963320931311066,0.9945226465480607,283587,89,95531,1999
11,7,giraffe,High,125,0.9,268490,558,268490,1497,4,90231,81,309,0.999683514846877,0.9924042211092424,0.9990620689655172,0.9960305683335806,0.9940748124152061,268490,85,90540,2055
11,7,safari,High,125,0.9,268653,558,268653,1334,4,90231,82,308,0.9996799869017895,0.9930067086806261,0.9990510344827587,0.9963321737711484,0.9945233546529335,268653,86,90539,1892
11,7,giraffe,Mid,125,0.15,44871,86,44871,2,3,14953,17,50,0.9995544763983872,0.9980426610912164,0.9986687079810956,0.9987979966611019,0.9981994598379513,44871,20,15003,88
11,7,safari,Mid,125,0.15,44871,86,44871,2,3,14953,17,50,0.9995544763983872,0.9980426610912164,0.9986687079810956,0.9987979966611019,0.9981994598379513,44871,20,15003,88
11,7,giraffe,Mid,125,0.1,29892,61,29892,0,0,10014,13,33,0.9995652900852701,0.9979634761125764,0.9987077534791252,0.9987637408533531,0.9981506010546572,29892,13,10047,61
11,7,safari,Mid,125,0.1,29892,61,29892,0,0,10014,13,33,0.9995652900852701,0.9979634761125764,0.9987077534791252,0.9987637408533531,0.9981506010546572,29892,13,10047,61
11,7,giraffe,Mid,125,0.25,74844,150,74844,3,4,24982,30,83,0.9995459280429498,0.9979599183967359,0.9986453643571457,0.9987522935779817,0.9981317934782609,74844,34,25065,153
11,7,safari,Mid,125,0.25,74844,150,74844,3,4,24982,30,83,0.9995459280429498,0.9979599183967359,0.9986453643571457,0.9987522935779817,0.9981317934782609,74844,34,25065,153
11,7,giraffe,Mid,125,0.2,59873,114,59873,3,3,19907,24,67,0.9995492487479132,0.9980496749458243,0.9986500674966252,0.9987988989907416,0.9981997974772162,59873,27,19974,117
11,7,safari,Mid,125,0.2,59873,114,59873,3,3,19907,24,67,0.9995492487479132,0.9980496749458243,0.9986500674966252,0.9987988989907416,0.9981997974772162,59873,27,19974,117
11,7,giraffe,Mid,125,0.35,104740,200,104740,3,6,35004,37,117,0.9995896280885258,0.9980656165728062,0.9987771584575134,0.9988270409963477,0.9982441990764201,104740,43,35121,203
11,7,safari,Mid,125,0.35,104740,200,104740,3,6,35004,37,117,0.9995896280885258,0.9980656165728062,0.9987771584575134,0.9988270409963477,0.9982441990764201,104740,43,35121,203
11,7,giraffe,Mid,125,0.3,89614,180,89614,3,4,29881,36,101,0.9995538403194504,0.9979620700023386,0.9986676437279328,0.998757320939978,0.9981388594463315,89614,40,29982,183
11,7,safari,Mid,125,0.3,89614,180,89614,3,4,29881,36,101,0.9995538403194504,0.9979620700023386,0.9986676437279328,0.998757320939978,0.9981388594463315,89614,40,29982,183
11,7,giraffe,Mid,125,0.45,135070,269,135070,3,7,45250,47,149,0.9996003670702466,0.9979902764847571,0.9988119596066266,0.9987946728978874,0.9981968527890704,135070,54,45399,272
11,7,safari,Mid,125,0.45,135070,269,135070,3,7,45250,47,149,0.9996003670702466,0.9979902764847571,0.9988119596066266,0.9987946728978874,0.9981968527890704,135070,54,45399,272
11,7,giraffe,Mid,125,0.4,119702,236,119702,3,7,40035,41,133,0.9995991649269311,0.9980073536155276,0.9988064451959419,0.9988026250464139,0.9982080083917656,119702,48,40168,239
11,7,safari,Mid,125,0.4,119702,236,119702,3,7,40035,41,133,0.9995991649269311,0.9980073536155276,0.9988064451959419,0.9988026250464139,0.9982080083917656,119702,48,40168,239
11,7,giraffe,Mid,125,0.55,165094,332,165094,5,7,55333,60,179,0.9995943352244174,0.9979628969177482,0.9987945087173213,0.9987779498596457,0.9981720284150039,165094,67,55512,337
11,7,safari,Mid,125,0.55,165094,332,165094,5,7,55333,60,179,0.9995943352244174,0.9979628969177482,0.9987945087173213,0.9987779498596457,0.9981720284150039,165094,67,55512,337
11,7,giraffe,Mid,125,0.5,150163,294,150163,4,7,50376,54,166,0.9995939397166897,0.9980194203148989,0.9987945378732486,0.9988060594974807,0.9982144988660328,150163,61,50542,298
11,7,safari,Mid,125,0.5,150163,294,150163,4,7,50376,54,166,0.9995939397166897,0.9980194203148989,0.9987945378732486,0.9988060594974807,0.9982144988660328,150163,61,50542,298
11,7,giraffe,Mid,125,0.65,195298,389,195298,6,7,65455,71,216,0.9996007697977234,0.9979815322980382,0.9988136701698885,0.9987904947720222,0.9981908033139282,195298,78,65671,395
11,7,safari,Mid,125,0.65,195298,389,195298,6,7,65455,71,216,0.9996007697977234,0.9979815322980382,0.9988136701698885,0.9987904947720222,0.9981908033139282,195298,78,65671,395
11,7,giraffe,Mid,125,0.6,180196,358,180196,6,7,60353,64,196,0.9996061397815462,0.9979840496233939,0.9988287693830419,0.998794436114814,0.9981963678580313,180196,71,60549,364
11,7,safari,Mid,125,0.6,180196,358,180196,6,7,60353,64,196,0.9996061397815462,0.9979840496233939,0.9988287693830419,0.998794436114814,0.9981963678580313,180196,71,60549,364
11,7,giraffe,Mid,125,0.75,225111,444,225111,7,7,75406,79,250,0.9996181121418136,0.9980005497379878,0.9988645665548836,0.998808676033091,0.9982177468603138,225111,86,75656,451
11,7,safari,Mid,125,0.75,225111,444,225111,7,7,75406,79,250,0.9996181121418136,0.9980005497379878,0.9988645665548836,0.998808676033091,0.9982177468603138,225111,86,75656,451
11,7,giraffe,Mid,125,0.7,210277,422,210277,7,7,70482,74,232,0.9996149421462459,0.9979639877364669,0.9988558514019351,0.998788782702867,0.9981882835229715,210277,81,70714,429
11,7,safari,Mid,125,0.7,210277,422,210277,7,7,70482,74,232,0.9996149421462459,0.9979639877364669,0.9988558514019351,0.998788782702867,0.9981882835229715,210277,81,70714,429
11,7,giraffe,Mid,125,0.85,255134,496,255134,8,8,85279,86,276,0.9996317018508941,0.9980284621222197,0.998902497402188,0.9988294386394866,0.9982478090287646,255134,94,85555,504
11,7,safari,Mid,125,0.85,255134,496,255134,8,8,85279,86,276,0.9996317018508941,0.9980284621222197,0.998902497402188,0.9988294386394866,0.9982478090287646,255134,94,85555,504
11,7,giraffe,Mid,125,0.8,239993,467,239993,8,8,80289,81,267,0.9996292933247807,0.9980246851971988,0.9988963977927956,0.9988263448132347,0.998243608947629,239993,89,80556,475
11,7,safari,Mid,125,0.8,239993,467,239993,8,8,80289,81,267,0.9996292933247807,0.9980246851971988,0.9988963977927956,0.9988263448132347,0.998243608947629,239993,89,80556,475
11,7,giraffe,Mid,125,0.95,285014,555,285014,8,8,95205,93,308,0.9996457569752556,0.9980285527195818,0.9989436693371264,0.9988365002488209,0.9982580910881946,285014,101,95513,563
11,7,safari,Mid,125,0.95,285014,555,285014,8,8,95205,93,308,0.9996457569752556,0.9980285527195818,0.9989436693371264,0.9988365002488209,0.9982580910881946,285014,101,95513,563
11,7,giraffe,Mid,125,0.9,269997,531,269997,8,8,90227,90,293,0.9996371647013088,0.9980076588697993,0.9989185371559735,0.9988217471806095,0.9982362094840428,269997,98,90520,539
11,7,safari,Mid,125,0.9,269997,531,269997,8,8,90227,90,293,0.9996371647013088,0.9980076588697993,0.9989185371559735,0.9988217471806095,0.9982362094840428,269997,98,90520,539
11,7,giraffe,None,125,0.15,44879,82,44879,0,0,14958,16,44,0.9996436128744849,0.9981761971486399,0.9989346117991743,0.9989093660968661,0.9983660947998466,44879,16,15002,82
11,7,safari,None,125,0.15,44879,82,44879,0,0,14958,16,44,0.9996436128744849,0.9981761971486399,0.9989346117991743,0.9989093660968661,0.9983660947998466,44879,16,15002,82
11,7,giraffe,None,125,0.1,29905,50,29905,0,0,10014,10,23,0.999665719538693,0.9983308295776999,0.9990046780133374,0.9989978286286956,0.9985000749962502,29905,10,10037,50
11,7,safari,None,125,0.1,29905,50,29905,0,0,10014,10,23,0.999665719538693,0.9983308295776999,0.9990046780133374,0.9989978286286956,0.9985000749962502,29905,10,10037,50
11,7,giraffe,None,125,0.25,74863,137,74863,0,0,24988,26,82,0.9996528195062026,0.9981733333333334,0.9989639783232388,0.9989125286045006,0.9983715632992327,74863,26,25070,137
11,7,safari,None,125,0.25,74863,137,74863,0,0,24988,26,82,0.9996528195062026,0.9981733333333334,0.9989639783232388,0.9989125286045006,0.9983715632992327,74863,26,25070,137
11,7,giraffe,None,125,0.2,59885,108,59885,0,0,19912,21,64,0.9996494508062631,0.9981997899754972,0.9989498424763714,0.9989240944461588,0.9983872984123016,59885,21,19976,108
11,7,safari,None,125,0.2,59885,108,59885,0,0,19912,21,64,0.9996494508062631,0.9981997899754972,0.9989498424763714,0.9989240944461588,0.9983872984123016,59885,21,19976,108
11,7,giraffe,None,125,0.35,104751,195,104751,0,1,35011,38,111,0.9996278270827369,0.9981419015493682,0.9988908165296778,0.9988843117061448,0.9983298479019607,104751,39,35122,195
11,7,safari,None,125,0.35,104751,195,104751,0,1,35011,38,111,0.9996278270827369,0.9981419015493682,0.9988908165296778,0.9988843117061448,0.9983298479019607,104751,39,35122,195
11,7,giraffe,None,125,0.3,89632,168,89632,0,0,29887,32,102,0.9996431120628123,0.9981291759465479,0.998934079477699,0.9988855703650872,0.9983308435082331,89632,32,29989,168
11,7,safari,None,125,0.3,89632,168,89632,0,0,29887,32,102,0.9996431120628123,0.9981291759465479,0.998934079477699,0.9988855703650872,0.9983308435082331,89632,32,29989,168
11,7,giraffe,None,125,0.45,135088,258,135088,0,3,45254,47,138,0.9996300078438337,0.9980937744743102,0.9988996963161832,0.9988613004835776,0.9982963471026838,135088,50,45392,258
11,7,safari,None,125,0.45,135088,258,135088,0,3,45254,47,138,0.9996300078438337,0.9980937744743102,0.9988996963161832,0.9988613004835776,0.9982963471026838,135088,50,45392,258
11,7,giraffe,None,125,0.4,119726,219,119726,0,2,40042,42,123,0.9996326292059782,0.9981741631581141,0.9989057176254073,0.9989028638174499,0.998357830588059,119726,44,40165,219
11,7,safari,None,125,0.4,119726,219,119726,0,2,40042,42,123,0.9996326292059782,0.9981741631581141,0.9989057176254073,0.9989028638174499,0.998357830588059,119726,44,40165,219
11,7,giraffe,None,125,0.55,165117,318,165117,0,3,55337,60,164,0.9996185978932074,0.9980777949043431,0.9988661723418041,0.9988476021959076,0.9982760102986892,165117,63,55501,318
11,7,safari,None,125,0.55,165117,318,165117,0,3,55337,60,164,0.9996185978932074,0.9980777949043431,0.9988661723418041,0.9988476021959076,0.9982760102986892,165117,63,55501,318
11,7,giraffe,None,125,0.5,150179,286,150179,0,3,50380,56,153,0.9996072897669032,0.9980992257335592,0.998833807716635,0.9988526885332039,0.9982840686969366,150179,59,50533,286
11,7,safari,None,125,0.5,150179,286,150179,0,3,50380,56,153,0.9996072897669032,0.9980992257335592,0.998833807716635,0.9988526885332039,0.9982840686969366,150179,59,50533,286
11,7,giraffe,None,125,0.65,195306,389,195306,0,3,65461,72,203,0.9996161346292628,0.9980122128822914,0.9988591247204855,0.9988135298509753,0.9982251734663433,195306,75,65664,389
11,7,safari,None,125,0.65,195306,389,195306,0,3,65461,72,203,0.9996161346292628,0.9980122128822914,0.9988591247204855,0.9988135298509753,0.9982251734663433,195306,75,65664,389
11,7,giraffe,None,125,0.6,180211,352,180211,0,3,60357,64,181,0.9996283517678253,0.998050541916118,0.9988944806534115,0.9988388237478557,0.9982626219067207,180211,67,60538,352
11,7,safari,None,125,0.6,180211,352,180211,0,3,60357,64,181,0.9996283517678253,0.998050541916118,0.9988944806534115,0.9988388237478557,0.9982626219067207,180211,67,60538,352
11,7,giraffe,None,125,0.75,225134,433,225134,0,3,75412,81,239,0.9996270280350593,0.9980803929652831,0.9988908694791048,0.9988531117938707,0.9982841136135837,225134,84,75651,433
11,7,safari,None,125,0.75,225134,433,225134,0,3,75412,81,239,0.9996270280350593,0.9980803929652831,0.9988908694791048,0.9988531117938707,0.9982841136135837,225134,84,75651,433
11,7,giraffe,None,125,0.7,210297,414,210297,0,3,70488,77,220,0.9996197302937108,0.9980352236000968,0.9988698649488614,0.9988268485447221,0.9982451092188604,210297,80,70708,414
11,7,safari,None,125,0.7,210297,414,210297,0,3,70488,77,220,0.9996197302937108,0.9980352236000968,0.9988698649488614,0.9988268485447221,0.9982451092188604,210297,80,70708,414
11,7,giraffe,None,125,0.85,255159,485,255159,0,4,85287,98,275,0.9996004089931482,0.9981028304986622,0.9988093014568546,0.9988510584159481,0.9982801457920705,255159,102,85562,485
11,7,safari,None,125,0.85,255159,485,255159,0,4,85287,98,275,0.9996004089931482,0.9981028304986622,0.9988093014568546,0.9988510584159481,0.9982801457920705,255159,102,85562,485
11,7,giraffe,None,125,0.8,240015,457,240015,0,3,80296,87,257,0.9996251639907541,0.9980995708440068,0.9988839700903984,0.9988617848960728,0.9982965604222787,240015,90,80553,457
11,7,safari,None,125,0.8,240015,457,240015,0,3,80296,87,257,0.9996251639907541,0.9980995708440068,0.9988839700903984,0.9988617848960728,0.9982965604222787,240015,90,80553,457
11,7,giraffe,None,125,0.95,285032,552,285032,0,5,95213,102,303,0.9996247444228955,0.9980671186060843,0.9988810223481799,0.9988453242641351,0.9982712804329407,285032,107,95516,552
11,7,safari,None,125,0.95,285032,552,285032,0,5,95213,102,303,0.9996247444228955,0.9980671186060843,0.9988810223481799,0.9988453242641351,0.9982712804329407,285032,107,95516,552
11,7,giraffe,None,125,0.9,270021,522,270021,0,4,90234,101,289,0.9996112925079408,0.9980705470110112,0.9988414176634153,0.998840325596622,0.9982639802198958,270021,105,90523,522
11,7,safari,None,125,0.9,270021,522,270021,0,4,90234,101,289,0.9996112925079408,0.9980705470110112,0.9988414176634153,0.998840325596622,0.9982639802198958,270021,105,90523,522
11,7,giraffe,Single-stranded,125,0.15,44867,94,44867,0,0,14958,16,44,0.9996435175901789,0.9979092991703922,0.9989346117991743,0.9987756555807845,0.998166024775338,44867,16,15002,94
11,7,safari,Single-stranded,125,0.15,44867,94,44867,0,0,14958,16,44,0.9996435175901789,0.9979092991703922,0.9989346117991743,0.9987756555807845,0.998166024775338,44867,16,15002,94
11,7,giraffe,Single-stranded,125,0.1,29888,67,29888,0,0,10014,10,23,0.9996655294668539,0.9977633116341178,0.9990046780133374,0.9987135147778724,0.9980750962451878,29888,10,10037,67
11,7,safari,Single-stranded,125,0.1,29888,67,29888,0,0,10014,10,23,0.9996655294668539,0.9977633116341178,0.9990046780133374,0.9987135147778724,0.9980750962451878,29888,10,10037,67
11,7,giraffe,Single-stranded,125,0.25,74846,154,74846,0,0,24987,26,82,0.9996527406774228,0.9979466666666666,0.9989639370392508,0.9987989751254405,0.9982017083770418,74846,26,25069,154
11,7,safari,Single-stranded,125,0.25,74846,154,74846,0,0,24987,26,82,0.9996527406774228,0.9979466666666666,0.9989639370392508,0.9987989751254405,0.9982017083770418,74846,26,25069,154
11,7,giraffe,Single-stranded,125,0.2,59882,111,59882,0,0,19911,21,64,0.9996494332504215,0.9981497841414831,0.9989497899579916,0.9988990458397278,0.9983497730938004,59882,21,19975,111
11,7,safari,Single-stranded,125,0.2,59882,111,59882,0,0,19911,21,64,0.9996494332504215,0.9981497841414831,0.9989497899579916,0.9988990458397278,0.9983497730938004,59882,21,19975,111
11,7,giraffe,Single-stranded,125,0.35,104737,209,104737,0,2,35008,37,112,0.9996277773535924,0.9980084996093229,0.998890753434398,0.9988174821907096,0.9982298990043182,104737,39,35120,209
11,7,safari,Single-stranded,125,0.35,104737,209,104737,0,2,35008,37,112,0.9996277773535924,0.9980084996093229,0.998890753434398,0.9988174821907096,0.9982298990043182,104737,39,35120,209
11,7,giraffe,Single-stranded,125,0.3,89613,187,89613,0,0,29885,32,102,0.9996430364214401,0.9979175946547885,0.9989340084613079,0.9987795703418875,0.9981722431333929,89613,32,29987,187
11,7,safari,Single-stranded,125,0.3,89613,187,89613,0,0,29885,32,102,0.9996430364214401,0.9979175946547885,0.9989340084613079,0.9987795703418875,0.9981722431333929,89613,32,29987,187
11,7,giraffe,Single-stranded,125,0.45,135092,254,135092,0,3,45252,46,139,0.999637415736157,0.9981233283584295,0.9989216549295775,0.9988797982897515,0.9983239852643457,135092,49,45391,254
11,7,safari,Single-stranded,125,0.45,135092,254,135092,0,3,45252,46,139,0.999637415736157,0.9981233283584295,0.9989216549295775,0.9988797982897515,0.9983239852643457,135092,49,45391,254
11,7,giraffe,Single-stranded,125,0.4,119711,234,119711,0,3,40039,41,124,0.9996325831906809,0.9980491058401767,0.9989056631929764,0.9988402169378389,0.9982641490583946,119711,44,40163,234
11,7,safari,Single-stranded,125,0.4,119711,234,119711,0,3,40039,41,124,0.9996325831906809,0.9980491058401767,0.9989056631929764,0.9988402169378389,0.9982641490583946,119711,44,40163,234
11,7,giraffe,Single-stranded,125,0.55,165115,318,165115,0,3,55336,59,165,0.9996246450777045,0.9980777716658707,0.9988841495239638,0.9988506094794471,0.9982805118644681,165115,62,55501,318
11,7,safari,Single-stranded,125,0.55,165115,318,165115,0,3,55336,59,165,0.9996246450777045,0.9980777716658707,0.9988841495239638,0.9988506094794471,0.9982805118644681,165115,62,55501,318
11,7,giraffe,Single-stranded,125,0.5,150182,283,150182,0,3,50378,55,154,0.9996139510117146,0.9981191639251653,0.9988535283652896,0.9988659982374752,0.9983039466812563,150182,58,50532,283
11,7,safari,Single-stranded,125,0.5,150182,283,150182,0,3,50378,55,154,0.9996139510117146,0.9981191639251653,0.9988535283652896,0.9988659982374752,0.9983039466812563,150182,58,50532,283
11,7,giraffe,Single-stranded,125,0.65,195315,379,195315,0,4,65459,71,204,0.9996161523107631,0.9980633029116887,0.9988591073656028,0.9988391240756461,0.998263410753083,195315,75,65663,379
11,7,safari,Single-stranded,125,0.65,195315,379,195315,0,4,65459,71,204,0.9996161523107631,0.9980633029116887,0.9988591073656028,0.9988391240756461,0.998263410753083,195315,75,65663,379
11,7,giraffe,Single-stranded,125,0.6,180214,348,180214,0,3,60356,63,182,0.9996339028178389,0.9980726841749649,0.9989109629727411,0.9988526834459405,0.9982833401059851,180214,66,60538,348
11,7,safari,Single-stranded,125,0.6,180214,348,180214,0,3,60356,63,182,0.9996339028178389,0.9980726841749649,0.9989109629727411,0.9988526834459405,0.9982833401059851,180214,66,60538,348
11,7,giraffe,Single-stranded,125,0.75,225116,450,225116,0,4,75410,80,240,0.9996269982238011,0.9980050184868287,0.9988908548340244,0.9988153498711083,0.9982276800531033,225116,84,75650,450
11,7,safari,Single-stranded,125,0.75,225116,450,225116,0,4,75410,80,240,0.9996269982238011,0.9980050184868287,0.9988908548340244,0.9988153498711083,0.9982276800531033,225116,84,75650,450
11,7,giraffe,Single-stranded,125,0.7,210297,413,210297,0,4,70486,76,221,0.9996197302937108,0.9980399601347824,0.9988698489835705,0.9988292205648714,0.9982486491863146,210297,80,70707,413
11,7,safari,Single-stranded,125,0.7,210297,413,210297,0,4,70486,76,221,0.9996197302937108,0.9980399601347824,0.9988698489835705,0.9988292205648714,0.9982486491863146,210297,80,70707,413
11,7,giraffe,Single-stranded,125,0.85,255144,499,255144,0,4,85288,97,276,0.9996043017492997,0.9980480592075668,0.9988209887351894,0.9988255742941702,0.99824205702767,255144,101,85564,499
11,7,safari,Single-stranded,125,0.85,255144,499,255144,0,4,85288,97,276,0.9996043017492997,0.9980480592075668,0.9988209887351894,0.9988255742941702,0.99824205702767,255144,101,85564,499
11,7,giraffe,Single-stranded,125,0.8,240001,470,240001,0,4,80296,86,258,0.9996251421336076,0.9980455023682689,0.9988839839293686,0.9988346977081001,0.9982560764835028,240001,90,80554,470
11,7,safari,Single-stranded,125,0.8,240001,470,240001,0,4,80296,86,258,0.9996251421336076,0.9980455023682689,0.9988839839293686,0.9988346977081001,0.9982560764835028,240001,90,80554,470
11,7,giraffe,Single-stranded,125,0.95,285028,554,285028,0,5,95214,101,304,0.9996282449655249,0.998060101827146,0.99889149167573,0.9988435579167221,0.9982686526445019,285028,106,95518,554
11,7,safari,Single-stranded,125,0.95,285028,554,285028,0,5,95214,101,304,0.9996282449655249,0.998060101827146,0.99889149167573,0.9988435579167221,0.9982686526445019,285028,106,95518,554
11,7,giraffe,Single-stranded,125,0.9,270011,530,270011,0,4,90235,100,290,0.9996149788053237,0.998040962367996,0.9988524644429487,0.998827350477938,0.9982445939585237,270011,104,90525,530
11,7,safari,Single-stranded,125,0.9,270011,530,270011,0,4,90235,100,290,0.9996149788053237,0.998040962367996,0.9988524644429487,0.998827350477938,0.9982445939585237,270011,104,90525,530
12,4,giraffe,High,125,0.15,44682,93,44682,185,0,14956,10,50,0.999776246308064,0.9938167259786477,0.9993340436867342,0.9967875786373979,0.9951980792316927,44682,10,15006,278
12,4,safari,High,125,0.15,44715,93,44715,152,0,14956,10,50,0.9997764114030184,0.9945507117437722,0.9993340436867342,0.9971567151697608,0.9957482993197279,44715,10,15006,245
12,4,giraffe,High,125,0.1,29779,58,29779,117,0,10014,6,27,0.9997985563202955,0.9941577084863458,0.9994028068080024,0.9969701535010629,0.995475113122172,29779,6,10041,175
12,4,safari,High,125,0.1,29797,58,29797,99,0,10014,6,27,0.9997986779854378,0.9947586298991787,0.9994028068080024,0.997272286092006,0.9959251018724532,29797,6,10041,157
12,4,giraffe,High,125,0.25,74545,158,74545,296,1,24985,19,89,0.9997317776436666,0.9939465859544794,0.9992029967322866,0.9968307881575781,0.9952644041041832,74545,20,25074,454
12,4,safari,High,125,0.25,74596,158,74596,245,1,24985,20,88,0.9997185627940014,0.9946265950212669,0.9991631465689009,0.9971660784942786,0.9957639395362313,74596,21,25073,403
12,4,giraffe,High,125,0.2,59634,125,59634,233,0,19910,14,71,0.9997652896995708,0.9940325376716895,0.999299824956239,0.9968906720160482,0.995349244252191,59634,14,19981,358
12,4,safari,High,125,0.2,59678,125,59678,189,0,19910,15,70,0.9997487142546028,0.9947659687958395,0.9992498124531133,0.997251117516815,0.9958868316101367,59678,15,19980,314
12,4,giraffe,High,125,0.35,104317,216,104317,411,2,35008,30,119,0.9996933367832945,0.9940253849672206,0.9990898489718137,0.9968513041525516,0.995296317709114,104317,32,35127,627
12,4,safari,High,125,0.35,104394,216,104394,334,2,35008,31,118,0.99968398977276,0.994759109620369,0.9990614067521829,0.9972154691910533,0.9958387757578353,104394,33,35126,550
12,4,giraffe,High,125,0.3,89255,192,89255,352,1,29884,25,109,0.9997087846238282,0.9939420260804686,0.9991338818748127,0.9968170649988832,0.9952427848904172,89255,26,29993,544
12,4,safari,High,125,0.3,89317,192,89317,290,1,29884,26,108,0.999697797277937,0.9946324569315916,0.9991005696392284,0.9971586944508019,0.9957518903670567,89317,27,29992,482
12,4,giraffe,High,125,0.45,134519,279,134519,546,2,45253,40,145,0.9996878739010561,0.9939044213263979,0.9990757042253521,0.9967877586558233,0.9952042216125321,134519,42,45398,825
12,4,safari,High,125,0.45,134626,279,134626,439,2,45253,41,144,0.9996806986017569,0.9946949994089136,0.9990536971830986,0.9971816171813951,0.9957905566864325,134626,43,45397,718
12,4,giraffe,High,125,0.4,119216,246,119216,481,2,40040,35,130,0.9996897352687144,0.9939387875907723,0.9990797622304574,0.9968059666549608,0.9952294723696534,119216,37,40170,727
12,4,safari,High,125,0.4,119310,246,119310,387,2,40040,36,129,0.9996816033783558,0.9947224931842625,0.9990548909393887,0.997195882837215,0.9958101779581642,119310,38,40169,633
12,4,giraffe,High,125,0.55,164411,336,164411,686,2,55336,52,172,0.9996716626637886,0.9938222724607545,0.9990281127389223,0.996738385804097,0.99513111156361,164411,54,55508,1022
12,4,safari,High,125,0.55,164556,336,164556,541,2,55336,53,171,0.9996658789509814,0.9946987602231719,0.9990101148266801,0.9971761340912122,0.9957827100160637,164556,55,55507,877
12,4,giraffe,High,125,0.5,149536,305,149536,622,2,50379,48,161,0.9996657441204391,0.993839016901165,0.9990116623838703,0.9967438651686891,0.9951405848209178,149536,50,50540,927
12,4,safari,High,125,0.5,149666,305,149666,492,2,50379,49,160,0.9996593573208119,0.9947030166884882,0.9989918956315478,0.9971750283163434,0.9957822066818203,149666,51,50539,797
12,4,giraffe,High,125,0.65,194470,402,194470,821,2,65460,60,215,0.9996812863693377,0.9937504151911413,0.9990568477417588,0.9967070279966685,0.995084726312971,194470,62,65675,1223
12,4,safari,High,125,0.65,194647,402,194647,644,2,65460,61,214,0.9996764418879359,0.9946548931234127,0.9990416356085614,0.9971593455992909,0.995757946677887,194647,63,65674,1046
12,4,giraffe,High,125,0.6,179430,376,179430,755,2,60356,53,192,0.9996935677076079,0.9937361888779969,0.9990924541689356,0.9967059764585635,0.9950821847373571,179430,55,60548,1131
12,4,safari,High,125,0.6,179590,376,179590,595,2,60356,54,191,0.9996882758313572,0.9946223160040097,0.9990759533356435,0.9971488616267868,0.9957414871207975,179590,56,60547,971
12,4,giraffe,High,125,0.75,224167,453,224167,947,2,75411,69,251,0.9996833721313961,0.9937934183635018,0.9990624958736614,0.9967296939785019,0.9951178227680053,224167,71,75662,1400
12,4,safari,High,125,0.75,224373,453,224373,741,2,75411,70,250,0.99967920871483,0.9947066725185865,0.9990492915901918,0.9971867416868885,0.9957982077663459,224373,72,75661,1194
12,4,giraffe,High,125,0.7,209401,423,209401,887,2,70487,65,232,0.9996801420742071,0.993782953903688,0.9990534851524313,0.9967228252720864,0.9951082960031545,209401,67,70719,1310
12,4,safari,High,125,0.7,209593,423,209593,695,2,70487,66,231,0.9996756669099165,0.9946941545529184,0.9990393580651541,0.9971786893513365,0.9957868112271179,209593,68,70718,1118
12,4,giraffe,High,125,0.85,254048,517,254048,1081,3,85284,85,288,0.9996537287121856,0.9937491687724431,0.9989726826990427,0.9966927039401156,0.9950601513011784,254048,88,85572,1598
12,4,safari,High,125,0.85,254254,517,254254,875,3,85284,87,286,0.9996461485232598,0.994554970545207,0.9989493345785664,0.9970940606678562,0.995657855414203,254254,90,85570,1392
12,4,giraffe,High,125,0.8,238978,480,238978,1016,3,80294,74,270,0.9996778983915835,0.9937789532340294,0.9990451507297776,0.9967196978702019,0.9951014434081248,238978,77,80564,1496
12,4,safari,High,125,0.8,239191,480,239191,803,3,80294,75,269,0.9996740070798975,0.9946647038765105,0.9990327500899047,0.9971630643907259,0.9957616430250845,239191,78,80563,1283
12,4,giraffe,High,125,0.95,283799,590,283799,1197,4,95211,90,315,0.9996688893350664,0.9937426904680201,0.99901694206233,0.9966969809246697,0.9950656600368305,283799,94,95526,1787
12,4,safari,High,125,0.95,284019,590,284019,977,4,95211,92,313,0.9996621086531862,0.9945130363533227,0.9989960259359967,0.9970809249062227,0.9956375293148586,284019,96,95524,1567
12,4,giraffe,High,125,0.9,268852,558,268852,1135,3,90232,88,302,0.9996616383397225,0.9937422609917019,0.9989958620689655,0.9966931609229491,0.9950604978265083,268852,91,90534,1693
12,4,safari,High,125,0.9,269064,558,269064,923,3,90232,90,300,0.9996544767552024,0.9945258644587777,0.9989737931034482,0.9970835757510627,0.9956419414680068,269064,93,90532,1481
12,4,giraffe,Mid,125,0.15,44870,86,44870,3,3,14953,15,52,0.9995990019604348,0.9980204186036167,0.9988018371829861,0.9988090865582603,0.9982161315061185,44870,18,15005,89
12,4,safari,Mid,125,0.15,44870,86,44870,3,3,14953,15,52,0.9995990019604348,0.9980204186036167,0.9988018371829861,0.9988090865582603,0.9982161315061185,44870,18,15005,89
12,4,giraffe,Mid,125,0.1,29891,61,29891,1,0,10014,13,33,0.9995652755484216,0.9979300904750776,0.9987077534791252,0.9987470137160231,0.9981256091770174,29891,13,10047,62
12,4,safari,Mid,125,0.1,29891,61,29891,1,0,10014,13,33,0.9995652755484216,0.9979300904750776,0.9987077534791252,0.9987470137160231,0.9981256091770174,29891,13,10047,62
12,4,giraffe,Mid,125,0.25,74843,150,74843,4,5,24981,28,85,0.9995592713285966,0.9979465845300479,0.9986852065819355,0.9987522769277989,0.9981317934782609,74843,33,25066,154
12,4,safari,Mid,125,0.25,74843,150,74843,4,5,24981,28,85,0.9995592713285966,0.9979465845300479,0.9986852065819355,0.9987522769277989,0.9981317934782609,74843,33,25066,154
12,4,giraffe,Mid,125,0.2,59872,114,59872,4,3,19907,22,69,0.9995826168255505,0.9980330055009168,0.9987500624968751,0.9988072101228656,0.9982122988836244,59872,25,19976,118
12,4,safari,Mid,125,0.2,59872,114,59872,4,3,19907,22,69,0.9995826168255505,0.9980330055009168,0.9987500624968751,0.9988072101228656,0.9982122988836244,59872,25,19976,118
12,4,giraffe,Mid,125,0.35,104739,200,104739,4,7,35003,36,118,0.9995896241720906,0.9980560875904062,0.9987771584575134,0.9988222672547383,0.9982370616742918,104739,43,35121,204
12,4,safari,Mid,125,0.35,104739,200,104739,4,7,35003,36,118,0.9995896241720906,0.9980560875904062,0.9987771584575134,0.9988222672547383,0.9982370616742918,104739,43,35121,204
12,4,giraffe,Mid,125,0.3,89613,180,89613,4,5,29880,34,103,0.9995649846071476,0.9979509337728432,0.9987009526347346,0.9987573070900367,0.9981388594463315,89613,39,29983,184
12,4,safari,Mid,125,0.3,89613,180,89613,4,5,29880,34,103,0.9995649846071476,0.9979509337728432,0.9987009526347346,0.9987573070900367,0.9981388594463315,89613,39,29983,184
12,4,giraffe,Mid,125,0.45,135067,269,135067,6,8,45249,49,147,0.9995781652408159,0.9979681104165743,0.9987459573625503,0.9987724889634927,0.9981636660305871,135067,57,45396,275
12,4,safari,Mid,125,0.45,135067,269,135067,6,8,45249,50,146,0.9995707678075856,0.9979681104165743,0.9987239566145248,0.9987687961932509,0.9981581349041733,135067,58,45395,275
12,4,giraffe,Mid,125,0.4,119700,236,119700,5,8,40034,41,133,0.9995908107792132,0.9979906787503856,0.9987815794708573,0.9987901038841837,0.9981892767721673,119700,49,40167,241
12,4,safari,Mid,125,0.4,119700,236,119700,5,8,40034,41,133,0.9995908107792132,0.9979906787503856,0.9987815794708573,0.9987901038841837,0.9981892767721673,119700,49,40167,241
12,4,giraffe,Mid,125,0.55,165093,332,165093,6,8,55332,63,176,0.9995701242401492,0.9979568521014803,0.9987225390885046,0.9987628367035195,0.9981494050042985,165093,71,55508,338
12,4,safari,Mid,125,0.55,165093,332,165093,6,8,55332,64,175,0.999564072291345,0.9979568521014803,0.9987045466813005,0.9987598156057544,0.9981448803221573,165093,72,55507,338
12,4,giraffe,Mid,125,0.5,150161,294,150161,6,8,50375,58,162,0.9995606648605111,0.9980061278337908,0.9986957295022034,0.9987827914649071,0.9981796840806907,150161,66,50537,300
12,4,safari,Mid,125,0.5,150161,294,150161,6,8,50375,59,161,0.9995540112362542,0.9980061278337908,0.9986759678279944,0.9987794698176522,0.9981747105399276,150161,67,50536,300
12,4,giraffe,Mid,125,0.65,195297,389,195297,7,9,65453,76,211,0.9995649548064817,0.9979764222532231,0.9987072046723144,0.9987700568944576,0.9981602037928107,195297,85,65664,396
12,4,safari,Mid,125,0.65,195297,389,195297,7,9,65453,77,210,0.9995598388805577,0.9979764222532231,0.9986919953155181,0.9987675029917459,0.998156378852671,195297,86,65663,396
12,4,giraffe,Mid,125,0.6,180196,358,180196,6,9,60351,69,191,0.9995673252937196,0.9979840496233939,0.9987132959419334,0.9987750599998892,0.9981673438925284,180196,78,60542,364
12,4,safari,Mid,125,0.6,180196,358,180196,6,9,60351,70,190,0.9995617806129524,0.9979840496233939,0.9986967997360607,0.9987722920448404,0.9981631976117422,180196,79,60541,364
12,4,giraffe,Mid,125,0.75,225111,444,225111,7,10,75403,87,242,0.9995692870590743,0.9980005497379878,0.9987193366956246,0.9987843024158661,0.998181238881661,225111,97,75645,451
12,4,safari,Mid,125,0.75,225111,444,225111,7,10,75403,88,241,0.9995648486516968,0.9980005497379878,0.9987061339811465,0.9987820866914686,0.9981779199745108,225111,98,75644,451
12,4,giraffe,Mid,125,0.7,210277,422,210277,7,9,70480,80,226,0.999576927830543,0.9979639877364669,0.9987428490712621,0.9987698065888969,0.9981598644409789,210277,89,70706,429
12,4,safari,Mid,125,0.7,210277,422,210277,7,9,70480,81,225,0.9995721762443729,0.9979639877364669,0.9987287237799279,0.9987674346253499,0.9981563120557299,210277,90,70705,429
12,4,giraffe,Mid,125,0.85,255134,496,255134,8,12,85275,94,268,0.9995847045917567,0.9980284621222197,0.9987623906875737,0.9988059771608878,0.9982126480059305,255134,106,85543,504
12,4,safari,Mid,125,0.85,255134,496,255134,8,12,85275,95,267,0.9995807883529684,0.9980284621222197,0.9987507151280225,0.9988040220874219,0.9982097179206944,255134,107,85542,504
12,4,giraffe,Mid,125,0.8,239993,467,239993,8,12,80285,89,259,0.9995793314285238,0.9980246851971988,0.998747597495195,0.998801403356903,0.9982062389252382,239993,101,80544,475
12,4,safari,Mid,125,0.8,239993,467,239993,8,12,80285,90,258,0.9995751681626023,0.9980246851971988,0.998735197470395,0.998799324958434,0.9982031247567056,239993,102,80543,475
12,4,giraffe,Mid,125,0.95,285013,555,285013,9,12,95201,100,301,0.9996071898290224,0.9980250510370233,0.998828623423348,0.9988154939004945,0.998226610806656,285013,112,95502,564
12,4,safari,Mid,125,0.95,285013,555,285013,9,12,95201,101,300,0.9996036839853257,0.9980250510370233,0.9988181647039136,0.9988137437511281,0.9982239874498611,285013,113,95501,564
12,4,giraffe,Mid,125,0.9,269996,531,269996,9,12,90223,98,285,0.9995927524749543,0.998003962504066,0.9987861131342559,0.9987977256668924,0.9982002137592274,269996,110,90508,540
12,4,safari,Mid,125,0.9,269996,531,269996,9,12,90223,99,284,0.9995890517461599,0.998003962504066,0.9987750777991128,0.9987958782412794,0.9981974448573185,269996,111,90507,540
12,4,giraffe,None,125,0.15,44879,82,44879,0,0,14958,14,46,0.9996881473726417,0.9981761971486399,0.9990677853242775,0.9989316001513566,0.9983994398039314,44879,14,15004,82
12,4,safari,None,125,0.15,44879,82,44879,0,0,14958,14,46,0.9996881473726417,0.9981761971486399,0.9990677853242775,0.9989316001513566,0.9983994398039314,44879,14,15004,82
12,4,giraffe,None,125,0.1,29905,50,29905,0,0,10014,8,25,0.9997325577508107,0.9983308295776999,0.9992037424106699,0.9990312019776842,0.9985500724963752,29905,8,10039,50
12,4,safari,None,125,0.1,29905,50,29905,0,0,10014,8,25,0.9997325577508107,0.9983308295776999,0.9992037424106699,0.9990312019776842,0.9985500724963752,29905,8,10039,50
12,4,giraffe,None,125,0.25,74863,137,74863,0,0,24988,25,83,0.999666168144429,0.9981733333333334,0.9990038253108064,0.9989191929974381,0.99838155370844,74863,25,25071,137
12,4,safari,None,125,0.25,74863,137,74863,0,0,24988,25,83,0.999666168144429,0.9981733333333334,0.9990038253108064,0.9989191929974381,0.99838155370844,74863,25,25071,137
12,4,giraffe,None,125,0.2,59885,108,59885,0,0,19912,20,65,0.9996661380519155,0.9981997899754972,0.9989998499774966,0.9989324258953444,0.9983997999749968,59885,20,19977,108
12,4,safari,None,125,0.2,59885,108,59885,0,0,19912,20,65,0.9996661380519155,0.9981997899754972,0.9989998499774966,0.9989324258953444,0.9983997999749968,59885,20,19977,108
12,4,giraffe,None,125,0.35,104751,195,104751,0,2,35010,38,111,0.9996182878300618,0.9981419015493682,0.9988623759278746,0.9988795491496494,0.9983227104998322,104751,40,35121,195
12,4,safari,None,125,0.35,104751,195,104751,0,2,35010,38,111,0.9996182878300618,0.9981419015493682,0.9988623759278746,0.9988795491496494,0.9983227104998322,104751,40,35121,195
12,4,giraffe,None,125,0.3,89632,168,89632,0,1,29886,32,102,0.9996319634193944,0.9981291759465479,0.9989007694613771,0.9988800044576936,0.9983224977257743,89632,33,29988,168
12,4,safari,None,125,0.3,89632,168,89632,0,1,29886,32,102,0.9996319634193944,0.9981291759465479,0.9989007694613771,0.9988800044576936,0.9983224977257743,89632,33,29988,168
12,4,giraffe,None,125,0.45,135088,258,135088,0,6,45251,48,137,0.9996004202986488,0.9980937744743102,0.9988116720214779,0.9988465292360474,0.998274221740381,135088,54,45388,258
12,4,safari,None,125,0.45,135088,258,135088,0,6,45251,48,137,0.9996004202986488,0.9980937744743102,0.9988116720214779,0.9988465292360474,0.998274221740381,135088,54,45388,258
12,4,giraffe,None,125,0.4,119726,219,119726,0,4,40040,43,122,0.9996075910263582,0.9981741631581141,0.9988311074635032,0.9988903628430071,0.9983390986175806,119726,47,40162,219
12,4,safari,None,125,0.4,119726,219,119726,0,4,40040,43,122,0.9996075910263582,0.9981741631581141,0.9988311074635032,0.9988903628430071,0.9983390986175806,119726,47,40162,219
12,4,giraffe,None,125,0.55,165117,318,165117,0,6,55334,63,161,0.9995822890559732,0.9980777949043431,0.9987581887553092,0.998829475441669,0.998248860854574,165117,69,55495,318
12,4,safari,None,125,0.55,165117,318,165117,0,6,55334,63,161,0.9995822890559732,0.9980777949043431,0.9987581887553092,0.998829475441669,0.998248860854574,165117,69,55495,318
12,4,giraffe,None,125,0.5,150179,286,150179,0,6,50377,58,151,0.9995740234154004,0.9980992257335592,0.9987349778621126,0.9988360801840989,0.998259200127327,150179,64,50528,286
12,4,safari,None,125,0.5,150179,286,150179,0,6,50377,58,151,0.9995740234154004,0.9980992257335592,0.9987349778621126,0.9988360801840989,0.998259200127327,150179,64,50528,286
12,4,giraffe,None,125,0.65,195306,389,195306,0,6,65458,75,200,0.9995854381304795,0.9980122128822914,0.9987678546981243,0.9987982060028332,0.9982022231232357,195306,81,65658,389
12,4,safari,None,125,0.65,195306,389,195306,0,6,65458,75,200,0.9995854381304795,0.9980122128822914,0.9987678546981243,0.9987982060028332,0.9982022231232357,195306,81,65658,389
12,4,giraffe,None,125,0.6,180211,352,180211,0,6,60354,67,178,0.9995950833129951,0.998050541916118,0.9987954789208812,0.9988222155096205,0.9982377429841438,180211,73,60532,352
12,4,safari,None,125,0.6,180211,352,180211,0,6,60354,67,178,0.9995950833129951,0.998050541916118,0.9987954789208812,0.9988222155096205,0.9982377429841438,180211,73,60532,352
12,4,giraffe,None,125,0.75,225134,433,225134,0,6,75409,85,235,0.9995959595959596,0.9980803929652831,0.9987984419356969,0.9988376013771318,0.9982608811093189,225134,91,75644,433
12,4,safari,None,125,0.75,225134,433,225134,0,6,75409,85,235,0.9995959595959596,0.9980803929652831,0.9987984419356969,0.9988376013771318,0.9982608811093189,225134,91,75644,433
12,4,giraffe,None,125,0.7,210297,414,210297,0,6,70485,81,216,0.9995864704540269,0.9980352236000968,0.9987709781318868,0.9988102447191252,0.9982202423454435,210297,87,70701,414
12,4,safari,None,125,0.7,210297,414,210297,0,6,70485,81,216,0.9995864704540269,0.9980352236000968,0.9987709781318868,0.9988102447191252,0.9982202423454435,210297,87,70701,414
12,4,giraffe,None,125,0.85,255159,485,255159,0,7,85284,100,273,0.999580829409322,0.9981028304986622,0.9987509338812103,0.9988412832005638,0.9982654962673011,255159,107,85557,485
12,4,safari,None,125,0.85,255159,485,255159,0,7,85284,100,273,0.999580829409322,0.9981028304986622,0.9987509338812103,0.9988412832005638,0.9982654962673011,255159,107,85557,485
12,4,giraffe,None,125,0.8,240015,457,240015,0,6,80293,89,255,0.9996043480071634,0.9980995708440068,0.9988219684287539,0.9988513926863677,0.9982809896765956,240015,95,80548,457
12,4,safari,None,125,0.8,240015,457,240015,0,6,80293,89,255,0.9996043480071634,0.9980995708440068,0.9988219684287539,0.9988513926863677,0.9982809896765956,240015,95,80548,457
12,4,giraffe,None,125,0.95,285032,552,285032,0,9,95209,105,300,0.9996002048073619,0.9980671186060843,0.9988078182027337,0.998833073432271,0.9982529177061281,285032,114,95509,552
12,4,safari,None,125,0.95,285032,552,285032,0,9,95209,105,300,0.9996002048073619,0.9980671186060843,0.9988078182027337,0.998833073432271,0.9982529177061281,285032,114,95509,552
12,4,giraffe,None,125,0.9,270021,522,270021,0,7,90231,103,287,0.9995927901647719,0.9980705470110112,0.9987862470759589,0.9988310886042235,0.9982501363620002,270021,110,90518,522
12,4,safari,None,125,0.9,270021,522,270021,0,7,90231,103,287,0.9995927901647719,0.9980705470110112,0.9987862470759589,0.9988310886042235,0.9982501363620002,270021,110,90518,522
12,4,giraffe,Single-stranded,125,0.15,44867,94,44867,0,0,14958,14,46,0.999688063991444,0.9979092991703922,0.9990677853242775,0.998797889628459,0.9981993697794228,44867,14,15004,94
12,4,safari,Single-stranded,125,0.15,44867,94,44867,0,0,14958,14,46,0.999688063991444,0.9979092991703922,0.9990677853242775,0.998797889628459,0.9981993697794228,44867,14,15004,94
12,4,giraffe,Single-stranded,125,0.1,29888,67,29888,0,0,10014,8,25,0.9997324056729997,0.9977633116341178,0.9992037424106699,0.9987468881054619,0.9981250937453128,29888,8,10039,67
12,4,safari,Single-stranded,125,0.1,29888,67,29888,0,0,10014,8,25,0.9997324056729997,0.9977633116341178,0.9992037424106699,0.9987468881054619,0.9981250937453128,29888,8,10039,67
12,4,giraffe,Single-stranded,125,0.25,74846,154,74846,0,0,24987,25,83,0.999666092345501,0.9979466666666666,0.9990037856146643,0.998805639516651,0.9982116988860582,74846,25,25070,154
12,4,safari,Single-stranded,125,0.25,74846,154,74846,0,0,24987,25,83,0.999666092345501,0.9979466666666666,0.9990037856146643,0.998805639516651,0.9982116988860582,74846,25,25070,154
12,4,giraffe,Single-stranded,125,0.2,59882,111,59882,0,0,19911,20,65,0.9996661213315081,0.9981497841414831,0.998999799959992,0.9989073772884607,0.9983622748127867,59882,20,19976,111
12,4,safari,Single-stranded,125,0.2,59882,111,59882,0,0,19911,20,65,0.9996661213315081,0.9981497841414831,0.998999799959992,0.9989073772884607,0.9983622748127867,59882,20,19976,111
12,4,giraffe,Single-stranded,125,0.35,104737,209,104737,0,3,35007,38,111,0.999608696482086,0.9980084996093229,0.9988338689951364,0.9988079571246018,0.9982156239962885,104737,41,35118,209
12,4,safari,Single-stranded,125,0.35,104737,209,104737,0,3,35007,38,111,0.999608696482086,0.9980084996093229,0.9988338689951364,0.9988079571246018,0.9982156239962885,104737,41,35118,209
12,4,giraffe,Single-stranded,125,0.3,89613,187,89613,0,1,29884,32,102,0.9996318854159695,0.9979175946547885,0.9989006962257237,0.9987740044358748,0.9981638972116276,89613,33,29986,187
12,4,safari,Single-stranded,125,0.3,89613,187,89613,0,1,29884,32,102,0.9996318854159695,0.9979175946547885,0.9989006962257237,0.9987740044358748,0.9981638972116276,89613,33,29986,187
12,4,giraffe,Single-stranded,125,0.45,135092,254,135092,0,5,45250,48,137,0.9996078286285102,0.9981233283584295,0.9988336267605634,0.9988650269325042,0.9983018596572744,135092,53,45387,254
12,4,safari,Single-stranded,125,0.45,135092,254,135092,0,5,45250,48,137,0.9996078286285102,0.9981233283584295,0.9988336267605634,0.9988650269325042,0.9983018596572744,135092,53,45387,254
12,4,giraffe,Single-stranded,125,0.4,119711,234,119711,0,5,40037,43,122,0.9995991950500589,0.9980491058401767,0.9988061780287014,0.9988235490438206,0.9982391727858534,119711,48,40159,234
12,4,safari,Single-stranded,125,0.4,119711,234,119711,0,5,40037,43,122,0.9995991950500589,0.9980491058401767,0.9988061780287014,0.9988235490438206,0.9982391727858534,119711,48,40159,234
12,4,giraffe,Single-stranded,125,0.55,165114,318,165114,1,5,55334,62,162,0.9995943843420249,0.9980717269226816,0.998794161582348,0.998832475333773,0.9982533620518018,165114,67,55496,319
12,4,safari,Single-stranded,125,0.55,165114,318,165114,1,5,55334,62,162,0.9995943843420249,0.9980717269226816,0.998794161582348,0.998832475333773,0.9982533620518018,165114,67,55496,319
12,4,giraffe,Single-stranded,125,0.5,150182,283,150182,0,5,50376,58,151,0.9995806848813604,0.9981191639251653,0.9987546946036766,0.9988493897775265,0.998279077864266,150182,63,50527,283
12,4,safari,Single-stranded,125,0.5,150182,283,150182,0,5,50376,58,151,0.9995806848813604,0.9981191639251653,0.9987546946036766,0.9988493897775265,0.998279077864266,150182,63,50527,283
12,4,giraffe,Single-stranded,125,0.65,195314,379,195314,1,6,65457,74,201,0.9995905708465971,0.998058192892986,0.9987830478566431,0.9988237941332897,0.9982404602344013,195314,80,65658,380
12,4,safari,Single-stranded,125,0.65,195314,379,195314,1,6,65457,74,201,0.9995905708465971,0.998058192892986,0.9987830478566431,0.9988237941332897,0.9982404602344013,195314,80,65658,380
12,4,giraffe,Single-stranded,125,0.6,180213,348,180213,1,5,60354,66,179,0.9996061769208582,0.9980671459110998,0.9988284601676457,0.9988360685721887,0.9982584609770864,180213,71,60533,349
12,4,safari,Single-stranded,125,0.6,180213,348,180213,1,5,60354,66,179,0.9996061769208582,0.9980671459110998,0.9988284601676457,0.9988360685721887,0.9982584609770864,180213,71,60533,349
12,4,giraffe,Single-stranded,125,0.75,225115,450,225115,1,7,75407,84,236,0.9995959255082014,0.9980005851945772,0.9987984260701931,0.998797618308147,0.9982011284434119,225115,91,75643,451
12,4,safari,Single-stranded,125,0.75,225115,450,225115,1,7,75407,84,236,0.9995959255082014,0.9980005851945772,0.9987984260701931,0.998797618308147,0.9982011284434119,225115,91,75643,451
12,4,giraffe,Single-stranded,125,0.7,210296,413,210296,1,6,70484,80,217,0.99959121978116,0.9980352142755445,0.9987850876573382,0.9988126110208695,0.9982237821362216,210296,86,70701,414
12,4,safari,Single-stranded,125,0.7,210296,413,210296,1,6,70484,80,217,0.99959121978116,0.9980352142755445,0.9987850876573382,0.9988126110208695,0.9982237821362216,210296,86,70701,414
12,4,giraffe,Single-stranded,125,0.85,255143,499,255143,1,8,85284,99,274,0.9995808031341822,0.998044147502572,0.9987509484620324,0.9988118842888823,0.9982215476929929,255143,107,85558,500
12,4,safari,Single-stranded,125,0.85,255143,499,255143,1,8,85284,99,274,0.9995808031341822,0.998044147502572,0.9987509484620324,0.9988118842888823,0.9982215476929929,255143,107,85558,500
12,4,giraffe,Single-stranded,125,0.8,240000,470,240000,1,8,80292,88,256,0.9996001599360256,0.9980413438626695,0.9988095828579932,0.9988201437052483,0.9982342774395466,240000,96,80548,471
12,4,safari,Single-stranded,125,0.8,240000,470,240000,1,8,80292,88,256,0.9996001599360256,0.9980413438626695,0.9988095828579932,0.9988201437052483,0.9982342774395466,240000,96,80548,471
12,4,giraffe,Single-stranded,125,0.95,285027,554,285027,1,9,95210,104,301,0.9996037034439222,0.9980566002058954,0.9988182882958253,0.9988295527419655,0.9982476666159504,285027,113,95511,555
12,4,safari,Single-stranded,125,0.95,285027,554,285027,1,9,95210,104,301,0.9996037034439222,0.9980566002058954,0.9988182882958253,0.9988295527419655,0.9982476666159504,285027,113,95511,555
12,4,giraffe,Single-stranded,125,0.9,270010,530,270010,1,8,90231,102,288,0.9995927735821116,0.9980372660705771,0.9987862604685035,0.9988144142077938,0.998225212503807,270010,110,90519,531
12,4,safari,Single-stranded,125,0.9,270010,530,270010,1,8,90231,102,288,0.9995927735821116,0.9980372660705771,0.9987862604685035,0.9988144142077938,0.998225212503807,270010,110,90519,531
12,6,giraffe,High,125,0.15,44547,91,44547,322,0,14956,10,50,0.9997755683730951,0.9908140569395018,0.9993340436867342,0.9952746405710647,0.9929471788715486,44547,10,15006,413
12,6,safari,High,125,0.15,44588,91,44588,281,0,14956,10,50,0.9997757746984169,0.9917259786476869,0.9993340436867342,0.9957346077402354,0.9936307856475923,44588,10,15006,372
12,6,giraffe,High,125,0.1,29692,56,29692,206,0,10014,6,27,0.9997979661930096,0.9912532549909862,0.9994028068080024,0.9955072755314156,0.9933001674958126,29692,6,10041,262
12,6,safari,High,125,0.1,29721,56,29721,177,0,10014,6,27,0.9997981632859017,0.992221406156106,0.9994028068080024,0.9959953754126103,0.9940251493712657,29721,6,10041,233
12,6,giraffe,High,125,0.25,74311,156,74311,532,1,24985,18,90,0.9997443831561953,0.9908265443539247,0.9992428468956722,0.9952654876145959,0.9929365689908385,74311,19,25075,688
12,6,safari,High,125,0.25,74369,156,74369,474,1,24985,19,89,0.9997311430453427,0.9915998879985066,0.9992029967322866,0.9956489142367526,0.9935060393833735,74369,20,25074,630
12,6,giraffe,High,125,0.2,59453,123,59453,416,0,19910,13,72,0.9997813876837184,0.9910154687291639,0.9993498374593648,0.9953791290662827,0.9930988785677672,59453,13,19982,539
12,6,safari,High,125,0.2,59506,123,59506,363,0,19910,14,71,0.9997647849462366,0.9918989198559808,0.999299824956239,0.9958163197001138,0.9937489842099341,59506,14,19981,486
12,6,giraffe,High,125,0.35,104008,214,104008,722,2,35008,27,122,0.999721253015754,0.9910809574630279,0.9991751756307062,0.9953823553337385,0.9931122103024204,104008,29,35130,936
12,6,safari,High,125,0.35,104094,214,104094,636,2,35008,28,121,0.9997118819868618,0.9919004421405702,0.9991467334110754,0.995790843170643,0.9937189068042797,104094,30,35129,850
12,6,giraffe,High,125,0.3,88982,190,88982,627,1,29884,23,111,0.999730355256949,0.9909019031392332,0.9992005063459809,0.9952965521098404,0.9929810212155102,88982,24,29995,817
12,6,safari,High,125,0.3,89053,190,89053,556,1,29884,24,110,0.999719347089068,0.9916925578235838,0.9991671941103968,0.9956897756558977,0.9935652406149327,89053,25,29994,746
12,6,giraffe,High,125,0.45,134120,277,134120,947,2,45253,36,149,0.9997167518895631,0.9909563778224376,0.9991637323943662,0.9953172889254996,0.9930192937428091,134120,38,45402,1224
12,6,safari,High,125,0.45,134238,277,134238,829,2,45253,37,148,0.9997095556200988,0.991828230287268,0.9991417253521127,0.9957532981481412,0.9936664749092841,134238,39,45401,1106
12,6,giraffe,High,125,0.4,118867,243,118867,833,2,40040,31,134,0.9997224558452481,0.991029072142601,0.9991792473947323,0.9953567824889153,0.9930752419606619,118867,33,40174,1076
12,6,safari,High,125,0.4,118972,243,118972,728,2,40040,32,133,0.9997143001193217,0.9919044879651168,0.9991543761036635,0.9957940815822623,0.9937246331564159,118972,34,40173,971
12,6,giraffe,High,125,0.55,163942,334,163942,1157,2,55336,48,176,0.999695107078394,0.9909872879050734,0.999100104387891,0.9953221522349549,0.993026991560895,163942,50,55512,1491
12,6,safari,High,125,0.55,164097,334,164097,1002,2,55336,49,175,0.9996893047737407,0.9919242230993817,0.9990821064756489,0.9957916263376834,0.9937238399058802,164097,51,55511,1336
12,6,giraffe,High,125,0.5,149100,303,149100,1060,2,50379,44,165,0.9996915773805533,0.9909412945375276,0.9990907293931607,0.995297204022576,0.9929918976588262,149100,46,50544,1363
12,6,safari,High,125,0.5,149237,303,149237,923,2,50379,45,164,0.9996851638487715,0.9918518173903219,0.9990709626408381,0.9957530851017692,0.9936683362098551,149237,47,50543,1226
12,6,giraffe,High,125,0.65,193919,400,193919,1374,2,65460,54,221,0.9997113030029643,0.990934780498025,0.9991481205409435,0.9953036944270508,0.9930000382511571,193919,56,65681,1774
12,6,safari,High,125,0.65,194098,400,194098,1195,2,65460,55,220,0.9997064201282481,0.9918494785199267,0.999132908407746,0.9957624510065461,0.9936809088474926,194098,57,65680,1595
12,6,giraffe,High,125,0.6,178916,374,178916,1271,2,60356,49,196,0.9997150312627467,0.9908895054856808,0.9991584575021039,0.9952827039896754,0.9929674412433033,178916,51,60552,1645
12,6,safari,High,125,0.6,179080,374,179080,1107,2,60356,50,195,0.9997097112743675,0.9917977857898439,0.9991419566688118,0.995738032155199,0.9936433298502264,179080,52,60551,1481
12,6,giraffe,High,125,0.75,223546,450,223546,1571,2,75411,63,257,0.9997093166257474,0.991040356080455,0.9991417215744788,0.9953559613338142,0.9930766677729838,223546,65,75668,2021
12,6,safari,High,125,0.75,223746,450,223746,1371,2,75411,64,256,0.9997051096455954,0.9919270105999548,0.9991285172910092,0.9958008718698471,0.9937371390640558,223746,66,75667,1821
12,6,giraffe,High,125,0.7,208815,420,208815,1476,2,70487,59,238,0.9997079607039583,0.9910018935888492,0.9991382476760942,0.9953358898154614,0.9930478832811718,208815,61,70725,1896
12,6,safari,High,125,0.7,209004,420,209004,1287,2,70487,60,237,0.9997034429318971,0.9918988567279354,0.9991241205888169,0.9957858577292229,0.9937157411979524,209004,62,70724,1707
12,6,giraffe,High,125,0.85,253348,514,253348,1784,3,85284,77,296,0.9996843284877757,0.9910110074086823,0.9990660751809479,0.9953287734199744,0.9930326451922908,253348,80,85580,2298
12,6,safari,High,125,0.85,253549,514,253549,1583,3,85284,78,295,0.9996806371486023,0.9917972508859908,0.9990544011207098,0.9957233405854586,0.9936186296168248,253549,81,85579,2097
12,6,giraffe,High,125,0.8,238318,477,238318,1679,3,80294,68,276,0.9997021674657807,0.9910343737784543,0.9991195545690158,0.9953494005592414,0.993064789872787,238318,71,80570,2156
12,6,safari,High,125,0.8,238523,477,238523,1474,3,80294,69,275,0.9996982334080764,0.9918868567911707,0.9991071539291427,0.9957772262450711,0.9937000762966538,238523,72,80569,1951
12,6,giraffe,High,125,0.95,283012,587,283012,1987,3,95212,81,324,0.9997032808658547,0.9909869531419607,0.9991215226939971,0.9953260345852338,0.9930273920137669,283012,84,95536,2574
12,6,safari,High,125,0.95,283229,587,283229,1770,3,95212,82,323,0.9996999795280148,0.9917467943106455,0.9991110646308303,0.995707505712779,0.9935940147846571,283229,85,95535,2357
12,6,giraffe,High,125,0.9,268107,555,268107,1883,3,90232,79,311,0.999694245476138,0.9909885601286292,0.9990951724137931,0.9953223668823574,0.9930226763020185,268107,82,90543,2438
12,6,safari,High,125,0.9,268314,555,268314,1676,3,90232,80,310,0.9996907566030917,0.9917536823818588,0.9990841379310345,0.995706402544244,0.993593044826536,268314,83,90542,2231
12,6,giraffe,Mid,125,0.15,44869,86,44869,4,2,14954,11,56,0.9997103515886101,0.9979981761160168,0.9991346601877121,0.9988535301254439,0.998282818178787,44869,13,15010,90
12,6,safari,Mid,125,0.15,44869,86,44869,4,2,14954,11,56,0.9997103515886101,0.9979981761160168,0.9991346601877121,0.9988535301254439,0.998282818178787,44869,13,15010,90
12,6,giraffe,Mid,125,0.1,29890,61,29890,2,0,10014,9,37,0.9996989865881802,0.9978967048375789,0.9991053677932406,0.9987970326806123,0.9982005848099368,29890,9,10051,63
12,6,safari,Mid,125,0.1,29890,61,29890,2,0,10014,9,37,0.9996989865881802,0.9978967048375789,0.9991053677932406,0.9987970326806123,0.9982005848099368,29890,9,10051,63
12,6,giraffe,Mid,125,0.25,74842,150,74842,5,3,24983,23,90,0.999652722124272,0.9979332506633599,0.9989641021554644,0.9987922463550529,0.9981917359335039,74842,26,25073,155
12,6,safari,Mid,125,0.25,74842,150,74842,5,3,24983,23,90,0.999652722124272,0.9979332506633599,0.9989641021554644,0.9987922463550529,0.9981917359335039,74842,26,25073,155
12,6,giraffe,Mid,125,0.2,59871,114,59871,5,2,19908,17,74,0.999682751711471,0.9980163360560094,0.9990500474976252,0.998848848848849,0.9982748059156655,59871,19,19982,119
12,6,safari,Mid,125,0.2,59871,114,59871,5,2,19908,17,74,0.999682751711471,0.9980163360560094,0.9990500474976252,0.998848848848849,0.9982748059156655,59871,19,19982,119
12,6,giraffe,Mid,125,0.35,104738,200,104738,5,4,35006,30,124,0.9996754858168213,0.9980465586080063,0.9990331020361733,0.9988603581050474,0.9982941608913187,104738,34,35130,205
12,6,safari,Mid,125,0.35,104738,200,104738,5,4,35006,30,124,0.9996754858168213,0.9980465586080063,0.9990331020361733,0.9988603581050474,0.9982941608913187,104738,34,35130,205
12,6,giraffe,Mid,125,0.3,89612,180,89612,5,3,29882,29,108,0.9996430324394271,0.9979397975433478,0.9989341149823463,0.99879068886152,0.9981889349769235,89612,32,29990,185
12,6,safari,Mid,125,0.3,89612,180,89612,5,3,29882,29,108,0.9996430324394271,0.9979397975433478,0.9989341149823463,0.99879068886152,0.9981889349769235,89612,32,29990,185
12,6,giraffe,Mid,125,0.45,135066,269,135066,7,5,45252,40,156,0.999666940515576,0.99796072172718,0.9990099663388555,0.9988131024614257,0.99822450842114,135066,45,45408,276
12,6,safari,Mid,125,0.45,135066,269,135066,7,5,45252,40,156,0.999666940515576,0.99796072172718,0.9990099663388555,0.9988131024614257,0.99822450842114,135066,45,45408,276
12,6,giraffe,Mid,125,0.4,119699,236,119699,6,5,40037,33,141,0.999682637781137,0.9979823413178146,0.9990551024467873,0.9988317659526532,0.9982517155041616,119699,38,40178,242
12,6,safari,Mid,125,0.4,119699,236,119699,6,5,40037,33,141,0.999682637781137,0.9979823413178146,0.9990551024467873,0.9988317659526532,0.9982517155041616,119699,38,40178,242
12,6,giraffe,Mid,125,0.55,165092,332,165092,7,5,55335,54,185,0.9996427511792239,0.9979508072852126,0.9989384479749546,0.9987960627015385,0.9981991765078503,165092,59,55520,339
12,6,safari,Mid,125,0.55,165092,332,165092,7,5,55335,54,185,0.9996427511792239,0.9979508072852126,0.9989384479749546,0.9987960627015385,0.9981991765078503,165092,59,55520,339
12,6,giraffe,Mid,125,0.5,150160,294,150160,7,5,50378,49,171,0.9996405128683079,0.9979994815932368,0.9989328695927119,0.9988193231894904,0.9982343930290852,150160,54,50549,301
12,6,safari,Mid,125,0.5,150160,294,150160,7,5,50378,49,171,0.9996405128683079,0.9979994815932368,0.9989328695927119,0.9988193231894904,0.9982343930290852,150160,54,50549,301
12,6,giraffe,Mid,125,0.65,195296,389,195296,8,6,65456,65,222,0.9996365814083238,0.9979713122084081,0.9989201356674626,0.9988032526977958,0.9982099280146266,195296,71,65678,397
12,6,safari,Mid,125,0.65,195296,389,195296,8,6,65456,65,222,0.9996365814083238,0.9979713122084081,0.9989201356674626,0.9988032526977958,0.9982099280146266,195296,71,65678,397
12,6,giraffe,Mid,125,0.6,180195,358,180195,7,6,60354,59,201,0.9996394097414846,0.9979785112981834,0.9989277466182778,0.9988082700515493,0.998217099261962,180195,65,60555,365
12,6,safari,Mid,125,0.6,180195,358,180195,7,6,60354,59,201,0.9996394097414846,0.9979785112981834,0.9989277466182778,0.9988082700515493,0.998217099261962,180195,65,60555,365
12,6,giraffe,Mid,125,0.75,225109,444,225109,9,7,75406,75,254,0.9996358646659946,0.9979916829962494,0.9989173774127961,0.998813097195138,0.9982243846746144,225109,82,75660,453
12,6,safari,Mid,125,0.75,225109,444,225109,9,7,75406,75,254,0.9996358646659946,0.9979916829962494,0.9989173774127961,0.998813097195138,0.9982243846746144,225109,82,75660,453
12,6,giraffe,Mid,125,0.7,210275,422,210275,9,6,70483,68,238,0.999648203699566,0.9979544958378025,0.9989547284412741,0.9988006317464464,0.9982060454492169,210275,74,70721,431
12,6,safari,Mid,125,0.7,210275,422,210275,9,6,70483,68,238,0.999648203699566,0.9979544958378025,0.9989547284412741,0.9988006317464464,0.9982060454492169,210275,74,70721,431
12,6,giraffe,Mid,125,0.85,255131,496,255131,11,8,85279,81,281,0.9996512812475511,0.9980167267777091,0.9989608751999439,0.9988333352908244,0.998253669199237,255131,89,85560,507
12,6,safari,Mid,125,0.85,255131,496,255131,11,8,85279,81,281,0.9996512812475511,0.9980167267777091,0.9989608751999439,0.9988333352908244,0.998253669199237,255131,89,85560,507
12,6,giraffe,Mid,125,0.8,239991,467,239991,10,8,80289,77,271,0.9996459454506073,0.9980163680822396,0.9989459978919958,0.9988304921089431,0.9982498372846942,239991,85,80560,477
12,6,safari,Mid,125,0.8,239991,467,239991,10,8,80289,77,271,0.9996459454506073,0.9980163680822396,0.9989459978919958,0.9988304921089431,0.9982498372846942,239991,85,80560,477
12,6,giraffe,Mid,125,0.95,285010,555,285010,12,8,95205,87,314,0.9996667894284562,0.9980145459893479,0.9990064216537328,0.9988399844396705,0.9982633378017844,285010,95,95519,567
12,6,safari,Mid,125,0.95,285010,555,285010,12,8,95205,87,314,0.9996667894284562,0.9980145459893479,0.9990064216537328,0.9988399844396705,0.9982633378017844,285010,95,95519,567
12,6,giraffe,Mid,125,0.9,269993,531,269993,12,8,90227,85,298,0.9996556652325556,0.9979928734068664,0.9989737138316891,0.998823577286903,0.9982389783859517,269993,93,90525,543
12,6,safari,Mid,125,0.9,269993,531,269993,12,8,90227,85,298,0.9996556652325556,0.9979928734068664,0.9989737138316891,0.998823577286903,0.9982389783859517,269993,93,90525,543
12,6,giraffe,None,125,0.15,44879,82,44879,0,0,14958,12,48,0.9997326858390323,0.9981761971486399,0.9992009588493808,0.9989538351956551,0.9984327848080161,44879,12,15006,82
12,6,safari,None,125,0.15,44879,82,44879,0,0,14958,12,48,0.9997326858390323,0.9981761971486399,0.9992009588493808,0.9989538351956551,0.9984327848080161,44879,12,15006,82
12,6,giraffe,None,125,0.1,29905,50,29905,0,0,10014,7,26,0.999765980208612,0.9983308295776999,0.9993032746093361,0.9990478894883659,0.9985750712464376,29905,7,10040,50
12,6,safari,None,125,0.1,29905,50,29905,0,0,10014,7,26,0.999765980208612,0.9983308295776999,0.9993032746093361,0.9990478894883659,0.9985750712464376,29905,7,10040,50
12,6,giraffe,None,125,0.25,74863,137,74863,0,0,24988,23,85,0.9996928664903988,0.9981733333333334,0.999083519285942,0.9989325220500915,0.9984015345268542,74863,23,25073,137
12,6,safari,None,125,0.25,74863,137,74863,0,0,24988,23,85,0.9996928664903988,0.9981733333333334,0.999083519285942,0.9989325220500915,0.9984015345268542,74863,23,25073,137
12,6,giraffe,None,125,0.2,59885,108,59885,0,0,19912,18,67,0.999699514214647,0.9981997899754972,0.999099864979747,0.9989490892106493,0.9984248031003875,59885,18,19979,108
12,6,safari,None,125,0.2,59885,108,59885,0,0,19912,18,67,0.999699514214647,0.9981997899754972,0.999099864979747,0.9989490892106493,0.9984248031003875,59885,18,19979,108
12,6,giraffe,None,125,0.35,104751,195,104751,0,2,35010,34,115,0.9996564459331787,0.9981419015493682,0.9989761383350871,0.998898599648124,0.9983512601083457,104751,36,35125,195
12,6,safari,None,125,0.35,104751,195,104751,0,2,35010,34,115,0.9996564459331787,0.9981419015493682,0.9989761383350871,0.998898599648124,0.9983512601083457,104751,36,35125,195
12,6,giraffe,None,125,0.3,89632,168,89632,0,1,29886,29,105,0.9996654100956928,0.9981291759465479,0.9990006995103428,0.9988967023659604,0.9983475350731508,89632,30,29991,168
12,6,safari,None,125,0.3,89632,168,89632,0,1,29886,29,105,0.9996654100956928,0.9981291759465479,0.9990006995103428,0.9988967023659604,0.9983475350731508,89632,30,29991,168
12,6,giraffe,None,125,0.45,135088,258,135088,0,5,45252,43,142,0.9996448022732655,0.9980937744743102,0.998943708463536,0.9988686862711752,0.9983074097838353,135088,48,45394,258
12,6,safari,None,125,0.45,135088,258,135088,0,5,45252,43,142,0.9996448022732655,0.9980937744743102,0.998943708463536,0.9988686862711752,0.9983074097838353,135088,48,45394,258
12,6,giraffe,None,125,0.4,119726,219,119726,0,3,40041,38,127,0.9996576686399425,0.9981741631581141,0.9989803277873113,0.9989153651047924,0.9983765625585375,119726,41,40168,219
12,6,safari,None,125,0.4,119726,219,119726,0,3,40041,38,127,0.9996576686399425,0.9981741631581141,0.9989803277873113,0.9989153651047924,0.9983765625585375,119726,41,40168,219
12,6,giraffe,None,125,0.55,165117,318,165117,0,5,55335,57,167,0.9996246496225307,0.9980777949043431,0.9988841696062198,0.9988506233855795,0.9982805352060417,165117,62,55502,318
12,6,safari,None,125,0.55,165117,318,165117,0,5,55335,57,167,0.9996246496225307,0.9980777949043431,0.9988841696062198,0.9988506233855795,0.9982805352060417,165117,62,55502,318
12,6,giraffe,None,125,0.5,150179,286,150179,0,5,50378,52,157,0.9996205969275007,0.9980992257335592,0.998873339658444,0.9988593320274958,0.9982940161247805,150179,57,50535,286
12,6,safari,None,125,0.5,150179,286,150179,0,5,50378,52,157,0.9996205969275007,0.9980992257335592,0.998873339658444,0.9988593320274958,0.9982940161247805,150179,57,50535,286
12,6,giraffe,None,125,0.65,195306,389,195306,0,5,65459,66,209,0.999636600009213,0.9980122128822914,0.9989199714020597,0.9988237460109648,0.9982404736950817,195306,71,65668,389
12,6,safari,None,125,0.65,195306,389,195306,0,5,65459,66,209,0.999636600009213,0.9980122128822914,0.9989199714020597,0.9988237460109648,0.9982404736950817,195306,71,65668,389
12,6,giraffe,None,125,0.6,180211,352,180211,0,5,60355,60,185,0.9996394417448801,0.998050541916118,0.9989274812309216,0.9988443599500054,0.9982709148809129,180211,65,60540,352
12,6,safari,None,125,0.6,180211,352,180211,0,5,60355,60,185,0.9996394417448801,0.998050541916118,0.9989274812309216,0.9988443599500054,0.9982709148809129,180211,65,60540,352
12,6,giraffe,None,125,0.75,225134,433,225134,0,5,75410,76,244,0.9996403436716027,0.9980803929652831,0.9989304812834224,0.9988597592627922,0.9982940704011258,225134,81,75654,433
12,6,safari,None,125,0.75,225134,433,225134,0,5,75410,76,244,0.9996403436716027,0.9980803929652831,0.9989304812834224,0.9988597592627922,0.9982940704011258,225134,81,75654,433
12,6,giraffe,None,125,0.7,210297,414,210297,0,5,70486,72,225,0.9996339851882837,0.9980352236000968,0.9989122450132791,0.9988339646389683,0.9982557664503249,210297,77,70711,414
12,6,safari,None,125,0.7,210297,414,210297,0,5,70486,72,225,0.9996339851882837,0.9980352236000968,0.9989122450132791,0.9988339646389683,0.9982557664503249,210297,77,70711,414
12,6,giraffe,None,125,0.85,255159,485,255159,0,5,85286,89,284,0.9996317379227668,0.9981028304986622,0.9989026895778856,0.9988666991585389,0.9983035850317016,255159,94,85570,485
12,6,safari,None,125,0.85,255159,485,255159,0,5,85286,89,284,0.9996317379227668,0.9981028304986622,0.9989026895778856,0.9988666991585389,0.9983035850317016,255159,94,85570,485
12,6,giraffe,None,125,0.8,240015,457,240015,0,5,80294,80,264,0.9996459808413162,0.9980995708440068,0.9989459717520429,0.9988721773220247,0.9983121311679616,240015,85,80558,457
12,6,safari,None,125,0.8,240015,457,240015,0,5,80294,80,264,0.9996459808413162,0.9980995708440068,0.9989459717520429,0.9988721773220247,0.9983121311679616,240015,85,80558,457
12,6,giraffe,None,125,0.95,285032,552,285032,0,6,95212,94,311,0.9996492852433259,0.9980671186060843,0.998954226493626,0.9988575753965194,0.9982896431597531,285032,100,95523,552
12,6,safari,None,125,0.95,285032,552,285032,0,6,95212,94,311,0.9996492852433259,0.9980671186060843,0.998954226493626,0.9988575753965194,0.9982896431597531,285032,100,95523,552
12,6,giraffe,None,125,0.9,270021,522,270021,0,5,90233,92,298,0.9996408976817539,0.9980705470110112,0.9989296906033456,0.9988551051398196,0.9982861303925288,270021,97,90531,522
12,6,safari,None,125,0.9,270021,522,270021,0,5,90233,92,298,0.9996408976817539,0.9980705470110112,0.9989296906033456,0.9988551051398196,0.9982861303925288,270021,97,90531,522
12,6,giraffe,Single-stranded,125,0.15,44867,94,44867,0,0,14958,12,48,0.9997326143630652,0.9979092991703922,0.9992009588493808,0.9988201246660731,0.9982327147835076,44867,12,15006,94
12,6,safari,Single-stranded,125,0.15,44867,94,44867,0,0,14958,12,48,0.9997326143630652,0.9979092991703922,0.9992009588493808,0.9988201246660731,0.9982327147835076,44867,12,15006,94
12,6,giraffe,Single-stranded,125,0.1,29888,67,29888,0,0,10014,7,26,0.9997658471316274,0.9977633116341178,0.9993032746093361,0.998763575605681,0.9981500924953752,29888,7,10040,67
12,6,safari,Single-stranded,125,0.1,29888,67,29888,0,0,10014,7,26,0.9997658471316274,0.9977633116341178,0.9993032746093361,0.998763575605681,0.9981500924953752,29888,7,10040,67
12,6,giraffe,Single-stranded,125,0.25,74846,154,74846,0,0,24987,23,85,0.9996927967516596,0.9979466666666666,0.9990834827654911,0.9988189685658808,0.9982316799040911,74846,23,25072,154
12,6,safari,Single-stranded,125,0.25,74846,154,74846,0,0,24987,23,85,0.9996927967516596,0.9979466666666666,0.9990834827654911,0.9988189685658808,0.9982316799040911,74846,23,25072,154
12,6,giraffe,Single-stranded,125,0.2,59882,111,59882,0,0,19911,18,67,0.9996994991652755,0.9981497841414831,0.9990998199639928,0.998924040602871,0.9983872782507595,59882,18,19978,111
12,6,safari,Single-stranded,125,0.2,59882,111,59882,0,0,19911,18,67,0.9996994991652755,0.9981497841414831,0.9990998199639928,0.998924040602871,0.9983872782507595,59882,18,19978,111
12,6,giraffe,Single-stranded,125,0.35,104737,209,104737,0,2,35008,34,115,0.9996564000267244,0.9980084996093229,0.9989760800932905,0.998831770130508,0.9982513115163627,104737,36,35123,209
12,6,safari,Single-stranded,125,0.35,104737,209,104737,0,2,35008,34,115,0.9996564000267244,0.9980084996093229,0.9989760800932905,0.998831770130508,0.9982513115163627,104737,36,35123,209
12,6,giraffe,Single-stranded,125,0.3,89613,187,89613,0,1,29884,29,105,0.9996653391787423,0.9979175946547885,0.9990006329324761,0.9987907023400188,0.9981889349769235,89613,30,29989,187
12,6,safari,Single-stranded,125,0.3,89613,187,89613,0,1,29884,29,105,0.9996653391787423,0.9979175946547885,0.9990006329324761,0.9987907023400188,0.9981889349769235,89613,30,29989,187
12,6,giraffe,Single-stranded,125,0.45,135091,254,135091,1,3,45252,43,142,0.9996596046974552,0.9981159398873997,0.998987676056338,0.9988871759038461,0.9983350480678813,135091,46,45394,255
12,6,safari,Single-stranded,125,0.45,135091,254,135091,1,3,45252,43,142,0.9996596046974552,0.9981159398873997,0.998987676056338,0.9988871759038461,0.9983350480678813,135091,46,45394,255
12,6,giraffe,Single-stranded,125,0.4,119711,234,119711,0,3,40039,38,127,0.9996576257599038,0.9980491058401767,0.9989802770661825,0.9988527182234237,0.9982828812628003,119711,41,40166,234
12,6,safari,Single-stranded,125,0.4,119711,234,119711,0,3,40039,38,127,0.9996576257599038,0.9980491058401767,0.9989802770661825,0.9988527182234237,0.9982828812628003,119711,41,40166,234
12,6,giraffe,Single-stranded,125,0.55,165113,318,165113,2,3,55336,56,168,0.999642796599908,0.9980656821794927,0.9989381422889333,0.9988536168539496,0.9982850368332459,165113,59,55504,320
12,6,safari,Single-stranded,125,0.55,165113,318,165113,2,3,55336,56,168,0.999642796599908,0.9980656821794927,0.9989381422889333,0.9988536168539496,0.9982850368332459,165113,59,55504,320
12,6,giraffe,Single-stranded,125,0.5,150181,283,150181,1,3,50378,52,157,0.9996339093160095,0.9981125178612966,0.9989128286222574,0.998872634277904,0.9983138942080525,150181,55,50535,284
12,6,safari,Single-stranded,125,0.5,150181,283,150181,1,3,50378,52,157,0.9996339093160095,0.9981125178612966,0.9989128286222574,0.998872634277904,0.9983138942080525,150181,55,50535,284
12,6,giraffe,Single-stranded,125,0.65,195313,379,195313,2,3,65460,65,210,0.999651962063865,0.9980530828742833,0.9989655906781466,0.9988518826312089,0.9982825361853178,195313,68,65670,381
12,6,safari,Single-stranded,125,0.65,195313,379,195313,2,3,65460,65,210,0.999651962063865,0.9980530828742833,0.9989655906781466,0.9988518826312089,0.9982825361853178,195313,68,65670,381
12,6,giraffe,Single-stranded,125,0.6,180212,348,180212,2,3,60356,59,186,0.9996560790796233,0.9980616076472347,0.9989769652168173,0.9988582070525114,0.9982916331489513,180212,62,60542,350
12,6,safari,Single-stranded,125,0.6,180212,348,180212,2,3,60356,59,186,0.9996560790796233,0.9980616076472347,0.9989769652168173,0.9988582070525114,0.9982916331489513,180212,62,60542,350
12,6,giraffe,Single-stranded,125,0.75,225114,450,225114,2,4,75410,75,245,0.9996491898060774,0.9979961519023257,0.9989568753796182,0.9988219869154026,0.9982376369067375,225114,79,75655,452
12,6,safari,Single-stranded,125,0.75,225114,450,225114,2,4,75410,75,245,0.9996491898060774,0.9979961519023257,0.9989568753796182,0.9988219869154026,0.9982376369067375,225114,79,75655,452
12,6,giraffe,Single-stranded,125,0.7,210295,413,210295,2,3,70487,71,226,0.9996482371452068,0.9980304684163068,0.9989546103098026,0.9988386977265549,0.9982628589292248,210295,74,70713,415
12,6,safari,Single-stranded,125,0.7,210295,413,210295,2,3,70487,71,226,0.9996482371452068,0.9980304684163068,0.9989546103098026,0.9988386977265549,0.9982628589292248,210295,74,70713,415
12,6,giraffe,Single-stranded,125,0.85,255141,499,255141,3,5,85287,88,285,0.9996356284820987,0.9980363240925822,0.9989143757660655,0.998835336098513,0.9982567065524395,255141,93,85572,502
12,6,safari,Single-stranded,125,0.85,255141,499,255141,3,5,85287,88,285,0.9996356284820987,0.9980363240925822,0.9989143757660655,0.998835336098513,0.9982567065524395,255141,93,85572,502
12,6,giraffe,Single-stranded,125,0.8,239998,470,239998,3,5,80295,79,265,0.9996501195424896,0.9980330268514707,0.998958385000744,0.9988409186915908,0.9982654189309126,239998,84,80560,473
12,6,safari,Single-stranded,125,0.8,239998,470,239998,3,5,80295,79,265,0.9996501195424896,0.9980330268514707,0.998958385000744,0.9988409186915908,0.9982654189309126,239998,84,80560,473
12,6,giraffe,Single-stranded,125,0.95,285025,554,285025,3,6,95213,93,312,0.9996527826489527,0.998049596963394,0.9989646950556346,0.9988505465160695,0.9982791456587776,285025,99,95525,557
12,6,safari,Single-stranded,125,0.95,285025,554,285025,3,6,95213,93,312,0.9996527826489527,0.998049596963394,0.9989646950556346,0.9988505465160695,0.9982791456587776,285025,99,95525,557
12,6,giraffe,Single-stranded,125,0.9,270008,530,270008,3,5,90234,91,299,0.9996445813464443,0.9980298734757393,0.9989407364088757,0.9988365748319137,0.9982584378547499,270008,96,90533,533
12,6,safari,Single-stranded,125,0.9,270008,530,270008,3,5,90234,91,299,0.9996445813464443,0.9980298734757393,0.9989407364088757,0.9988365748319137,0.9982584378547499,270008,96,90533,533
15,10,giraffe,High,125,0.15,42656,89,42656,2215,0,14956,8,52,0.9998124882805175,0.9487544483985765,0.9994672349493873,0.97361453483064,0.9614512471655329,42656,8,15008,2304
15,10,safari,High,125,0.15,42719,89,42719,2152,0,14956,8,52,0.9998127647623283,0.950155693950178,0.9994672349493873,0.9743519563903429,0.9625016673336001,42719,8,15008,2241
15,10,giraffe,High,125,0.1,28438,56,28438,1460,0,10014,5,28,0.9998242098231551,0.9493890632302865,0.9995023390066686,0.9739541414798707,0.961975950601235,28438,5,10042,1516
15,10,safari,High,125,0.1,28479,56,28479,1419,0,10014,5,28,0.9998244628563404,0.9507578286706283,0.9995023390066686,0.9746740134843767,0.9630009249768756,28479,5,10042,1475
15,10,giraffe,High,125,0.25,71118,151,71118,3730,0,24986,14,94,0.9998031828150481,0.9482526433685783,0.9994420977126006,0.9733458335329259,0.9610861898434456,71118,14,25080,3881
15,10,safari,High,125,0.25,71219,151,71219,3629,0,24986,14,94,0.9998034618786237,0.9495993279910399,0.9994420977126006,0.9740549264182943,0.9620952514161829,71219,14,25080,3780
15,10,giraffe,High,125,0.2,56932,119,56932,2941,0,19910,10,75,0.9998243827052088,0.9489931990932124,0.9994998749687422,0.9737458737407426,0.9616187630489954,56932,10,19985,3060
15,10,safari,High,125,0.2,57016,119,57016,2857,0,19910,10,75,0.999824641391646,0.9503933857847713,0.9994998749687422,0.9744825582389035,0.9626689337017266,57016,10,19985,2976
15,10,giraffe,High,125,0.35,99595,209,99595,5140,0,35010,21,128,0.9997891904914873,0.9490299588351883,0.9994027133877528,0.9737485334376222,0.9616710562942977,99595,21,35138,5349
15,10,safari,High,125,0.35,99724,209,99724,5011,0,35010,21,128,0.999789463130984,0.9502591858515017,0.9994027133877528,0.9743953021412973,0.9625918074559431,99724,21,35138,5220
15,10,giraffe,High,125,0.3,85171,184,85171,4444,0,29885,17,117,0.9998004413767198,0.9484626777581042,0.9994336919950698,0.9734551709555566,0.9612328698526098,85171,17,30002,4628
15,10,safari,High,125,0.3,85287,184,85287,4328,0,29885,17,117,0.9998007127450061,0.9497544516085925,0.9994336919950698,0.9741352232685905,0.962201004857367,85287,17,30002,4512
15,10,giraffe,High,125,0.45,128394,267,128394,6683,0,45255,27,158,0.9997897540121943,0.948649367537534,0.999405809859155,0.973548423786325,0.9614069829188424,128394,27,45413,6950
15,10,safari,High,125,0.45,128560,267,128560,6517,0,45255,27,158,0.9997900254302534,0.9498758718524648,0.999405809859155,0.9741940128291106,0.9623252057704221,128560,27,45413,6784
15,10,giraffe,High,125,0.4,113804,235,113804,5904,0,40042,25,140,0.9997803723128552,0.948817354910249,0.9993782177232821,0.9736324281778826,0.9615110833593506,113804,25,40182,6139
15,10,safari,High,125,0.4,113956,235,113956,5752,0,40042,25,140,0.9997806651985858,0.9500846235295098,0.9993782177232821,0.9742993450864383,0.9624601935685295,113956,25,40182,5987
15,10,giraffe,High,125,0.55,156929,322,156929,8182,0,55338,32,192,0.9997961277005116,0.9485955039200159,0.9994240668082502,0.973523080454351,0.9613746917351071,156929,32,55530,8504
15,10,safari,High,125,0.55,157132,323,157132,7978,0,55338,32,192,0.9997963910310249,0.9498225867874004,0.9994240668082502,0.9741690096312117,0.9622932645534967,157132,32,55530,8301
15,10,giraffe,High,125,0.5,142734,293,142734,7436,0,50381,32,177,0.999775856996764,0.9486318895675349,0.999367463925677,0.9735326314927923,0.9613982382754797,142734,32,50558,7729
15,10,safari,High,125,0.5,142918,293,142918,7252,0,50381,32,177,0.9997761455054215,0.9498547815742077,0.999367463925677,0.9741763316553801,0.9623134198445186,142918,32,50558,7545
15,10,giraffe,High,125,0.65,185658,386,185658,9649,0,65462,36,239,0.9998061326698763,0.9487207002805415,0.9994523632048922,0.9735937512290666,0.9614772596871055,185658,36,65701,10035
15,10,safari,High,125,0.65,185899,387,185899,9407,0,65462,36,239,0.9998063839513809,0.9499522210809789,0.9994523632048922,0.9742419319337156,0.9623991125731554,185899,36,65701,9794
15,10,giraffe,High,125,0.6,171268,361,171268,8932,0,60358,33,212,0.9998073566412339,0.9485326288622682,0.9994554725013614,0.9734952907674032,0.9613292199499096,171268,33,60570,9293
15,10,safari,High,125,0.6,171487,362,171487,8712,0,60358,33,212,0.9998076026119403,0.9497455153659982,0.9994554725013614,0.9741337930760251,0.9622373156855916,171487,33,60570,9074
15,10,giraffe,High,125,0.75,214060,432,214060,11075,0,75413,38,282,0.999822511186466,0.9489863322205819,0.9994982372281568,0.9737413712713089,0.9616827082641886,214060,38,75695,11507
15,10,safari,High,125,0.75,214334,433,214334,10800,0,75413,38,282,0.9998227380441476,0.9502010489122966,0.9994982372281568,0.9743805391201962,0.9625921008961168,214334,38,75695,11233
15,10,giraffe,High,125,0.7,199919,406,199919,10386,0,70489,37,260,0.999814959291044,0.9487829301745044,0.9994772977707457,0.9736307032218318,0.9615306735062896,199919,37,70749,10792
15,10,safari,High,125,0.7,200180,407,200180,10124,0,70489,37,260,0.9998152005074494,0.9500215935570521,0.9994772977707457,0.974282599384807,0.9624578592311819,200180,37,70749,10531
15,10,giraffe,High,125,0.85,242607,491,242607,12548,0,85287,48,325,0.9998021882920195,0.9489958771113179,0.9994396451085688,0.9737367575019917,0.961656109180618,242607,48,85612,13039
15,10,safari,High,125,0.85,242907,492,242907,12247,0,85287,48,325,0.9998024325492375,0.950169374838644,0.9994396451085688,0.9743542431723963,0.962535085817419,242907,48,85612,12739
15,10,giraffe,High,125,0.8,228210,459,228210,11805,0,80297,42,302,0.9998159928500079,0.9490007235709473,0.9994791731253333,0.9737458557878164,0.9616772807249739,228210,42,80599,12264
15,10,safari,High,125,0.8,228504,460,228504,11510,0,80297,42,302,0.9998162295555381,0.9502233089647946,0.9994791731253333,0.9743891518485354,0.9625928405711349,228504,42,80599,11970
15,10,giraffe,High,125,0.95,270998,561,270998,14027,0,95215,49,356,0.9998192195449498,0.9489190646600324,0.9994875549048317,0.9737043976911178,0.9616034375114767,270998,49,95571,14588
15,10,safari,High,125,0.95,271326,562,271326,13698,0,95215,49,356,0.9998194380469829,0.9500675803435743,0.9994875549048317,0.9743087936139155,0.9624638646820879,271326,49,95571,14260
15,10,giraffe,High,125,0.9,256730,531,256730,13284,0,90235,49,341,0.9998091744262576,0.9489364061431554,0.9994593103448276,0.9737087634926535,0.9616136445441205,256730,49,90576,13815
15,10,safari,High,125,0.9,257044,532,257044,12969,0,90235,49,341,0.9998094074906746,0.9500970263726921,0.9994593103448276,0.9743195145156338,0.9624830412271229,257044,49,90576,13501
15,10,giraffe,Mid,125,0.15,44791,86,44791,82,0,14956,9,58,0.9997991071428571,0.9962632620832313,0.999400918591493,0.9980280528972024,0.9970491147344204,44791,9,15014,168
15,10,safari,Mid,125,0.15,44791,86,44791,82,0,14956,9,58,0.9997991071428571,0.9962632620832313,0.999400918591493,0.9980280528972024,0.9970491147344204,44791,9,15014,168
15,10,giraffe,Mid,125,0.1,29841,61,29841,51,0,10014,8,38,0.9997319843210828,0.9962608086001402,0.9992047713717693,0.997993378147888,0.9970009746832279,29841,8,10052,112
15,10,safari,Mid,125,0.1,29841,61,29841,51,0,10014,8,38,0.9997319843210828,0.9962608086001402,0.9992047713717693,0.997993378147888,0.9970009746832279,29841,8,10052,112
15,10,giraffe,Mid,125,0.25,74707,150,74707,140,0,24986,18,95,0.9997591167614587,0.9961331786604798,0.999282839953783,0.9979428540895794,0.9969229539641944,74707,18,25081,290
15,10,safari,Mid,125,0.25,74709,150,74709,138,0,24986,18,95,0.9997591232084788,0.9961598463938558,0.999282839953783,0.9979562394806445,0.9969429347826086,74709,18,25081,288
15,10,giraffe,Mid,125,0.2,59764,114,59764,112,0,19910,12,79,0.9997992505353319,0.9962327054509085,0.9994000299985001,0.9980127916103068,0.9970246652748435,59764,12,19989,226
15,10,safari,Mid,125,0.2,59764,114,59764,112,0,19910,12,79,0.9997992505353319,0.9962327054509085,0.9994000299985001,0.9980127916103068,0.9970246652748435,59764,12,19989,226
15,10,giraffe,Mid,125,0.35,104543,200,104543,200,1,35009,23,131,0.9997704820832576,0.9961884070400122,0.99931748379024,0.9979762302515394,0.9969737414975697,104543,24,35140,400
15,10,safari,Mid,125,0.35,104545,200,104545,198,1,35009,23,131,0.9997704864730466,0.9962074650048122,0.99931748379024,0.9979857955630227,0.9969880163018264,104545,24,35140,398
15,10,giraffe,Mid,125,0.3,89451,180,89451,166,0,29885,22,115,0.9997541157667676,0.9961468645945856,0.9992672040503631,0.9979472304345401,0.9969287007903588,89451,22,30000,346
15,10,safari,Mid,125,0.3,89453,180,89453,164,0,29885,22,115,0.9997541212629226,0.9961691370535763,0.9992672040503631,0.9979584095675844,0.9969453926338895,89453,22,30000,344
15,10,giraffe,Mid,125,0.45,134809,269,134809,264,2,45255,30,166,0.9997626834568121,0.9960618285528513,0.9992959760631861,0.9979088247595149,0.9968749135761498,134809,32,45421,533
15,10,safari,Mid,125,0.45,134813,269,134813,260,2,45255,30,166,0.999762690496496,0.9960913833104283,0.9992959760631861,0.9979236602797321,0.9968970380818054,134813,32,45421,529
15,10,giraffe,Mid,125,0.4,119469,236,119469,236,2,40040,25,149,0.9997740510142599,0.9960647318264814,0.9993286254227173,0.9979159444864412,0.9968843072734879,119469,27,40189,472
15,10,safari,Mid,125,0.4,119472,236,119472,233,2,40040,25,149,0.9997740566866669,0.9960897441241944,0.9993286254227173,0.9979284998329436,0.9969030388930862,119472,27,40189,469
15,10,giraffe,Mid,125,0.55,164758,331,164758,342,2,55338,35,204,0.9997754786249583,0.9959318386517642,0.9993342809334461,0.9978499573019689,0.9967874756798335,164758,37,55542,673
15,10,safari,Mid,125,0.55,164763,331,164763,337,2,55338,35,204,0.9997754854368932,0.9959620627331033,0.9993342809334461,0.9978651307720959,0.9968100990905389,164763,37,55542,668
15,10,giraffe,Mid,125,0.5,149864,294,149864,303,2,50381,33,187,0.9997665094496961,0.9960321943892437,0.9993083414026837,0.9978958583033694,0.9968567222376955,149864,35,50568,597
15,10,safari,Mid,125,0.5,149869,294,149869,298,2,50381,33,187,0.9997665172376988,0.9960654255920138,0.9993083414026837,0.9979125397433123,0.9968815899415112,149869,35,50568,592
15,10,giraffe,Mid,125,0.65,194900,388,194900,405,2,65460,42,245,0.9997742941562705,0.9959477344616312,0.9993307883009628,0.9978573458223364,0.9967985251030821,194900,44,65705,793
15,10,safari,Mid,125,0.65,194905,388,194905,400,2,65460,42,245,0.9997742999451138,0.9959732846857067,0.9993307883009628,0.9978701726900846,0.9968176498037806,194905,44,65705,788
15,10,giraffe,Mid,125,0.6,179832,357,179832,371,2,60358,38,222,0.9997776196406334,0.9959680992467878,0.999340151765094,0.9978692235983487,0.9968156563562485,179832,40,60580,728
15,10,safari,Mid,125,0.6,179837,357,179837,366,2,60358,38,222,0.9997776258220895,0.9959957908728401,0.999340151765094,0.9978831252063467,0.9968363877601791,179837,40,60580,723
15,10,giraffe,Mid,125,0.75,224642,443,224642,477,2,75411,49,280,0.9997730236366954,0.9959212988003299,0.9993266615616171,0.9978434442704689,0.9967773411571038,224642,51,75691,920
15,10,safari,Mid,125,0.75,224648,443,224648,471,2,75411,49,280,0.9997730296975065,0.995947899025545,0.9993266615616171,0.9978567986123603,0.9967972546000053,224648,51,75691,914
15,10,giraffe,Mid,125,0.7,209845,421,209845,440,2,70487,44,262,0.999780838625763,0.9959137376249371,0.9993502365986299,0.9978435414422833,0.9967779865790886,209845,46,70749,861
15,10,safari,Mid,125,0.7,209851,421,209851,434,2,70487,44,262,0.9997808448905892,0.9959422133209306,0.9993502365986299,0.9978578374381543,0.996799300890583,209851,46,70749,855
15,10,giraffe,Mid,125,0.85,254593,495,254593,550,3,85284,53,309,0.9997800894564676,0.9959121883288087,0.9993461686651333,0.9978423906546708,0.9967739761549663,254593,56,85593,1045
15,10,safari,Mid,125,0.85,254600,495,254600,543,3,85284,53,309,0.9997800955013822,0.9959395707993335,0.9993461686651333,0.9978561378342681,0.9967944867516196,254600,56,85593,1038
15,10,giraffe,Mid,125,0.8,239490,466,239490,512,3,80294,50,298,0.9997787453609581,0.9959329307849694,0.9993427986855974,0.9978521325552957,0.9967892922429176,239490,53,80592,978
15,10,safari,Mid,125,0.8,239496,466,239496,506,3,80294,50,298,0.999778750902738,0.9959578821298468,0.9993427986855974,0.9978646589599951,0.9968079772541131,239496,53,80592,972
15,10,giraffe,Mid,125,0.95,284410,554,284410,613,3,95210,58,343,0.9997855668943407,0.9959135364542663,0.9993620181145021,0.9978457954417873,0.996778517855878,284410,61,95553,1167
15,10,safari,Mid,125,0.95,284417,554,284417,606,3,95210,58,343,0.999785572170783,0.9959380482321756,0.9993620181145021,0.9978581014112673,0.9967968813534422,284417,61,95553,1160
15,10,giraffe,Mid,125,0.9,269425,530,269425,581,3,90232,56,327,0.9997810630686794,0.9958933376704024,0.9993489152265554,0.997833413577275,0.9967603847666092,269425,59,90559,1111
15,10,safari,Mid,125,0.9,269432,530,269432,574,3,90232,56,327,0.9997810687555428,0.9959192122305349,0.9993489152265554,0.9978464039760975,0.9967797670799714,269432,59,90559,1104
15,10,giraffe,None,125,0.15,44875,81,44875,5,0,14958,10,50,0.9997772084215216,0.9980872311558907,0.999334132374484,0.9989315050197004,0.9983994398039314,44875,10,15008,86
15,10,safari,None,125,0.15,44875,81,44875,5,0,14958,10,50,0.9997772084215216,0.9980872311558907,0.999334132374484,0.9989315050197004,0.9983994398039314,44875,10,15008,86
15,10,giraffe,None,125,0.1,29902,50,29902,3,0,10014,7,26,0.9997659567354308,0.9982306793523619,0.9993032746093361,0.9989977281838834,0.9985000749962502,29902,7,10040,53
15,10,safari,None,125,0.1,29902,50,29902,3,0,10014,7,26,0.9997659567354308,0.9982306793523619,0.9993032746093361,0.9989977281838834,0.9985000749962502,29902,7,10040,53
15,10,giraffe,None,125,0.25,74858,136,74858,6,0,24988,17,91,0.9997729549248748,0.9981066666666667,0.9993226012113484,0.9989391159299417,0.9984115249360613,74858,17,25079,142
15,10,safari,None,125,0.25,74858,136,74858,6,0,24988,17,91,0.9997729549248748,0.9981066666666667,0.9993226012113484,0.9989391159299417,0.9984115249360613,74858,17,25079,142
15,10,giraffe,None,125,0.2,59880,107,59880,6,0,19912,13,72,0.9997829462541532,0.9981164469188072,0.9993499024853728,0.9989490015514739,0.9984248031003875,59880,13,19984,113
15,10,safari,None,125,0.2,59880,107,59880,6,0,19912,13,72,0.9997829462541532,0.9981164469188072,0.9993499024853728,0.9989490015514739,0.9984248031003875,59880,13,19984,113
15,10,giraffe,None,125,0.35,104746,194,104746,6,0,35012,26,123,0.9997518420952163,0.998094257999352,0.9992605443531185,0.9989223624104752,0.9983869471189877,104746,26,35135,200
15,10,safari,None,125,0.35,104746,194,104746,6,0,35012,26,123,0.9997518420952163,0.998094257999352,0.9992605443531185,0.9989223624104752,0.9983869471189877,104746,26,35135,200
15,10,giraffe,None,125,0.3,89627,167,89627,6,0,29887,21,113,0.9997657504908085,0.9980734966592427,0.9993004896572399,0.9989189068699568,0.9983809182029861,89627,21,30000,173
15,10,safari,None,125,0.3,89627,167,89627,6,0,29887,21,113,0.9997657504908085,0.9980734966592427,0.9993004896572399,0.9989189068699568,0.9983809182029861,89627,21,30000,173
15,10,giraffe,None,125,0.45,135080,257,135080,9,1,45256,33,152,0.9997483606436046,0.9980346667060719,0.9992517934950046,0.9988907786733714,0.9983405978272895,135080,34,45408,266
15,10,safari,None,125,0.45,135080,257,135080,9,1,45256,33,152,0.9997483606436046,0.9980346667060719,0.9992517934950046,0.9988907786733714,0.9983405978272895,135080,34,45408,266
15,10,giraffe,None,125,0.4,119719,218,119719,8,0,40044,30,135,0.9997494759872734,0.99811580307641,0.9992538983809595,0.9989319715971197,0.9984015385191753,119719,30,40179,226
15,10,safari,None,125,0.4,119719,218,119719,8,0,40044,30,135,0.9997494759872734,0.99811580307641,0.9992538983809595,0.9989319715971197,0.9984015385191753,119719,30,40179,226
15,10,giraffe,None,125,0.55,165104,317,165104,14,1,55339,41,183,0.9997456795804924,0.9979992141928854,0.999244114894536,0.9988716834905816,0.9983122095575093,165104,42,55522,331
15,10,safari,None,125,0.55,165104,317,165104,14,1,55339,41,183,0.9997456795804924,0.9979992141928854,0.999244114894536,0.9988716834905816,0.9983122095575093,165104,42,55522,331
15,10,giraffe,None,125,0.5,150170,285,150170,10,1,50382,39,170,0.9997337061447307,0.9980394111587413,0.9992093611638204,0.9988858401928994,0.9983338058361559,150170,40,50552,295
15,10,safari,None,125,0.5,150170,285,150170,10,1,50382,39,170,0.9997337061447307,0.9980394111587413,0.9992093611638204,0.9988858401928994,0.9983338058361559,150170,40,50552,295
15,10,giraffe,None,125,0.65,195290,388,195290,17,1,65463,47,228,0.999754272082237,0.9979304530008432,0.9992698398211107,0.9988415299987469,0.998267249095374,195290,48,65691,405
15,10,safari,None,125,0.65,195290,388,195290,17,1,65463,47,228,0.999754272082237,0.9979304530008432,0.9992698398211107,0.9988415299987469,0.998267249095374,195290,48,65691,405
15,10,giraffe,None,125,0.6,180196,351,180196,16,1,60359,43,202,0.9997558810474922,0.9979674684182253,0.9992739872947777,0.9988608742166779,0.9982957938034897,180196,44,60561,367
15,10,safari,None,125,0.6,180196,351,180196,16,1,60359,43,202,0.9997558810474922,0.9979674684182253,0.9992739872947777,0.9988608742166779,0.9982957938034897,180196,44,60561,367
15,10,giraffe,None,125,0.75,225114,432,225114,21,1,75414,53,267,0.9997601790662972,0.9979917275133331,0.9992869875222816,0.9988751705547606,0.9983173029053906,225114,54,75681,453
15,10,safari,None,125,0.75,225114,432,225114,21,1,75414,53,267,0.9997601790662972,0.9979917275133331,0.9992869875222816,0.9988751705547606,0.9983173029053906,225114,54,75681,453
15,10,giraffe,None,125,0.7,210280,413,210280,18,1,70490,51,246,0.9997527718083792,0.9979545443759462,0.9992654122167599,0.9988528487589153,0.99828418573423,210280,52,70736,431
15,10,safari,None,125,0.7,210280,413,210280,18,1,70490,51,246,0.9997527718083792,0.9979545443759462,0.9992654122167599,0.9988528487589153,0.99828418573423,210280,52,70736,431
15,10,giraffe,None,125,0.85,255135,484,255135,25,2,85289,63,310,0.9997452978056426,0.9980089499460186,0.9992412215166231,0.9988763693025658,0.998318234556471,255135,65,85599,509
15,10,safari,None,125,0.85,255135,484,255135,25,2,85289,63,310,0.9997452978056426,0.9980089499460186,0.9992412215166231,0.9988763693025658,0.998318234556471,255135,65,85599,509
15,10,giraffe,None,125,0.8,239993,456,239993,23,1,80298,57,287,0.9997583846765895,0.9980080841012675,0.9992807807249234,0.9988824676446288,0.9983277019136446,239993,58,80585,479
15,10,safari,None,125,0.8,239993,456,239993,23,1,80298,57,287,0.9997583846765895,0.9980080841012675,0.9992807807249234,0.9988824676446288,0.9983277019136446,239993,58,80585,479
15,10,giraffe,None,125,0.95,285004,551,285004,29,2,95216,65,340,0.9997649708318279,0.9979690738976974,0.9992993317507294,0.9988662151387442,0.9983027593931906,285004,67,95556,580
15,10,safari,None,125,0.95,285004,551,285004,29,2,95216,65,340,0.9997649708318279,0.9979690738976974,0.9992993317507294,0.9988662151387442,0.9983027593931906,285004,67,95556,580
15,10,giraffe,None,125,0.9,269995,521,269995,27,2,90236,65,325,0.9997519088209375,0.9979744439885712,0.999260714128084,0.99886238566051,0.9982972054788452,269995,67,90561,548
15,10,safari,None,125,0.9,269995,521,269995,27,2,90236,65,325,0.9997519088209375,0.9979744439885712,0.999260714128084,0.99886238566051,0.9982972054788452,269995,67,90561,548
15,10,giraffe,Single-stranded,125,0.15,44848,94,44848,19,0,14958,10,50,0.9997770743234206,0.9974867107048331,0.999334132374484,0.9986305792760997,0.9979492822487871,44848,10,15008,113
15,10,safari,Single-stranded,125,0.15,44848,94,44848,19,0,14958,10,50,0.9997770743234206,0.9974867107048331,0.999334132374484,0.9986305792760997,0.9979492822487871,44848,10,15008,113
15,10,giraffe,Single-stranded,125,0.1,29875,67,29875,13,0,10014,7,26,0.9997657452647079,0.9973293273243198,0.9993032746093361,0.9985460501027793,0.9978251087445628,29875,7,10040,80
15,10,safari,Single-stranded,125,0.1,29875,67,29875,13,0,10014,7,26,0.9997657452647079,0.9973293273243198,0.9993032746093361,0.9985460501027793,0.9978251087445628,29875,7,10040,80
15,10,giraffe,Single-stranded,125,0.25,74817,154,74817,29,0,24987,17,91,0.9997728305315765,0.99756,0.9993225742179717,0.9986651894763539,0.9980018981967131,74817,17,25078,183
15,10,safari,Single-stranded,125,0.25,74817,154,74817,29,0,24987,17,91,0.9997728305315765,0.99756,0.9993225742179717,0.9986651894763539,0.9980018981967131,74817,17,25078,183
15,10,giraffe,Single-stranded,125,0.2,59861,111,59861,21,0,19911,13,72,0.9997828773758226,0.9977997433033854,0.9993498699739948,0.9987903259445886,0.9981872507469777,59861,13,19983,132
15,10,safari,Single-stranded,125,0.2,59861,111,59861,21,0,19911,13,72,0.9997828773758226,0.9977997433033854,0.9993498699739948,0.9987903259445886,0.9981872507469777,59861,13,19983,132
15,10,giraffe,Single-stranded,125,0.35,104700,208,104700,38,1,35009,26,123,0.9997421868286115,0.997655937339203,0.9992320600699679,0.9986979725572678,0.9980514614039471,104700,27,35132,246
15,10,safari,Single-stranded,125,0.35,104700,208,104700,38,1,35009,26,123,0.9997421868286115,0.997655937339203,0.9992320600699679,0.9986979725572678,0.9980514614039471,104700,27,35132,246
15,10,giraffe,Single-stranded,125,0.3,89579,187,89579,34,0,29885,21,113,0.999765625,0.9975389755011136,0.9993004430527332,0.9986510590858417,0.9979802869327903,89579,21,29998,221
15,10,safari,Single-stranded,125,0.3,89579,187,89579,34,0,29885,21,113,0.999765625,0.9975389755011136,0.9993004430527332,0.9986510590858417,0.9979802869327903,89579,21,29998,221
15,10,giraffe,Single-stranded,125,0.45,135047,253,135047,46,1,45254,33,152,0.9997482991686469,0.9977908471620883,0.9992517605633803,0.9987686140806946,0.9981580432113106,135047,34,45406,299
15,10,safari,Single-stranded,125,0.45,135047,253,135047,46,1,45254,33,152,0.9997482991686469,0.9977908471620883,0.9992517605633803,0.9987686140806946,0.9981580432113106,135047,34,45406,299
15,10,giraffe,Single-stranded,125,0.4,119669,233,119669,43,1,40041,30,135,0.9997410192147034,0.9976989453499521,0.9992289899768697,0.9987189384297607,0.9980830710824716,119669,31,40176,276
15,10,safari,Single-stranded,125,0.4,119669,233,119669,43,1,40041,30,135,0.9997410192147034,0.9976989453499521,0.9992289899768697,0.9987189384297607,0.9980830710824716,119669,31,40176,276
15,10,giraffe,Single-stranded,125,0.55,165049,317,165049,67,1,55338,41,183,0.9997455948537474,0.9976788186153911,0.9992441012904271,0.9987111374665681,0.9980723633006933,165049,42,55521,384
15,10,safari,Single-stranded,125,0.55,165049,317,165049,67,1,55338,41,183,0.9997455948537474,0.9976788186153911,0.9992441012904271,0.9987111374665681,0.9980723633006933,165049,42,55521,384
15,10,giraffe,Single-stranded,125,0.5,150127,282,150127,56,1,50380,39,170,0.9997336298920535,0.9977536304123883,0.9992093299070962,0.9987426488198196,0.9981199174355276,150127,40,50550,338
15,10,safari,Single-stranded,125,0.5,150127,282,150127,56,1,50380,39,170,0.9997336298920535,0.9977536304123883,0.9992093299070962,0.9987426488198196,0.9981199174355276,150127,40,50550,338
15,10,giraffe,Single-stranded,125,0.65,195235,378,195235,81,1,65462,47,228,0.9997542028748022,0.9976545014154752,0.9992698287139858,0.9987032485286859,0.9980606811713945,195235,48,65690,459
15,10,safari,Single-stranded,125,0.65,195235,378,195235,81,1,65462,47,228,0.9997542028748022,0.9976545014154752,0.9992698287139858,0.9987032485286859,0.9980606811713945,195235,48,65690,459
15,10,giraffe,Single-stranded,125,0.6,180143,347,180143,72,1,60358,43,202,0.9997558092426202,0.9976794674405467,0.9992739753151607,0.9987165591588612,0.9980801605533118,180143,44,60560,419
15,10,safari,Single-stranded,125,0.6,180143,347,180143,72,1,60358,43,202,0.9997558092426202,0.9976794674405467,0.9992739753151607,0.9987165591588612,0.9980801605533118,180143,44,60560,419
15,10,giraffe,Single-stranded,125,0.75,225025,449,225025,92,1,75413,53,267,0.9997600842370901,0.997601588891943,0.999286978107587,0.9986796702504188,0.9980252240292068,225025,54,75680,541
15,10,safari,Single-stranded,125,0.75,225025,449,225025,92,1,75413,53,267,0.9997600842370901,0.997601588891943,0.999286978107587,0.9986796702504188,0.9980252240292068,225025,54,75680,541
15,10,giraffe,Single-stranded,125,0.7,210214,412,210214,84,1,70489,51,246,0.9997526942063862,0.9976460538180437,0.9992654018393208,0.9986982630838813,0.998053265221299,210214,52,70735,496
15,10,safari,Single-stranded,125,0.7,210214,412,210214,84,1,70489,51,246,0.9997526942063862,0.9976460538180437,0.9992654018393208,0.9986982630838813,0.998053265221299,210214,52,70735,496
15,10,giraffe,Single-stranded,125,0.85,255040,498,255040,105,1,85291,63,310,0.9997491219267436,0.9976412418881018,0.9992529037529913,0.9986940696665864,0.9980457533957598,255040,64,85601,603
15,10,safari,Single-stranded,125,0.85,255040,498,255040,105,1,85291,63,310,0.9997491219267436,0.9976412418881018,0.9992529037529913,0.9986940696665864,0.9980457533957598,255040,64,85601,603
15,10,giraffe,Single-stranded,125,0.8,239901,469,239901,101,1,80299,57,287,0.9997582920415571,0.9976296518083262,0.9992807896433709,0.9986928376662572,0.9980443143422139,239901,58,80586,570
15,10,safari,Single-stranded,125,0.8,239901,469,239901,101,1,80299,57,287,0.9997582920415571,0.9976296518083262,0.9992807896433709,0.9986928376662572,0.9980443143422139,239901,58,80586,570
15,10,giraffe,Single-stranded,125,0.95,284907,553,284907,122,2,95217,65,340,0.999764890832146,0.9976364056558187,0.9992993390780557,0.9986995141581194,0.9980535458518491,284907,67,95557,675
15,10,safari,Single-stranded,125,0.95,284907,553,284907,122,2,95217,65,340,0.999764890832146,0.9976364056558187,0.9992993390780557,0.9986995141581194,0.9980535458518491,284907,67,95557,675
15,10,giraffe,Single-stranded,125,0.9,269895,529,269895,117,1,90238,65,325,0.9997555202418127,0.9976121918674065,0.9992717562811021,0.9986827060769432,0.9980286291773957,269895,66,90563,646
15,10,safari,Single-stranded,125,0.9,269895,529,269895,117,1,90238,65,325,0.9997555202418127,0.9976121918674065,0.9992717562811021,0.9986827060769432,0.9980286291773957,269895,66,90563,646
15,5,giraffe,High,125,0.15,43884,89,43884,987,0,14956,10,50,0.9997721784298538,0.976067615658363,0.9993340436867342,0.9877777027483288,0.9818927571028412,43884,10,15006,1076
15,5,safari,High,125,0.15,43963,89,43963,908,0,14956,10,50,0.9997725877242853,0.9778247330960854,0.9993340436867342,0.9886768691037072,0.9832099506469254,43963,10,15006,997
15,5,giraffe,High,125,0.1,29248,54,29248,652,0,10014,6,27,0.9997948998427566,0.9764305268077719,0.9994028068080024,0.9879745980272935,0.9822004449888753,29248,6,10041,706
15,5,safari,High,125,0.1,29290,54,29290,610,0,10014,6,27,0.999795193883124,0.9778326767710489,0.9994028068080024,0.9886919831223628,0.9832504187395316,29290,6,10041,664
15,5,giraffe,High,125,0.25,73194,154,73194,1651,1,24985,17,91,0.9997541386657925,0.9759330124401658,0.9992826970590579,0.9876999682884536,0.9817869381475228,73194,18,25076,1805
15,5,safari,High,125,0.25,73323,154,73323,1522,1,24985,17,91,0.99975457111302,0.977653035373805,0.9992826970590579,0.9885802885263584,0.9830757395622072,73323,18,25076,1676
15,5,giraffe,High,125,0.2,58579,121,58579,1292,0,19910,13,72,0.9997781267067176,0.9764468595812775,0.9993498374593648,0.9879747689401606,0.9821721029667321,58579,13,19982,1413
15,5,safari,High,125,0.2,58678,121,58678,1193,0,19910,13,72,0.9997785009626688,0.9780970796106148,0.9993498374593648,0.988818954694438,0.9834098040931651,58678,13,19982,1314
15,5,giraffe,High,125,0.35,102488,212,102488,2244,1,35009,25,124,0.9997463761047272,0.9765970422320476,0.9992605022895987,0.9880361326147944,0.9822844621457071,102488,26,35133,2456
15,5,safari,High,125,0.35,102663,212,102663,2069,1,35009,25,124,0.9997468083241633,0.9782645982619301,0.9992605022895987,0.988889049428559,0.9835335431789469,102663,26,35133,2281
15,5,giraffe,High,125,0.3,87650,188,87650,1961,1,29884,20,114,0.9997604681137434,0.976068775821557,0.9993004430527332,0.9877725812813433,0.9818891986179038,87650,21,29998,2149
15,5,safari,High,125,0.3,87804,188,87804,1807,1,29884,20,114,0.9997608881298036,0.977783716967895,0.9993004430527332,0.9886501824077828,0.9831744812966332,87804,21,29998,1995
15,5,giraffe,High,125,0.45,132201,273,132201,2870,1,45254,32,153,0.9997504423975679,0.9767776923986287,0.9992737676056338,0.9881305637982196,0.982432073634835,132201,33,45407,3143
15,5,safari,High,125,0.45,132420,273,132420,2651,1,45254,33,152,0.999743307110393,0.9783957914647121,0.9992517605633803,0.988954361122936,0.9836379325604035,132420,34,45406,2924
15,5,giraffe,High,125,0.4,117168,239,117168,2536,1,40041,29,136,0.999744022935545,0.9768640104049423,0.9992538612679385,0.9881715941148936,0.9824851701529815,117168,30,40177,2775
15,5,safari,High,125,0.4,117364,239,117364,2340,1,40041,29,136,0.9997444503126225,0.978498119940305,0.9992538612679385,0.9890071923046133,0.9837090227911333,117364,30,40177,2579
15,5,giraffe,High,125,0.55,161591,330,161591,3512,1,55337,40,184,0.9997463373589388,0.9767760966675331,0.9992620855980706,0.988127742191919,0.9824294667300165,161591,41,55521,3842
15,5,safari,High,125,0.55,161854,330,161854,3249,1,55337,41,183,0.99974057419578,0.9783658641262626,0.9992440876858284,0.9889377354282693,0.9836150139143419,161854,42,55520,3579
15,5,giraffe,High,125,0.5,146969,300,146969,3194,1,50380,38,171,0.9997347083151937,0.9767783441776383,0.9992290966594188,0.9881232120105826,0.982427519111876,146969,39,50551,3494
15,5,safari,High,125,0.5,147206,300,147206,2957,1,50380,39,170,0.9997283457615147,0.9783534822514505,0.9992093299070962,0.9889254271788893,0.983601338950426,147206,40,50550,3257
15,5,giraffe,High,125,0.65,191139,395,191139,4159,1,65461,45,230,0.9997593953500536,0.9767288559120664,0.9993002418729179,0.988109946804936,0.982404467735149,191139,46,65691,4554
15,5,safari,High,125,0.65,191446,395,191446,3852,1,65461,46,229,0.9997545602189114,0.9782976396702999,0.9992850297397204,0.9889097229755208,0.9835749531423326,191446,47,65690,4247
15,5,giraffe,High,125,0.6,176354,370,176354,3837,1,60357,41,204,0.9997618993627974,0.9767003948804005,0.9993069650017326,0.9880966054734883,0.982381284105422,176354,42,60561,4207
15,5,safari,High,125,0.6,176642,370,176642,3549,1,60357,42,203,0.999756629029063,0.9782954237072236,0.9992904641684405,0.9889096029066805,0.9835713456403111,176642,43,60560,3919
15,5,giraffe,High,125,0.75,220350,442,220350,4775,1,75412,49,271,0.9997731397459165,0.976871616858849,0.9993397858265222,0.9881897091040368,0.9825190839694656,220350,50,75683,5217
15,5,safari,High,125,0.75,220697,442,220697,4428,1,75412,50,270,0.9997689673292623,0.9784099624501811,0.9993265815430525,0.9889741550250384,0.983667441088616,220697,51,75682,4870
15,5,giraffe,High,125,0.7,205805,414,205805,4492,1,70488,47,250,0.9997668238986073,0.9767169250774758,0.9993218998106971,0.9881074696805294,0.9824012334056846,205805,48,70738,4906
15,5,safari,High,125,0.7,206140,414,206140,4157,1,70488,48,249,0.9997623539568066,0.9783067803769143,0.9993077727234199,0.9889182058047493,0.9835877469386886,206140,49,70737,4571
15,5,giraffe,High,125,0.85,249710,504,249710,5432,1,85286,62,311,0.9997477709760463,0.9767803916353082,0.9992645342049965,0.988130640122354,0.9824233971861028,249710,63,85597,5936
15,5,safari,High,125,0.85,250097,504,250097,5045,1,85286,63,310,0.999744164757896,0.9782942037035588,0.9992528601447583,0.9889028819292734,0.9835543471254534,250097,64,85596,5549
15,5,giraffe,High,125,0.8,234899,469,234899,5106,1,80296,54,290,0.9997659116252543,0.9768166205078304,0.9993179648069841,0.9881580386514888,0.9824673403609299,234899,55,80586,5575
15,5,safari,High,125,0.8,235268,469,235268,4737,1,80296,55,289,0.9997620302221618,0.9783510899307202,0.999305564167111,0.988940684912505,0.9836133472431995,235268,56,80585,5206
15,5,giraffe,High,125,0.95,278962,576,278962,6048,1,95214,64,341,0.9997670476333832,0.9768055857079829,0.9993202258941644,0.9881529472399679,0.9824530568773839,278962,65,95555,6624
15,5,safari,High,125,0.95,279394,576,279394,5616,1,95214,65,340,0.999763830244042,0.9783182649009405,0.9993097678309977,0.9889247955033749,0.9835836791655955,279394,66,95554,6192
15,5,giraffe,High,125,0.9,264263,546,264263,5736,1,90234,64,326,0.9997540933991101,0.976780202923728,0.9992827586206896,0.9881336317219227,0.9824265581305203,264263,65,90560,6282
15,5,safari,High,125,0.9,264671,546,264671,5328,1,90234,65,325,0.99975069597374,0.9782882699735719,0.9992717241379311,0.9889030454975134,0.9835534512833292,264671,66,90559,5874
15,5,giraffe,Mid,125,0.15,44861,86,44861,12,1,14955,11,56,0.9997325786107459,0.9978202362152183,0.9992012247886574,0.9987754920295663,0.9981661165016171,44861,12,15011,98
15,5,safari,Mid,125,0.15,44862,86,44862,11,1,14955,11,56,0.9997325845701297,0.9978424787028182,0.9992012247886574,0.9987866374272262,0.9981827881697842,44862,12,15011,97
15,5,giraffe,Mid,125,0.1,29886,61,29886,6,0,10014,9,37,0.9996989463120923,0.9977631622875839,0.9991053677932406,0.9987301162946131,0.9981006172993777,29886,9,10051,67
15,5,safari,Mid,125,0.1,29886,61,29886,6,0,10014,9,37,0.9996989463120923,0.9977631622875839,0.9991053677932406,0.9987301162946131,0.9981006172993777,29886,9,10051,67
15,5,giraffe,Mid,125,0.25,74828,150,74828,19,2,24984,23,90,0.9996660120502853,0.9977465765297279,0.9990039443802542,0.9987053720387054,0.9980618606138107,74828,25,25074,169
15,5,safari,Mid,125,0.25,74830,150,74830,17,2,24984,23,90,0.9996660209738828,0.9977732442631039,0.9990039443802542,0.9987187358193418,0.9980818414322251,74830,25,25074,167
15,5,giraffe,Mid,125,0.2,59861,114,59861,15,1,19909,17,74,0.9996993937774512,0.9978496416069345,0.9991000449977501,0.9987736612468611,0.9981622932579916,59861,18,19983,129
15,5,safari,Mid,125,0.2,59862,114,59862,14,1,19909,17,74,0.9996993987975952,0.997866311051842,0.9991000449977501,0.9987820138483356,0.9981747946643997,59862,18,19983,128
15,5,giraffe,Mid,125,0.35,104721,200,104721,22,3,35007,29,125,0.999694519488702,0.9978845659072068,0.9990899783869867,0.9987887227224173,0.9981870998593931,104721,32,35132,222
15,5,safari,Mid,125,0.35,104723,200,104723,20,3,35007,29,125,0.999694525320987,0.9979036238720067,0.9990899783869867,0.9987982718003987,0.9982013746636499,104723,32,35132,220
15,5,giraffe,Mid,125,0.3,89596,180,89596,21,2,29883,28,109,0.9996652757012474,0.9977616178714211,0.9990007327959496,0.9987125396409602,0.9980720920722089,89596,30,29992,201
15,5,safari,Mid,125,0.3,89598,180,89598,19,2,29883,28,109,0.9996652831704378,0.9977838903304119,0.9990007327959496,0.9987237007106033,0.9980887839157395,89598,30,29992,199
15,5,giraffe,Mid,125,0.45,135041,269,135041,32,4,45253,37,159,0.999696480656194,0.9977760044923232,0.9990979693309573,0.9987353193503536,0.9981083547664482,135041,41,45412,301
15,5,safari,Mid,125,0.45,135044,269,135044,29,4,45253,37,159,0.9996964873968243,0.997798170560506,0.9990979693309573,0.9987464269470134,0.9981249481456899,135044,41,45412,298
15,5,giraffe,Mid,125,0.4,119678,236,119678,27,4,40038,32,142,0.9996992832918455,0.9978072552338233,0.9991048338969565,0.9987523732031461,0.9981330819133725,119678,36,40180,263
15,5,safari,Mid,125,0.4,119681,236,119681,24,4,40038,32,142,0.999699290827535,0.9978322675315363,0.9991048338969565,0.9987649066586551,0.9981518135329708,119681,36,40180,260
15,5,giraffe,Mid,125,0.55,165062,332,165062,37,4,55336,46,193,0.9996971752507389,0.9977694627971783,0.999100379639792,0.9987323888268698,0.9981041581828877,165062,50,55529,369
15,5,safari,Mid,125,0.55,165065,332,165065,34,4,55336,46,193,0.9996971807528087,0.9977875972459818,0.999100379639792,0.9987414762241867,0.9981177322293109,165065,50,55529,366
15,5,giraffe,Mid,125,0.5,150133,294,150133,34,4,50379,42,178,0.9996936988527024,0.9978200330982779,0.9990909629863842,0.9987559872272486,0.9981398957545856,150133,46,50557,328
15,5,safari,Mid,125,0.5,150136,294,150136,31,4,50379,42,178,0.9996937049713015,0.99783997181994,0.9990909629863842,0.9987659782532772,0.998154816376875,150136,46,50557,325
15,5,giraffe,Mid,125,0.65,195256,389,195256,48,4,65458,55,232,0.9996979238665745,0.9977669104158043,0.9991026479490183,0.9987314837548081,0.9981028296907153,195256,59,65690,437
15,5,safari,Mid,125,0.65,195259,389,195259,45,4,65458,56,231,0.9996928102232757,0.9977822405502497,0.9990874385922219,0.9987366116640921,0.9981104795709947,195259,60,65689,434
15,5,giraffe,Mid,125,0.6,180159,358,180159,43,4,60356,50,210,0.9997003545804132,0.997779131590607,0.9991092048828769,0.9987388191466656,0.9981134422423087,180159,54,60566,401
15,5,safari,Mid,125,0.6,180162,358,180162,40,4,60356,50,210,0.9997003595685178,0.9977957465662384,0.9991092048828769,0.9987471450429076,0.998125881084667,180162,54,60566,398
15,5,giraffe,Mid,125,0.75,225056,444,225056,62,4,75409,62,267,0.9997068256323238,0.9977567143401814,0.9991286208444456,0.9987308180454598,0.998101585110055,225056,66,75676,506
15,5,safari,Mid,125,0.75,225061,444,225061,57,4,75409,63,266,0.9997023915283749,0.9977788811945274,0.9991154181299675,0.9987397102221038,0.998114860738656,225061,67,75675,501
15,5,giraffe,Mid,125,0.7,210228,422,210228,56,4,70485,57,249,0.9997099230107138,0.9977314362191869,0.9991383572286179,0.9987196997589045,0.9980852643507483,210228,61,70734,478
15,5,safari,Mid,125,0.7,210233,422,210233,51,4,70485,58,248,0.9997051760621983,0.9977551659658481,0.9991242319372837,0.9987292191705007,0.9980994738917446,210233,62,70733,473
15,5,giraffe,Mid,125,0.85,255071,496,255071,71,5,85282,66,296,0.999721723589217,0.9977820198874972,0.9991710352718653,0.9987509299502721,0.9981306056193174,255071,71,85578,567
15,5,safari,Mid,125,0.85,255077,496,255077,65,5,85282,67,295,0.9997178119451772,0.9978054905765184,0.9991593597123142,0.9987607358840378,0.9981452560454983,255077,72,85577,561
15,5,giraffe,Mid,125,0.8,239934,467,239934,67,5,80292,63,285,0.9997166690277581,0.9977793303059035,0.9991567983135966,0.9987470601702501,0.9981252705433913,239934,68,80577,534
15,5,safari,Mid,125,0.8,239939,467,239939,62,5,80292,64,284,0.9997125095830139,0.9978001230933013,0.9991443982887965,0.9987554008941133,0.9981377272175216,239939,69,80576,529
15,5,giraffe,Mid,125,0.95,284943,555,284943,79,5,95208,71,330,0.999733351109926,0.9977799332579305,0.9992051373229862,0.9987556870360115,0.9981374166756298,284943,76,95538,634
15,5,safari,Mid,125,0.95,284949,555,284949,73,5,95208,72,329,0.999729849206739,0.9978009433532813,0.9991946786035518,0.9987644649607521,0.9981505334596043,284949,77,95537,628
15,5,giraffe,Mid,125,0.9,269929,531,269929,76,5,90230,69,314,0.9997259289711595,0.9977563059999408,0.9991833851994085,0.9987401464094172,0.9981143778000521,269929,74,90544,607
15,5,safari,Mid,125,0.9,269935,531,269935,70,5,90230,70,313,0.999722232509907,0.9977784841943401,0.9991723498642654,0.9987494126309324,0.9981282223095964,269935,75,90543,601
15,5,giraffe,None,125,0.15,44879,82,44879,0,0,14958,12,48,0.9997326858390323,0.9981761971486399,0.9992009588493808,0.9989538351956551,0.9984327848080161,44879,12,15006,82
15,5,safari,None,125,0.15,44879,82,44879,0,0,14958,12,48,0.9997326858390323,0.9981761971486399,0.9992009588493808,0.9989538351956551,0.9984327848080161,44879,12,15006,82
15,5,giraffe,None,125,0.1,29905,50,29905,0,0,10014,7,26,0.999765980208612,0.9983308295776999,0.9993032746093361,0.9990478894883659,0.9985750712464376,29905,7,10040,50
15,5,safari,None,125,0.1,29905,50,29905,0,0,10014,7,26,0.999765980208612,0.9983308295776999,0.9993032746093361,0.9990478894883659,0.9985750712464376,29905,7,10040,50
15,5,giraffe,None,125,0.25,74863,137,74863,0,0,24988,20,88,0.9997329166833594,0.9981733333333334,0.9992030602486452,0.9989525162960443,0.9984315057544757,74863,20,25076,137
15,5,safari,None,125,0.25,74863,137,74863,0,0,24988,20,88,0.9997329166833594,0.9981733333333334,0.9992030602486452,0.9989525162960443,0.9984315057544757,74863,20,25076,137
15,5,giraffe,None,125,0.2,59885,108,59885,0,0,19912,16,69,0.9997328926061334,0.9981997899754972,0.9991998799819973,0.9989657530818891,0.9984498062257782,59885,16,19981,108
15,5,safari,None,125,0.2,59885,108,59885,0,0,19912,16,69,0.9997328926061334,0.9981997899754972,0.9991998799819973,0.9989657530818891,0.9984498062257782,59885,16,19981,108
15,5,giraffe,None,125,0.35,104751,195,104751,0,0,35012,31,118,0.9997041476589491,0.9981419015493682,0.9991183413441028,0.9989224137931034,0.9983869471189877,104751,31,35130,195
15,5,safari,None,125,0.35,104751,195,104751,0,0,35012,31,118,0.9997041476589491,0.9981419015493682,0.9991183413441028,0.9989224137931034,0.9983869471189877,104751,31,35130,195
15,5,giraffe,None,125,0.3,89632,168,89632,0,0,29887,25,109,0.9997211595302096,0.9981291759465479,0.9991672495919524,0.9989245334536964,0.9983892639854449,89632,25,29996,168
15,5,safari,None,125,0.3,89632,168,89632,0,0,29887,25,109,0.9997211595302096,0.9981291759465479,0.9991672495919524,0.9989245334536964,0.9983892639854449,89632,25,29996,168
15,5,giraffe,None,125,0.45,135087,258,135087,1,1,45256,38,147,0.9997113804893211,0.9980863860032805,0.999141763126623,0.9988982223668254,0.9983516605084408,135087,39,45403,259
15,5,safari,None,125,0.45,135087,258,135087,1,1,45256,38,147,0.9997113804893211,0.9980863860032805,0.999141763126623,0.9988982223668254,0.9983516605084408,135087,39,45403,259
15,5,giraffe,None,125,0.4,119725,219,119725,1,0,40044,35,130,0.9997077488309953,0.9981658260035849,0.9991295481111194,0.9989361924031622,0.9984077825093348,119725,35,40174,220
15,5,safari,None,125,0.4,119725,219,119725,1,0,40044,35,130,0.9997077488309953,0.9981658260035849,0.9991295481111194,0.9989361924031622,0.9984077825093348,119725,35,40174,220
15,5,giraffe,None,125,0.55,165116,318,165116,1,1,55339,49,175,0.9996972742574137,0.998071750234231,0.9991001367792096,0.9988838509260408,0.9983303091869195,165116,50,55514,319
15,5,safari,None,125,0.55,165116,318,165116,1,1,55339,49,175,0.9996972742574137,0.998071750234231,0.9991001367792096,0.9988838509260408,0.9983303091869195,165116,50,55514,319
15,5,giraffe,None,125,0.5,150178,286,150178,1,1,50382,46,163,0.9996871359627226,0.9980925796696907,0.9990709993674889,0.9988892214573148,0.9983387795500779,150178,47,50545,287
15,5,safari,None,125,0.5,150178,286,150178,1,1,50382,46,163,0.9996871359627226,0.9980925796696907,0.9990709993674889,0.9988892214573148,0.9983387795500779,150178,47,50545,287
15,5,giraffe,None,125,0.65,195305,389,195305,1,1,65463,56,219,0.9997082339451889,0.9980071028897008,0.999132934787569,0.9988569441283496,0.9982901994384816,195305,57,65682,390
15,5,safari,None,125,0.65,195305,389,195305,1,1,65463,56,219,0.9997082339451889,0.9980071028897008,0.999132934787569,0.9988569441283496,0.9982901994384816,195305,57,65682,390
15,5,giraffe,None,125,0.6,180210,352,180210,1,1,60359,51,194,0.9997115309937757,0.998045003682925,0.9991419849847373,0.9988775722303056,0.9983206727260665,180210,52,60553,353
15,5,safari,None,125,0.6,180210,352,180210,1,1,60359,51,194,0.9997115309937757,0.998045003682925,0.9991419849847373,0.9988775722303056,0.9983206727260665,180210,52,60553,353
15,5,giraffe,None,125,0.75,225133,433,225133,1,1,75414,63,257,0.9997158043846055,0.9980759596926856,0.999154948174556,0.9988952090229034,0.9983471732680168,225133,64,75671,434
15,5,safari,None,125,0.75,225133,433,225133,1,1,75414,63,257,0.9997158043846055,0.9980759596926856,0.999154948174556,0.9988952090229034,0.9983471732680168,225133,64,75671,434
15,5,giraffe,None,125,0.7,210296,414,210296,1,1,70490,60,237,0.9997100167809961,0.998030477763382,0.9991382720235068,0.9988695412617439,0.9983090526076469,210296,61,70727,415
15,5,safari,None,125,0.7,210296,414,210296,1,1,70490,60,237,0.9997100167809961,0.998030477763382,0.9991382720235068,0.9988695412617439,0.9983090526076469,210296,61,70727,415
15,5,giraffe,None,125,0.85,255158,485,255158,1,2,85289,75,298,0.999698317237056,0.9980989188089687,0.9991011393350766,0.9988979777990483,0.9983504635109637,255158,77,85587,486
15,5,safari,None,125,0.85,255158,485,255158,1,2,85289,75,298,0.999698317237056,0.9980989188089687,0.9991011393350766,0.9988979777990483,0.9983504635109637,255158,77,85587,486
15,5,giraffe,None,125,0.8,240014,457,240014,1,1,80298,67,277,0.9997167634391583,0.9980954123557004,0.9991567774016343,0.9989054299828947,0.9983619575541473,240014,68,80575,458
15,5,safari,None,125,0.8,240014,457,240014,1,1,80298,67,277,0.9997167634391583,0.9980954123557004,0.9991567774016343,0.9989054299828947,0.9983619575541473,240014,68,80575,458
15,5,giraffe,None,125,0.95,285031,552,285031,1,2,95216,78,327,0.9997194075289975,0.9980636170093563,0.9991633811949008,0.9988908260980034,0.9983394848468156,285031,80,95543,553
15,5,safari,None,125,0.95,285031,552,285031,1,2,95216,78,327,0.9997194075289975,0.9980636170093563,0.9991633811949008,0.9988908260980034,0.9983394848468156,285031,80,95543,553
15,5,giraffe,None,125,0.9,270020,522,270020,1,2,90236,78,312,0.9997038134024435,0.9980668507409174,0.9991172706006973,0.9988846614124294,0.9983304307377946,270020,80,90548,523
15,5,safari,None,125,0.9,270020,522,270020,1,2,90236,78,312,0.9997038134024435,0.9980668507409174,0.9991172706006973,0.9988846614124294,0.9983304307377946,270020,80,90548,523
15,5,giraffe,Single-stranded,125,0.15,44867,94,44867,0,0,14958,12,48,0.9997326143630652,0.9979092991703922,0.9992009588493808,0.9988201246660731,0.9982327147835076,44867,12,15006,94
15,5,safari,Single-stranded,125,0.15,44867,94,44867,0,0,14958,12,48,0.9997326143630652,0.9979092991703922,0.9992009588493808,0.9988201246660731,0.9982327147835076,44867,12,15006,94
15,5,giraffe,Single-stranded,125,0.1,29888,67,29888,0,0,10014,7,26,0.9997658471316274,0.9977633116341178,0.9993032746093361,0.998763575605681,0.9981500924953752,29888,7,10040,67
15,5,safari,Single-stranded,125,0.1,29888,67,29888,0,0,10014,7,26,0.9997658471316274,0.9977633116341178,0.9993032746093361,0.998763575605681,0.9981500924953752,29888,7,10040,67
15,5,giraffe,Single-stranded,125,0.25,74846,154,74846,0,0,24987,20,88,0.9997328560361178,0.9979466666666666,0.9992030284917314,0.9988389628067741,0.9982616514311404,74846,20,25075,154
15,5,safari,Single-stranded,125,0.25,74846,154,74846,0,0,24987,20,88,0.9997328560361178,0.9979466666666666,0.9992030284917314,0.9988389628067741,0.9982616514311404,74846,20,25075,154
15,5,giraffe,Single-stranded,125,0.2,59882,111,59882,0,0,19911,16,69,0.999732879228021,0.9981497841414831,0.9991998399679936,0.9989407044732299,0.9984122816887322,59882,16,19980,111
15,5,safari,Single-stranded,125,0.2,59882,111,59882,0,0,19911,16,69,0.999732879228021,0.9981497841414831,0.9991998399679936,0.9989407044732299,0.9984122816887322,59882,16,19980,111
15,5,giraffe,Single-stranded,125,0.35,104737,209,104737,0,1,35009,30,119,0.9997041081246182,0.9980084996093229,0.9991182911914446,0.9988555842719132,0.9982869990364369,104737,31,35128,209
15,5,safari,Single-stranded,125,0.35,104737,209,104737,0,1,35009,30,119,0.9997041081246182,0.9980084996093229,0.9991182911914446,0.9988555842719132,0.9982869990364369,104737,31,35128,209
15,5,giraffe,Single-stranded,125,0.3,89613,187,89613,0,0,29885,25,109,0.9997211004261586,0.9979175946547885,0.9991671941103968,0.9988185334210145,0.9982306645857502,89613,25,29994,187
15,5,safari,Single-stranded,125,0.3,89613,187,89613,0,0,29885,25,109,0.9997211004261586,0.9979175946547885,0.9991671941103968,0.9988185334210145,0.9982306645857502,89613,25,29994,187
15,5,giraffe,Single-stranded,125,0.45,135092,254,135092,0,1,45254,37,148,0.9997187893139939,0.9981233283584295,0.9991637323943662,0.9989204217749449,0.9983848306837919,135092,38,45402,254
15,5,safari,Single-stranded,125,0.45,135092,254,135092,0,1,45254,37,148,0.9997187893139939,0.9981233283584295,0.9991637323943662,0.9989204217749449,0.9983848306837919,135092,38,45402,254
15,5,giraffe,Single-stranded,125,0.4,119711,234,119711,0,1,40041,34,131,0.9997077146627027,0.9980491058401767,0.9991295048125948,0.9988777217333985,0.998320345671612,119711,35,40172,234
15,5,safari,Single-stranded,125,0.4,119711,234,119711,0,1,40041,34,131,0.9997077146627027,0.9980491058401767,0.9991295048125948,0.9988777217333985,0.998320345671612,119711,35,40172,234
15,5,giraffe,Single-stranded,125,0.55,165114,318,165114,1,1,55338,48,176,0.9997033233835665,0.9980717269226816,0.9991181181721649,0.9988868588851649,0.9983348114898007,165114,49,55514,319
15,5,safari,Single-stranded,125,0.55,165114,318,165114,1,1,55338,48,176,0.9997033233835665,0.9980717269226816,0.9991181181721649,0.9988868588851649,0.9983348114898007,165114,49,55514,319
15,5,giraffe,Single-stranded,125,0.5,150182,283,150182,0,1,50380,45,164,0.9996937987592193,0.9981191639251653,0.9990907293931607,0.9989058607948971,0.9983636318420333,150182,46,50544,283
15,5,safari,Single-stranded,125,0.5,150182,283,150182,0,1,50380,45,164,0.9996937987592193,0.9981191639251653,0.9990907293931607,0.9989058607948971,0.9983636318420333,150182,46,50544,283
15,5,giraffe,Single-stranded,125,0.65,195312,379,195312,3,1,65462,55,220,0.99971336145121,0.9980479728555807,0.9991481334996501,0.9988799729966092,0.9983246121362342,195312,56,65682,382
15,5,safari,Single-stranded,125,0.65,195312,379,195312,3,1,65462,55,220,0.99971336145121,0.9980479728555807,0.9991481334996501,0.9988799729966092,0.9983246121362342,195312,56,65682,382
15,5,giraffe,Single-stranded,125,0.6,180213,348,180213,1,1,60358,50,195,0.9997170816136334,0.9980671459110998,0.9991584713880272,0.9988914324355784,0.9983413914067488,180213,51,60553,349
15,5,safari,Single-stranded,125,0.6,180213,348,180213,1,1,60358,50,195,0.9997170816136334,0.9980671459110998,0.9991584713880272,0.9988914324355784,0.9983413914067488,180213,51,60553,349
15,5,giraffe,Single-stranded,125,0.75,225113,450,225113,3,1,75413,62,258,0.9997202188510321,0.9979917186100742,0.9991681411255182,0.9988552209467945,0.9982874211749088,225113,63,75671,453
15,5,safari,Single-stranded,125,0.75,225113,450,225113,3,1,75413,62,258,0.9997202188510321,0.9979917186100742,0.9991681411255182,0.9988552209467945,0.9982874211749088,225113,63,75671,453
15,5,giraffe,Single-stranded,125,0.7,210294,413,210294,3,1,70489,59,238,0.99971476653641,0.998025722557069,0.9991523867376778,0.9988695305226759,0.9983090405936831,210294,60,70727,416
15,5,safari,Single-stranded,125,0.7,210294,413,210294,3,1,70489,59,238,0.99971476653641,0.998025722557069,0.9991523867376778,0.9988695305226759,0.9983090405936831,210294,60,70727,416
15,5,giraffe,Single-stranded,125,0.85,255141,499,255141,3,1,85291,74,299,0.9997061312770359,0.9980363240925822,0.9991244965855367,0.998870529833085,0.9983094448416093,255141,75,85590,502
15,5,safari,Single-stranded,125,0.85,255141,499,255141,3,1,85291,74,299,0.9997061312770359,0.9980363240925822,0.9991244965855367,0.998870529833085,0.9983094448416093,255141,75,85590,502
15,5,giraffe,Single-stranded,125,0.8,239998,470,239998,3,1,80299,66,278,0.9997209089205007,0.9980330268514707,0.9991691880363077,0.9988762548487523,0.9983183594662348,239998,67,80577,473
15,5,safari,Single-stranded,125,0.8,239998,470,239998,3,1,80299,66,278,0.9997209089205007,0.9980330268514707,0.9991691880363077,0.9988762548487523,0.9983183594662348,239998,67,80577,473
15,5,giraffe,Single-stranded,125,0.95,285024,554,285024,4,2,95217,77,328,0.9997229071598686,0.9980460953421434,0.9991738475696478,0.998883797541551,0.9983289874765875,285024,79,95545,558
15,5,safari,Single-stranded,125,0.95,285024,554,285024,4,2,95217,77,328,0.9997229071598686,0.9980460953421434,0.9991738475696478,0.998883797541551,0.9983289874765875,285024,79,95545,558
15,5,giraffe,Single-stranded,125,0.9,270007,530,270007,4,1,90238,77,313,0.9997112020289909,0.9980261771783204,0.9991393483322115,0.9988679789725246,0.9983055071019188,270007,78,90551,534
15,5,safari,Single-stranded,125,0.9,270007,530,270007,4,1,90238,77,313,0.9997112020289909,0.9980261771783204,0.9991393483322115,0.9988679789725246,0.9983055071019188,270007,78,90551,534
20,10,giraffe,High,125,0.15,38683,68,38683,6209,0,14956,2,58,0.9999483003748223,0.8603870106761566,0.9998668087373468,0.9249327515093551,0.8953081232492998,38683,2,15014,6277
20,10,safari,High,125,0.15,38709,68,38709,6183,0,14956,2,58,0.9999483350985507,0.8609653024911033,0.9998668087373468,0.9252668188500197,0.8957416299853275,38709,2,15014,6251
20,10,giraffe,High,125,0.1,25829,44,25829,4081,0,10014,1,32,0.999961285327139,0.862288842892435,0.9999004678013337,0.9260361393948084,0.8968525786855328,25829,1,10046,4125
20,10,safari,High,125,0.1,25842,44,25842,4068,0,10014,1,32,0.999961304802074,0.8627228416905922,0.9999004678013337,0.9262863594816926,0.897177570560736,25842,1,10046,4112
20,10,giraffe,High,125,0.25,64468,125,64468,10406,0,24986,6,102,0.999906939231318,0.8595847944639262,0.999760899019686,0.9244513274970783,0.8947279030501634,64468,6,25088,10531
20,10,safari,High,125,0.25,64507,125,64507,10367,0,24986,6,102,0.9999069954892812,0.860104801397352,0.999760899019686,0.9247519926601295,0.895117540687161,64507,6,25088,10492
20,10,giraffe,High,125,0.2,51602,95,51602,8295,0,19910,3,82,0.9999418660982463,0.8601480197359648,0.9998499624906226,0.9247918850865167,0.8950704489479541,51602,3,19992,8390
20,10,safari,High,125,0.2,51630,95,51630,8267,0,19910,3,82,0.9999418976236129,0.8606147486331511,0.9998499624906226,0.9250615901455768,0.8954205058321977,51630,3,19992,8362
20,10,giraffe,High,125,0.35,90384,181,90384,14379,0,35010,9,140,0.9999004347681789,0.8612593383137673,0.9997440200233226,0.9254160758074508,0.8960122195813081,90384,9,35150,14560
20,10,safari,High,125,0.35,90451,181,90451,14312,0,35010,9,140,0.9999005085120495,0.8618977740509224,0.9997440200233226,0.9257845284641051,0.8964904391768913,90451,9,35150,14493
20,10,giraffe,High,125,0.3,77262,156,77262,12381,0,29885,8,126,0.999896466934127,0.8603882003140346,0.999733502115327,0.9249112642082014,0.8952995376320753,77262,8,30011,12537
20,10,safari,High,125,0.3,77319,156,77319,12324,0,29885,8,126,0.999896543251387,0.8610229512578091,0.999733502115327,0.9252779340138578,0.8957752591430336,77319,8,30011,12480
20,10,giraffe,High,125,0.45,116618,235,116618,18491,0,45255,14,171,0.9998799643322587,0.8616414469795484,0.9996919014084507,0.9256278375718322,0.896340384104788,116618,14,45426,18726
20,10,safari,High,125,0.45,116712,235,116712,18397,0,45255,14,171,0.9998800609975498,0.8623359735193286,0.9996919014084507,0.9260284841512277,0.8968603416231525,116712,14,45426,18632
20,10,giraffe,High,125,0.4,103341,205,103341,16397,0,40042,12,153,0.9998838930655133,0.861584252519947,0.9997015445071754,0.9255965176268272,0.8962597564783016,103341,12,40195,16602
20,10,safari,High,125,0.4,103422,205,103422,16316,0,40042,12,153,0.9998839839897906,0.8622595732973162,0.9997015445071754,0.9259861131629487,0.8967655323134561,103422,12,40195,16521
20,10,giraffe,High,125,0.55,142489,284,142489,22660,0,55338,18,206,0.9998736904152077,0.8613094122696198,0.9996760375796407,0.9254335260115608,0.8960971967691577,142489,18,55544,22944
20,10,safari,High,125,0.55,142605,284,142605,22544,0,55338,18,206,0.9998737931469679,0.8620106024795536,0.9996760375796407,0.9258381592957124,0.8966220955225231,142605,18,55544,22828
20,10,giraffe,High,125,0.5,129617,260,129617,20586,0,50381,18,191,0.9998611486095577,0.8614543110266312,0.9996441984581933,0.9255117851609079,0.8962263681715766,129617,18,50572,20846
20,10,safari,High,125,0.5,129725,260,129725,20478,0,50381,18,191,0.9998612641915171,0.8621720954653304,0.9996441984581933,0.9259259259259259,0.8967635399620996,129725,18,50572,20738
20,10,giraffe,High,125,0.65,168527,340,168527,26826,0,65462,20,255,0.9998813387363762,0.8611805225531828,0.9996957573360512,0.925362398418625,0.8960104043147306,168527,20,65717,27166
20,10,safari,High,125,0.65,168670,340,168670,26683,0,65462,20,255,0.9998814393265754,0.8619112589617411,0.9996957573360512,0.9257841337274242,0.8965573958612248,168670,20,65717,27023
20,10,giraffe,High,125,0.6,155407,321,155407,24833,0,60358,18,227,0.9998841885153611,0.8606897392017102,0.9997029850007425,0.9250802116754865,0.8956228956228957,155407,18,60585,25154
20,10,safari,High,125,0.6,155540,321,155540,24700,0,60358,18,227,0.9998842875326245,0.8614263323752084,0.9997029850007425,0.9255055501176667,0.8961743875536979,155540,18,60585,25021
20,10,giraffe,High,125,0.75,194211,378,194211,30978,0,75413,21,299,0.9998918818732238,0.8609903044328293,0.9997227100471393,0.9252570873203605,0.8958612678393627,194211,21,75712,31356
20,10,safari,High,125,0.75,194375,378,194375,30814,0,75413,21,299,0.999891973085866,0.861717361138819,0.9997227100471393,0.9256767858120835,0.8964055758380352,194375,21,75712,31192
20,10,giraffe,High,125,0.7,181410,356,181410,28945,0,70489,21,276,0.9998842535178663,0.8609422384213449,0.9997033311671799,0.925226066067904,0.8958354795965854,181410,21,70765,29301
20,10,safari,High,125,0.7,181560,356,181560,28795,0,70489,21,276,0.9998843491334446,0.8616541139285562,0.9997033311671799,0.9256370254810192,0.8963683449557189,181560,21,70765,29151
20,10,giraffe,High,125,0.85,220144,429,220144,35073,0,85287,24,349,0.9998909923331274,0.8611282789482331,0.9997198225542844,0.9253363709348611,0.8959115866700263,220144,24,85636,35502
20,10,safari,High,125,0.85,220326,429,220326,34891,0,85287,24,349,0.9998910823689585,0.8618402009028109,0.9997198225542844,0.9257472751871865,0.8964448324963522,220326,24,85636,35320
20,10,giraffe,High,125,0.8,207065,401,207065,33008,0,80297,22,322,0.9998937644564845,0.8610702196495256,0.9997271859227936,0.9253040367681725,0.8958908802142534,207065,22,80619,33409
20,10,safari,High,125,0.8,207245,401,207245,32828,0,80297,22,322,0.9998938567162163,0.8618187413192279,0.9997271859227936,0.9257360840307232,0.8964514270588418,207245,22,80619,33229
20,10,giraffe,High,125,0.95,245922,496,245922,39168,0,95215,25,380,0.9998983520839856,0.861113640024371,0.9997385484208324,0.9253310706955166,0.89588568910248,245922,25,95595,39664
20,10,safari,High,125,0.95,246120,496,246120,38970,0,95215,25,380,0.9998984338499665,0.8618069513211432,0.9997385484208324,0.9257312438056085,0.8964050933091294,246120,25,95595,39466
20,10,giraffe,High,125,0.9,232977,466,232977,37102,0,90235,25,365,0.9998927047836499,0.8611395516457521,0.9997241379310344,0.9253436124135382,0.8959132818340394,232977,25,90600,37568
20,10,safari,High,125,0.9,233162,466,233162,36917,0,90235,25,365,0.999892789906813,0.8618233565580588,0.9997241379310344,0.9257382894078597,0.8964255059944071,233162,25,90600,37383
20,10,giraffe,Mid,125,0.15,44442,84,44442,433,0,14956,4,63,0.9999100031498898,0.9885006339108966,0.9997337415962191,0.9941725854258711,0.9913140608849321,44442,4,15019,517
20,10,safari,Mid,125,0.15,44442,84,44442,433,0,14956,4,63,0.9999100031498898,0.9885006339108966,0.9997337415962191,0.9941725854258711,0.9913140608849321,44442,4,15019,517
20,10,giraffe,Mid,125,0.1,29612,60,29612,281,0,10014,3,43,0.9998986999831166,0.9886154976129269,0.9997017892644136,0.9942250872951921,0.9914027940919201,29612,3,10057,341
20,10,safari,Mid,125,0.1,29612,60,29612,281,0,10014,3,43,0.9998986999831166,0.9886154976129269,0.9997017892644136,0.9942250872951921,0.9914027940919201,29612,3,10057,341
20,10,giraffe,Mid,125,0.25,74115,142,74115,740,0,24986,14,99,0.9998111400396605,0.9882395295811832,0.9994422088529423,0.9939916580609686,0.9910485933503836,74115,14,25085,882
20,10,safari,Mid,125,0.25,74115,142,74115,740,0,24986,14,99,0.9998111400396605,0.9882395295811832,0.9994422088529423,0.9939916580609686,0.9910485933503836,74115,14,25085,882
20,10,giraffe,Mid,125,0.2,59294,109,59294,587,0,19910,8,83,0.9998650972985734,0.9883980663443908,0.9996000199990001,0.9940985145692922,0.9911990098886124,59294,8,19993,696
20,10,safari,Mid,125,0.2,59294,109,59294,587,0,19910,8,83,0.9998650972985734,0.9883980663443908,0.9996000199990001,0.9940985145692922,0.9911990098886124,59294,8,19993,696
20,10,giraffe,Mid,125,0.35,103718,187,103718,1038,0,35010,19,135,0.9998168445202772,0.9883269965600373,0.9994596746672734,0.9940387195706344,0.9911210717523036,103718,19,35145,1225
20,10,safari,Mid,125,0.35,103719,187,103719,1037,0,35010,19,135,0.9998168462858354,0.9883365255424373,0.9994596746672734,0.994043540140214,0.991128209154432,103719,19,35145,1224
20,10,giraffe,Mid,125,0.3,88748,167,88748,882,0,29885,18,119,0.9997972196561746,0.9883180952593071,0.9994004396775698,0.9940245179572476,0.9910949014763936,88748,18,30004,1049
20,10,safari,Mid,125,0.3,88748,167,88748,882,0,29885,18,119,0.9997972196561746,0.9883180952593071,0.9994004396775698,0.9940245179572476,0.9910949014763936,88748,18,30004,1049
20,10,giraffe,Mid,125,0.45,133719,253,133719,1370,0,45257,20,176,0.9998504549906908,0.9880081571130913,0.9995599850394914,0.9938940319086076,0.9909123593019719,133719,20,45433,1623
20,10,safari,Mid,125,0.45,133720,253,133720,1369,0,45257,20,176,0.9998504561088679,0.9880155458024855,0.9995599850394914,0.9938977709397134,0.9909178904283857,133720,20,45433,1622
20,10,giraffe,Mid,125,0.4,118513,222,118513,1206,0,40042,20,154,0.9998312706166216,0.9880941462885919,0.9995026854983091,0.9939280592433557,0.9909588716072354,118513,20,40196,1428
20,10,safari,Mid,125,0.4,118514,222,118514,1205,0,40042,20,154,0.9998312720400898,0.9881024837211629,0.9995026854983091,0.9939322780165637,0.9909651154804349,118514,20,40196,1427
20,10,giraffe,Mid,125,0.55,163411,310,163411,1710,0,55340,23,216,0.99985927040885,0.9877894711390247,0.9995861746343043,0.9937877244462013,0.9907560743857744,163411,23,55556,2020
20,10,safari,Mid,125,0.55,163413,310,163413,1708,0,55340,23,216,0.999859272130987,0.9878015607715603,0.9995861746343043,0.9937938437118956,0.9907651237500565,163413,23,55556,2018
20,10,giraffe,Mid,125,0.5,148645,277,148645,1539,0,50383,22,198,0.9998520182690174,0.9879304271538804,0.9995652431674011,0.993855473242224,0.9908586320773485,148645,22,50581,1816
20,10,safari,Mid,125,0.5,148647,277,148647,1537,0,50383,22,198,0.9998520202597717,0.9879437196349885,0.9995652431674011,0.9938622003811052,0.9908685791588748,148647,22,50581,1814
20,10,giraffe,Mid,125,0.65,193302,359,193302,2032,0,65462,27,260,0.9998603416973139,0.9877818828471125,0.9995893473664998,0.9937844132208461,0.9907512947422373,193302,27,65722,2391
20,10,safari,Mid,125,0.65,193304,359,193304,2030,0,65462,27,260,0.9998603431420724,0.9877921029367428,0.9995893473664998,0.9937895862466068,0.9907589446225167,193304,27,65722,2389
20,10,giraffe,Mid,125,0.6,178366,335,178366,1859,0,60360,26,234,0.9998542535539711,0.9878489144882587,0.9995710986473111,0.9938153290690678,0.9907952566547806,178366,26,60594,2194
20,10,safari,Mid,125,0.6,178368,335,178368,1857,0,60360,26,234,0.9998542551879548,0.9878599911386796,0.9995710986473111,0.9938209352730434,0.9908035492163529,178368,26,60594,2192
20,10,giraffe,Mid,125,0.75,222772,407,222772,2383,0,75413,31,298,0.9998608636328954,0.9876308952749133,0.999590715851179,0.9937082510900717,0.9906373629291347,222772,31,75711,2790
20,10,safari,Mid,125,0.75,222774,407,222774,2381,0,75413,31,298,0.9998608648818473,0.9876397620166517,0.999590715851179,0.9937127397868263,0.9906440007434352,222774,31,75711,2788
20,10,giraffe,Mid,125,0.7,208111,389,208111,2206,0,70489,28,278,0.9998654745146273,0.9876842614828244,0.9996044918426442,0.9937375401401473,0.990682093491675,208111,28,70767,2595
20,10,safari,Mid,125,0.7,208113,389,208113,2204,0,70489,28,278,0.9998654758072653,0.9876937533814889,0.9996044918426442,0.9937423450567868,0.9906891982621732,208113,28,70767,2593
20,10,giraffe,Mid,125,0.85,252498,457,252498,2683,0,85287,32,330,0.9998732823822912,0.9877170060789084,0.9996263820943618,0.9937579698052612,0.9907057696308386,252498,32,85617,3140
20,10,safari,Mid,125,0.85,252500,457,252500,2681,0,85287,32,330,0.9998732833858679,0.9877248296419155,0.9996263820943618,0.9937619300627744,0.9907116298013109,252500,32,85617,3138
20,10,giraffe,Mid,125,0.8,237509,430,237509,2529,0,80297,31,317,0.9998694956638882,0.9876948284179184,0.9996155992311985,0.9937448745627688,0.9906886360876078,237509,31,80614,2959
20,10,safari,Mid,125,0.8,237511,430,237511,2527,0,80297,31,317,0.9998694967626778,0.9877031455328775,0.9996155992311985,0.993749084747181,0.9906948644246729,237511,31,80614,2957
20,10,giraffe,Mid,125,0.95,282027,513,282027,3037,0,95213,36,365,0.9998723689388541,0.9875690269174339,0.9996234861003619,0.993682615742372,0.9905926425335331,282027,36,95578,3550
20,10,safari,Mid,125,0.95,282029,513,282029,3035,0,95213,36,365,0.9998723698438303,0.9875760302825508,0.9996234861003619,0.9936861613481738,0.9905978892471229,282029,36,95578,3548
20,10,giraffe,Mid,125,0.9,267183,490,267183,2863,0,90235,34,349,0.9998727625862127,0.9876060856965432,0.9996247986051336,0.9937015693078421,0.9906217292346201,267183,34,90584,3353
20,10,safari,Mid,125,0.9,267185,490,267185,2861,0,90235,34,349,0.9998727635385208,0.9876134784280096,0.9996247986051336,0.9937053118985412,0.9906272670384378,267185,34,90584,3351
20,10,giraffe,None,125,0.15,44840,73,44840,48,0,14958,3,57,0.9999330999264099,0.9973087787193345,0.9998002397123452,0.9986192151797247,0.9979326097467447,44840,3,15015,121
20,10,safari,None,125,0.15,44840,73,44840,48,0,14958,3,57,0.9999330999264099,0.9973087787193345,0.9998002397123452,0.9986192151797247,0.9979326097467447,44840,3,15015,121
20,10,giraffe,None,125,0.1,29876,46,29876,33,0,10014,2,31,0.9999330611152019,0.9973627107327658,0.9998009356026675,0.9986462320124346,0.9979751012449377,29876,2,10045,79
20,10,safari,None,125,0.1,29876,46,29876,33,0,10014,2,31,0.9999330611152019,0.9973627107327658,0.9998009356026675,0.9986462320124346,0.9979751012449377,29876,2,10045,79
20,10,giraffe,None,125,0.25,74806,123,74806,71,0,24988,8,100,0.9998930681423263,0.9974133333333334,0.999681224099458,0.9986516613934612,0.9979819373401535,74806,8,25088,194
20,10,safari,None,125,0.25,74806,123,74806,71,0,24988,8,100,0.9998930681423263,0.9974133333333334,0.999681224099458,0.9986516613934612,0.9979819373401535,74806,8,25088,194
20,10,giraffe,None,125,0.2,59840,97,59840,56,0,19912,4,81,0.9999331595481585,0.9974497024652876,0.9997999699954994,0.9986898870966396,0.9980372546568321,59840,4,19993,153
20,10,safari,None,125,0.2,59840,97,59840,56,0,19912,4,81,0.9999331595481585,0.9974497024652876,0.9997999699954994,0.9986898870966396,0.9980372546568321,59840,4,19993,153
20,10,giraffe,None,125,0.35,104669,178,104669,99,0,35012,13,136,0.999875814371143,0.9973605473291026,0.9996302721765593,0.9986165970194821,0.9979301533827717,104669,13,35148,277
20,10,safari,None,125,0.35,104669,178,104669,99,0,35012,13,136,0.999875814371143,0.9973605473291026,0.9996302721765593,0.9986165970194821,0.9979301533827717,104669,13,35148,277
20,10,giraffe,None,125,0.3,89560,151,89560,89,0,29887,11,123,0.99987719239486,0.9973273942093541,0.999633589820459,0.9986006656594433,0.9979052086028326,89560,11,30010,240
20,10,safari,None,125,0.3,89560,151,89560,89,0,29887,11,123,0.99987719239486,0.9973273942093541,0.999633589820459,0.9986006656594433,0.9979052086028326,89560,11,30010,240
20,10,giraffe,None,125,0.45,134992,239,134992,115,0,45257,20,165,0.9998518650194057,0.997384481255449,0.9995598785264733,0.998616649035723,0.9979312786246874,134992,20,45422,354
20,10,safari,None,125,0.45,134992,239,134992,115,0,45257,20,165,0.9998518650194057,0.997384481255449,0.9995598785264733,0.998616649035723,0.9979312786246874,134992,20,45422,354
20,10,giraffe,None,125,0.4,119638,202,119638,105,0,40044,17,148,0.9998579248673269,0.9974404935595481,0.9995772090825437,0.9986477462437395,0.9979769471883312,119638,17,40192,307
20,10,safari,None,125,0.4,119638,202,119638,105,0,40044,17,148,0.9998579248673269,0.9974404935595481,0.9995772090825437,0.9986477462437395,0.9979769471883312,119638,17,40192,307
20,10,giraffe,None,125,0.55,164998,295,164998,142,0,55340,26,198,0.9998424471592011,0.9973584791609997,0.9995320711251889,0.9985989184740013,0.9979049678957823,164998,26,55538,437
20,10,safari,None,125,0.55,164998,295,164998,142,0,55340,26,198,0.9998424471592011,0.9973584791609997,0.9995320711251889,0.9985989184740013,0.9979049678957823,164998,26,55538,437
20,10,giraffe,None,125,0.5,150074,264,150074,127,0,50383,24,185,0.9998401044650828,0.9974013890273485,0.9995256166982922,0.9986192578594172,0.9979359087224021,150074,24,50568,391
20,10,safari,None,125,0.5,150074,264,150074,127,0,50383,24,185,0.9998401044650828,0.9974013890273485,0.9995256166982922,0.9986192578594172,0.9979359087224021,150074,24,50568,391
20,10,giraffe,None,125,0.65,195161,360,195161,174,0,65464,29,246,0.9998514268148984,0.9972712639566672,0.9995588615585878,0.9985596786778721,0.9978464928050674,195161,29,65710,534
20,10,safari,None,125,0.65,195161,360,195161,174,0,65464,29,246,0.9998514268148984,0.9972712639566672,0.9995588615585878,0.9985596786778721,0.9978464928050674,195161,29,65710,534
20,10,giraffe,None,125,0.6,180076,325,180076,162,0,60360,27,218,0.9998500857842457,0.9973028804350836,0.9995544922036136,0.9985748587335652,0.9978687056325881,180076,27,60578,487
20,10,safari,None,125,0.6,180076,325,180076,162,0,60360,27,218,0.9998500857842457,0.9973028804350836,0.9995544922036136,0.9985748587335652,0.9978687056325881,180076,27,60578,487
20,10,giraffe,None,125,0.75,224966,403,224966,198,0,75415,33,287,0.9998533326814786,0.9973356031689032,0.9995642701525055,0.9985928809541776,0.9978957988994431,224966,33,75702,601
20,10,safari,None,125,0.75,224966,403,224966,198,0,75415,33,287,0.9998533326814786,0.9973356031689032,0.9995642701525055,0.9985928809541776,0.9978957988994431,224966,33,75702,601
20,10,giraffe,None,125,0.7,210141,385,210141,185,0,70491,31,266,0.9998525017604628,0.997294873072597,0.9995620726676838,0.9985720497145287,0.9978650012966298,210141,31,70757,570
20,10,safari,None,125,0.7,210141,385,210141,185,0,70491,31,266,0.9998525017604628,0.997294873072597,0.9995620726676838,0.9985720497145287,0.9978650012966298,210141,31,70757,570
20,10,giraffe,None,125,0.85,254972,453,254972,219,0,85291,38,335,0.9998509862358339,0.9973713445259814,0.9995564064251027,0.9986096260873312,0.9979197674827429,254972,38,85626,672
20,10,safari,None,125,0.85,254972,453,254972,219,0,85291,38,335,0.9998509862358339,0.9973713445259814,0.9995564064251027,0.9986096260873312,0.9979197674827429,254972,38,85626,672
20,10,giraffe,None,125,0.8,239840,426,239840,206,0,80299,35,309,0.9998540906722251,0.9973718353903989,0.9995659883684883,0.9986114204939346,0.9979228625258864,239840,35,80608,632
20,10,safari,None,125,0.8,239840,426,239840,206,0,80299,35,309,0.9998540906722251,0.9973718353903989,0.9995659883684883,0.9986114204939346,0.9979228625258864,239840,35,80608,632
20,10,giraffe,None,125,0.95,284823,516,284823,245,0,95218,40,365,0.999859581623447,0.9973352848899097,0.9995816905974504,0.9985958380007257,0.9978987794033163,284823,40,95583,761
20,10,safari,None,125,0.95,284823,516,284823,245,0,95218,40,365,0.999859581623447,0.9973352848899097,0.9995816905974504,0.9985958380007257,0.9978987794033163,284823,40,95583,761
20,10,giraffe,None,125,0.9,269824,488,269824,231,0,90238,40,350,0.9998517771914742,0.9973423818025231,0.9995586353003487,0.9985955030190208,0.9978985023714528,269824,40,90588,719
20,10,safari,None,125,0.9,269824,488,269824,231,0,90238,40,350,0.9998517771914742,0.9973423818025231,0.9995586353003487,0.9985955030190208,0.9978985023714528,269824,40,90588,719
20,10,giraffe,Single-stranded,125,0.15,44733,87,44733,141,0,14958,3,57,0.9999329399141631,0.9949289384132916,0.9998002397123452,0.9974246630322084,0.9961486520282099,44733,3,15015,228
20,10,safari,Single-stranded,125,0.15,44733,87,44733,141,0,14958,3,57,0.9999329399141631,0.9949289384132916,0.9998002397123452,0.9974246630322084,0.9961486520282099,44733,3,15015,228
20,10,giraffe,Single-stranded,125,0.1,29800,60,29800,95,0,10014,2,31,0.9999328904100396,0.9948255716908696,0.9998009356026675,0.997372692738926,0.996075196240188,29800,2,10045,155
20,10,safari,Single-stranded,125,0.1,29800,60,29800,95,0,10014,2,31,0.9999328904100396,0.9948255716908696,0.9998009356026675,0.997372692738926,0.996075196240188,29800,2,10045,155
20,10,giraffe,Single-stranded,125,0.25,74645,145,74645,210,0,24987,8,100,0.9998928375282976,0.9952666666666666,0.9996812113966925,0.9975743887526479,0.9963734452270343,74645,8,25087,355
20,10,safari,Single-stranded,125,0.25,74645,145,74645,210,0,24987,8,100,0.9998928375282976,0.9952666666666666,0.9996812113966925,0.9975743887526479,0.9963734452270343,74645,8,25087,355
20,10,giraffe,Single-stranded,125,0.2,59723,104,59723,166,0,19911,4,81,0.9999330286135248,0.9954994749387428,0.9997999599919984,0.9977113264283327,0.9965745289977372,59723,4,19992,270
20,10,safari,Single-stranded,125,0.2,59723,104,59723,166,0,19911,4,81,0.9999330286135248,0.9954994749387428,0.9997999599919984,0.9977113264283327,0.9965745289977372,59723,4,19992,270
20,10,giraffe,Single-stranded,125,0.35,104465,193,104465,288,0,35010,13,136,0.999875571890733,0.9954166904884417,0.9996302511447993,0.9976411490564597,0.996474073016666,104465,13,35146,481
20,10,safari,Single-stranded,125,0.35,104465,193,104465,288,0,35010,13,136,0.999875571890733,0.9954166904884417,0.9996302511447993,0.9976411490564597,0.996474073016666,104465,13,35146,481
20,10,giraffe,Single-stranded,125,0.3,89366,176,89366,258,0,29885,11,123,0.9998769258310304,0.9951670378619154,0.9996335654085746,0.9975164223086669,0.9962860648144284,89366,11,30008,434
20,10,safari,Single-stranded,125,0.3,89366,176,89366,258,0,29885,11,123,0.9998769258310304,0.9951670378619154,0.9996335654085746,0.9975164223086669,0.9962860648144284,89366,11,30008,434
20,10,giraffe,Single-stranded,125,0.45,134751,235,134751,360,0,45255,20,165,0.999851600121688,0.995603859737266,0.9995598591549296,0.9977232088317285,0.9965981879127809,134751,20,45420,595
20,10,safari,Single-stranded,125,0.45,134751,235,134751,360,0,45255,20,165,0.999851600121688,0.995603859737266,0.9995598591549296,0.9977232088317285,0.9965981879127809,134751,20,45420,595
20,10,giraffe,Single-stranded,125,0.4,119405,216,119405,324,0,40042,17,148,0.9998576476696086,0.995497936554254,0.9995771880518318,0.9976730292813962,0.9965220540486538,119405,17,40190,540
20,10,safari,Single-stranded,125,0.4,119405,216,119405,324,0,40042,17,148,0.9998576476696086,0.995497936554254,0.9995771880518318,0.9976730292813962,0.9965220540486538,119405,17,40190,540
20,10,giraffe,Single-stranded,125,0.55,164693,297,164693,443,0,55339,26,198,0.9998421554283355,0.9955268900400767,0.9995320627035977,0.997679856550922,0.99653387391627,164693,26,55537,740
20,10,safari,Single-stranded,125,0.55,164693,297,164693,443,0,55339,26,198,0.9998421554283355,0.9955268900400767,0.9995320627035977,0.997679856550922,0.99653387391627,164693,26,55537,740
20,10,giraffe,Single-stranded,125,0.5,149794,262,149794,409,0,50381,24,185,0.9998398056308321,0.9955404911441199,0.9995255979442578,0.9976855166626148,0.9965432344383378,149794,24,50566,671
20,10,safari,Single-stranded,125,0.5,149794,262,149794,409,0,50381,24,185,0.9998398056308321,0.9955404911441199,0.9995255979442578,0.9976855166626148,0.9965432344383378,149794,24,50566,671
20,10,giraffe,Single-stranded,125,0.65,194831,350,194831,513,0,65463,29,246,0.9998511752027096,0.9955900538595971,0.9995588548480331,0.9977160648719511,0.9965880228893172,194831,29,65709,863
20,10,safari,Single-stranded,125,0.65,194831,350,194831,513,0,65463,29,246,0.9998511752027096,0.9955900538595971,0.9995588548480331,0.9977160648719511,0.9965880228893172,194831,29,65709,863
20,10,giraffe,Single-stranded,125,0.6,179767,324,179767,471,0,60359,27,218,0.9998498281366452,0.9955970802272903,0.999554484852485,0.9977189223989611,0.996591559340869,179767,27,60577,795
20,10,safari,Single-stranded,125,0.6,179767,324,179767,471,0,60359,27,218,0.9998498281366452,0.9955970802272903,0.999554484852485,0.9977189223989611,0.996591559340869,179767,27,60577,795
20,10,giraffe,Single-stranded,125,0.75,224557,418,224557,591,0,75414,33,287,0.9998530655861793,0.9955268081182448,0.999564264399081,0.9976852468921885,0.9965416528377032,224557,33,75701,1009
20,10,safari,Single-stranded,125,0.75,224557,418,224557,591,0,75414,33,287,0.9998530655861793,0.9955268081182448,0.999564264399081,0.9976852468921885,0.9965416528377032,224557,33,75701,1009
20,10,giraffe,Single-stranded,125,0.7,209776,383,209776,551,0,70490,31,266,0.9998522451586458,0.9955673674718808,0.9995620664811335,0.9977052057348454,0.9965718995229079,209776,31,70756,934
20,10,safari,Single-stranded,125,0.7,209776,383,209776,551,0,70490,31,266,0.9998522451586458,0.9955673674718808,0.9995620664811335,0.9977052057348454,0.9965718995229079,209776,31,70756,934
20,10,giraffe,Single-stranded,125,0.85,254525,464,254525,654,0,85292,38,335,0.9998507245750561,0.9956267138157509,0.9995564116033386,0.9977342485192255,0.9966130298733109,254525,38,85627,1118
20,10,safari,Single-stranded,125,0.85,254525,464,254525,654,0,85292,38,335,0.9998507245750561,0.9956267138157509,0.9995564116033386,0.9977342485192255,0.9966130298733109,254525,38,85627,1118
20,10,giraffe,Single-stranded,125,0.8,239409,438,239409,624,0,80300,35,309,0.9998538280349476,0.9955836670534077,0.99956599375031,0.9977141785524519,0.9965837783971474,239409,35,80609,1062
20,10,safari,Single-stranded,125,0.8,239409,438,239409,624,0,80300,35,309,0.9998538280349476,0.9955836670534077,0.99956599375031,0.9977141785524519,0.9965837783971474,239409,35,80609,1062
20,10,giraffe,Single-stranded,125,0.95,284330,516,284330,736,0,95219,40,365,0.9998593381861659,0.9956159701941999,0.9995816949719736,0.9977331424400651,0.996610756388934,284330,40,95584,1252
20,10,safari,Single-stranded,125,0.95,284330,516,284330,736,0,95219,40,365,0.9998593381861659,0.9956159701941999,0.9995816949719736,0.9977331424400651,0.996610756388934,284330,40,95584,1252
20,10,giraffe,Single-stranded,125,0.9,269340,493,269340,708,0,90239,40,350,0.9998515108768282,0.9955607467999306,0.9995586401703649,0.997701515592096,0.9965639449566686,269340,40,90589,1201
20,10,safari,Single-stranded,125,0.9,269340,493,269340,708,0,90239,40,350,0.9998515108768282,0.9955607467999306,0.9995586401703649,0.997701515592096,0.9965639449566686,269340,40,90589,1201
20,2,giraffe,High,125,0.15,42091,88,42091,2781,0,14956,3,57,0.9999287309355253,0.9361877224199289,0.9998002131060203,0.9670089829301353,0.9521141790049353,42091,3,15013,2869
20,2,safari,High,125,0.15,42184,88,42184,2688,0,14956,4,56,0.999905186308903,0.9382562277580071,0.9997336174746937,0.9681002432643319,0.9536481259170335,42184,4,15012,2776
20,2,giraffe,High,125,0.1,28068,55,28068,1831,0,10014,2,31,0.9999287495546847,0.9370367897442745,0.9998009356026675,0.9674617399696677,0.9528011799705007,28068,2,10045,1886
20,2,safari,High,125,0.1,28127,55,28127,1772,0,10014,3,30,0.9998933522929258,0.9390064765974494,0.9997014034040012,0.9684939053784174,0.954251143721407,28127,3,10044,1827
20,2,giraffe,High,125,0.25,70171,150,70171,4678,0,24986,9,99,0.9998717583357082,0.9356258083441112,0.999641348529529,0.9666825091783248,0.9516749423036576,70171,9,25085,4828
20,2,safari,High,125,0.25,70327,150,70327,4522,0,24986,10,98,0.9998578273170593,0.9377058360778143,0.9996014983661433,0.9677849947707381,0.953223502143007,70327,10,25084,4672
20,2,giraffe,High,125,0.2,56161,118,56161,3713,0,19910,5,80,0.9999109781718477,0.9361414855314042,0.9997499374843711,0.9669760154272629,0.9520422068586145,56161,5,19990,3831
20,2,safari,High,125,0.2,56281,118,56281,3593,0,19910,6,79,0.999893403450175,0.9381417522336312,0.9996999249812453,0.9680337808202686,0.9535299486166502,56281,6,19989,3711
20,2,giraffe,High,125,0.35,98214,208,98214,6522,0,35010,13,136,0.9998676534964929,0.9358705595365148,0.9996302511447993,0.9668112082925222,0.9518711233877932,98214,13,35146,6730
20,2,safari,High,125,0.35,98497,208,98497,6239,0,35010,14,135,0.999857883891139,0.9385672358591248,0.9996018089251685,0.9682435919490796,0.9538839282527855,98497,14,35145,6447
20,2,giraffe,High,125,0.3,84032,183,84032,5584,0,29885,11,123,0.9998691146198969,0.9357787948640853,0.9996335654085746,0.9667629226539041,0.9517768615733863,84032,11,30008,5767
20,2,safari,High,125,0.3,84251,183,84251,5365,0,29885,12,122,0.9998575887400164,0.9382175748059555,0.9996002531729904,0.968057358872126,0.9535962877030162,84251,12,30007,5548
20,2,giraffe,High,125,0.45,126702,265,126702,8377,0,45255,19,166,0.9998500643145177,0.9361478898214919,0.9995818661971831,0.9669509472840706,0.9520919992919727,126702,19,45421,8642
20,2,safari,High,125,0.45,127091,265,127091,7988,0,45255,20,165,0.9998426572051199,0.939022047523348,0.9995598591549296,0.9684784058219504,0.9542382069209665,127091,20,45420,8253
20,2,giraffe,High,125,0.4,112284,234,112284,7425,0,40042,16,149,0.9998575244879786,0.9361446687176409,0.9996020593429005,0.9669527176276572,0.9520761785825789,112284,16,40191,7659
20,2,safari,High,125,0.4,112620,234,112620,7089,0,40042,17,148,0.9998490726848194,0.9389459993496911,0.9995771880518318,0.9684409665491442,0.9541679675304402,112620,17,40190,7323
20,2,giraffe,High,125,0.55,154902,320,154902,10211,0,55338,23,201,0.9998515410682588,0.9363428094757394,0.9995860480184299,0.9670556065401832,0.9522432634222494,154902,23,55539,10531
20,2,safari,High,125,0.55,155369,320,155369,9744,0,55338,25,199,0.9998391186274889,0.9391657045450424,0.9995500521939455,0.9685531454646898,0.9543473834249644,155369,25,55537,10064
20,2,giraffe,High,125,0.5,140886,291,140886,9286,0,50381,23,186,0.9998367740882413,0.9363498002831261,0.9995453646965804,0.9670524278242246,0.9522513963979647,140886,23,50567,9577
20,2,safari,High,125,0.5,141311,291,141311,8861,0,50381,25,184,0.9998231165449708,0.9391744149724517,0.9995058311919351,0.9685502691921494,0.9543553192441794,141311,25,50565,9152
20,2,giraffe,High,125,0.65,183232,385,183232,12076,0,65462,25,250,0.9998635795631272,0.9363237315591257,0.999619696670064,0.9670510621454018,0.9522396052480587,183232,25,65712,12461
20,2,safari,High,125,0.65,183786,385,183786,11522,0,65462,27,248,0.9998531115862317,0.9391546963866874,0.9995892724036691,0.9685538568560181,0.9543510691198409,183786,27,65710,11907
20,2,giraffe,High,125,0.6,169033,361,169033,11167,0,60358,23,222,0.9998639504069657,0.9361545405707766,0.9996204808342821,0.9669609887391061,0.9521031331376159,169033,23,60580,11528
20,2,safari,High,125,0.6,169533,361,169533,10667,0,60358,25,220,0.9998525578268204,0.9389236878395667,0.999587479167698,0.9684307335505928,0.9541681179612214,169533,25,60578,11028
20,2,giraffe,High,125,0.75,211206,430,211206,13931,0,75413,26,294,0.9998769125890017,0.9363337722273205,0.9996566886297915,0.9670626535317159,0.9522502489213408,211206,26,75707,14361
20,2,safari,High,125,0.75,211845,430,211845,13292,0,75413,29,291,0.9998631261976457,0.9391666334171221,0.9996170757793829,0.9685649036098583,0.9543611018918022,211845,29,75704,13722
20,2,giraffe,High,125,0.7,197286,404,197286,13021,0,70489,26,271,0.9998682289977295,0.9362871421045887,0.9996326957307943,0.9670337211382691,0.9522161870286362,197286,26,70760,13425
20,2,safari,High,125,0.7,197880,404,197880,12427,0,70489,28,269,0.9998585201204601,0.9391061691131455,0.99960444155624,0.9685305871728921,0.9543192289793497,197880,28,70758,12831
20,2,giraffe,High,125,0.85,239368,486,239368,15792,0,85287,32,341,0.9998663324979115,0.9363260133152875,0.9996264300723792,0.9670535667392525,0.9522129701792527,239368,32,85628,16278
20,2,safari,High,125,0.85,240104,486,240104,15056,0,85287,35,338,0.999854251079583,0.9392049944063275,0.9995914078916647,0.9685811390017851,0.9543606030951697,240104,35,85625,15542
20,2,giraffe,High,125,0.8,225158,455,225158,14861,0,80297,29,315,0.9998712181431433,0.9363091228157722,0.9996403814436825,0.9670468430897154,0.9522133814988399,225158,29,80612,15316
20,2,safari,High,125,0.8,225852,455,225852,14167,0,80297,32,312,0.9998583343663119,0.9391950896978467,0.9996031795240634,0.9685777878796975,0.9543652585522321,225852,32,80609,14622
20,2,giraffe,High,125,0.95,267427,557,267427,17602,0,95215,33,372,0.9998766170642339,0.9364149503126904,0.9996548839154988,0.9671058103665879,0.9522777710739075,267427,33,95587,18159
20,2,safari,High,125,0.95,268236,557,268236,16793,0,95215,36,369,0.9998658078368223,0.93924772222728,0.9996235097259988,0.9686092825236794,0.9543921134504704,268236,36,95584,17350
20,2,giraffe,High,125,0.9,253326,527,253326,16692,0,90235,33,357,0.999869750038483,0.9363543957567133,0.9996358620689655,0.9670703029562668,0.9522330204612787,253326,33,90592,17219
20,2,safari,High,125,0.9,254092,527,254092,15926,0,90235,36,354,0.9998583391047031,0.9391857177179397,0.9996027586206897,0.9685728063003052,0.9543455990253897,254092,36,90589,16453
20,2,giraffe,Mid,125,0.15,44770,86,44770,103,0,14956,6,61,0.9998659996426658,0.9957961698436353,0.9996006123943287,0.9978269348637655,0.9967490247074122,44770,6,15017,189
20,2,safari,Mid,125,0.15,44774,86,44774,99,0,14956,6,61,0.9998660116123269,0.9958851397940346,0.9996006123943287,0.997871605433535,0.9968157113800807,44774,6,15017,185
20,2,giraffe,Mid,125,0.1,29822,61,29822,70,0,10014,5,41,0.9998323666476682,0.995626481487664,0.9995029821073559,0.9977249916359986,0.9966011046409917,29822,5,10055,131
20,2,safari,Mid,125,0.1,29824,61,29824,68,0,10014,5,41,0.9998323778872908,0.9956932527626615,0.9995029821073559,0.9977585226322303,0.9966510883962713,29824,5,10055,129
20,2,giraffe,Mid,125,0.25,74680,150,74680,167,0,24986,16,97,0.9997857984363285,0.9957731642599037,0.9993625244033627,0.9977754470816939,0.9966731937340153,74680,16,25083,317
20,2,safari,Mid,125,0.25,74685,150,74685,162,0,24986,16,97,0.9997858127735907,0.9958398335933437,0.9993625244033627,0.9978089219628853,0.9967231457800512,74685,16,25083,312
20,2,giraffe,Mid,125,0.2,59746,114,59746,130,0,19910,10,81,0.9998326527880046,0.9959326554425738,0.99950002499875,0.9978788435521855,0.9968246427723119,59746,10,19991,244
20,2,safari,Mid,125,0.2,59750,114,59750,126,0,19910,10,81,0.9998326639892905,0.9959993332222037,0.99950002499875,0.9979123173277662,0.9968746483979448,59750,10,19991,240
20,2,giraffe,Mid,125,0.35,104514,200,104514,229,0,35010,21,133,0.9997991103458171,0.9959120665504131,0.9994027983164601,0.997851803053304,0.996788169042232,104514,21,35143,429
20,2,safari,Mid,125,0.35,104520,200,104520,223,0,35010,21,133,0.9997991218756277,0.9959692404448129,0.9994027983164601,0.9978805063871226,0.9968309934550023,104520,21,35143,423
20,2,giraffe,Mid,125,0.3,89419,180,89419,198,0,29885,20,117,0.9997763839041134,0.9957905052507322,0.9993338218639665,0.9977794639469749,0.9966783231373989,89419,20,30002,378
20,2,safari,Mid,125,0.3,89424,180,89424,193,0,29885,20,117,0.9997763964044541,0.9958461863982093,0.9993338218639665,0.9978074212931193,0.9967200527462255,89424,20,30002,373
20,2,giraffe,Mid,125,0.45,134763,269,134763,310,0,45257,23,173,0.9998293591322541,0.9957219488407146,0.999493982795415,0.9977714268791091,0.9966702618988357,134763,23,45430,579
20,2,safari,Mid,125,0.45,134770,269,134770,303,0,45257,24,172,0.9998219505319228,0.9957736696664745,0.9994719820473896,0.9977937039121035,0.9967034486573191,134770,24,45429,572
20,2,giraffe,Mid,125,0.4,119436,236,119436,269,0,40042,22,152,0.999815834854091,0.9957895965516379,0.99945295404814,0.9977986541297166,0.996709478823904,119436,22,40194,505
20,2,safari,Mid,125,0.4,119442,236,119442,263,0,40042,23,151,0.9998074749926756,0.9958396211470639,0.9994280883230555,0.9978196035187087,0.9967406981899012,119442,23,40193,499
20,2,giraffe,Mid,125,0.55,164718,331,164718,382,0,55340,26,213,0.9998421793813431,0.9956900460010518,0.9995321974126918,0.9977617929885667,0.9966562598977422,164718,26,55553,713
20,2,safari,Mid,125,0.55,164726,331,164726,374,0,55340,27,212,0.9998361183104405,0.9957384045311942,0.9995142050054877,0.997783054296998,0.9966879326727297,164726,27,55552,705
20,2,giraffe,Mid,125,0.5,149829,294,149829,338,0,50383,25,195,0.999833170953061,0.9957995759698527,0.999505958144774,0.9978122970880575,0.9967323837186169,149829,25,50578,632
20,2,safari,Mid,125,0.5,149837,294,149837,330,0,50383,26,194,0.9998265082108325,0.9958527458942849,0.999486196470565,0.9978356708088597,0.9967671985039589,149837,26,50577,624
20,2,giraffe,Mid,125,0.65,194848,388,194848,457,0,65462,31,256,0.9998409269341488,0.9956820121312464,0.9995285099393146,0.9977571356881703,0.9966493524376343,194848,31,65718,845
20,2,safari,Mid,125,0.65,194860,388,194860,445,0,65462,32,255,0.9998358064979579,0.9957433326690275,0.9995133005825184,0.9977853732222179,0.9966914267791709,194860,32,65717,833
20,2,giraffe,Mid,125,0.6,179790,357,179790,413,0,60360,29,231,0.9998387267196459,0.9957354895879486,0.9995216100296932,0.9977828896800313,0.9966871216518782,179790,29,60591,770
20,2,safari,Mid,125,0.6,179799,357,179799,404,0,60360,30,230,0.9998331748494403,0.9957853345148427,0.9995051138238206,0.9978051494357486,0.9967202918981674,179799,30,60590,761
20,2,giraffe,Mid,125,0.75,224579,443,224579,540,0,75413,35,294,0.9998441771216398,0.9956419964355698,0.9995379049932667,0.9977386622121126,0.9966213525210419,224579,35,75707,983
20,2,safari,Mid,125,0.75,224593,442,224593,527,0,75413,36,293,0.9998397357420458,0.9957040636277387,0.9995247022787885,0.9977676141904214,0.9966644983139952,224593,36,75706,969
20,2,giraffe,Mid,125,0.7,209784,421,209784,501,0,70489,32,274,0.9998474854157929,0.9956242347156702,0.9995479906773077,0.9977313909854896,0.996611024472382,209784,32,70763,922
20,2,safari,Mid,125,0.7,209798,420,209798,488,0,70489,33,273,0.9998427305784179,0.9956906780063216,0.9995338653859736,0.9977623847604373,0.99665720548062,209798,33,70762,908
20,2,giraffe,Mid,125,0.85,254512,495,254512,631,0,85287,38,324,0.999850716951483,0.9955953340270226,0.9995563287370547,0.9977184880867443,0.9965893807850871,254512,38,85611,1126
20,2,safari,Mid,125,0.85,254527,494,254527,617,0,85287,39,323,0.9998467980798693,0.9956540107495756,0.9995446531775035,0.99774599963936,0.9966304019783936,254527,39,85610,1111
20,2,giraffe,Mid,125,0.8,239416,466,239416,586,0,80297,36,312,0.9998496567161685,0.9956251975314803,0.9995535991071982,0.9977329554925821,0.996611784636561,239416,36,80609,1052
20,2,safari,Mid,125,0.8,239431,465,239431,572,0,80297,37,311,0.9998454908380243,0.995687575893674,0.9995411990823981,0.9977622016268834,0.996655382996017,239431,37,80608,1037
20,2,giraffe,Mid,125,0.95,284319,554,284319,704,0,95213,43,358,0.9998487842960733,0.9955948833414455,0.9995502750643211,0.9977172995706557,0.9965870128098512,284319,43,95571,1258
20,2,safari,Mid,125,0.95,284335,553,284335,689,0,95213,44,357,0.9998452769015996,0.9956509102623811,0.9995398163448868,0.9977436854774755,0.9966263631617746,284335,44,95570,1242
20,2,giraffe,Mid,125,0.9,269338,530,269338,668,0,90235,41,342,0.9998477980837408,0.9955717538516131,0.9995475512591318,0.9977051943361456,0.9965693305348965,269338,41,90577,1198
20,2,safari,Mid,125,0.9,269354,529,269354,653,0,90235,42,341,0.999844095680708,0.9956308957033445,0.9995365159239886,0.9977330478652868,0.9966108640635297,269354,42,90576,1182
20,2,giraffe,None,125,0.15,44874,81,44874,6,0,14958,6,54,0.9998663101604278,0.9980649896577033,0.9996004794246903,0.9989648378802551,0.9984494573100585,44874,6,15012,87
20,2,safari,None,125,0.15,44875,80,44875,6,0,14958,6,54,0.9998663131391903,0.9980872311558907,0.9996004794246903,0.9989759800538723,0.9984661298121009,44875,6,15012,86
20,2,giraffe,None,125,0.1,29902,50,29902,3,0,10014,4,29,0.9998662475757373,0.9982306793523619,0.999601871205335,0.9990477940562303,0.9985750712464376,29902,4,10043,53
20,2,safari,None,125,0.1,29902,50,29902,3,0,10014,4,29,0.9998662475757373,0.9982306793523619,0.999601871205335,0.9990477940562303,0.9985750712464376,29902,4,10043,53
20,2,giraffe,None,125,0.25,74857,136,74857,7,0,24988,13,95,0.9998263657005476,0.9980933333333334,0.9994819891616193,0.9989590978848336,0.9984414961636828,74857,13,25083,143
20,2,safari,None,125,0.25,74858,135,74858,7,0,24988,13,95,0.9998263680196605,0.9981066666666667,0.9994819891616193,0.9989657772350888,0.9984514865728901,74858,13,25083,142
20,2,giraffe,None,125,0.2,59879,107,59879,7,0,19912,9,76,0.9998497194763558,0.9980997783074692,0.9995499324898734,0.9989739825326782,0.9984623077884736,59879,9,19988,114
20,2,safari,None,125,0.2,59880,106,59880,7,0,19912,9,76,0.9998497219856735,0.9981164469188072,0.9995499324898734,0.9989823326270834,0.998474809351169,59880,9,19988,113
20,2,giraffe,None,125,0.35,104741,194,104741,11,0,35012,20,129,0.9998090892603163,0.9980466144493358,0.9994311879639373,0.9989270744419595,0.998394084521116,104741,20,35141,205
20,2,safari,None,125,0.35,104742,193,104742,11,0,35012,20,129,0.9998090910826445,0.9980561431593391,0.9994311879639373,0.9989318480935396,0.9984012219232444,104742,20,35141,204
20,2,giraffe,None,125,0.3,89626,167,89626,7,0,29887,16,118,0.9998215122375672,0.9980623608017818,0.9994670397388494,0.9989411620467894,0.9984143013328215,89626,16,30005,174
20,2,safari,None,125,0.3,89627,166,89627,7,0,29887,16,118,0.9998215142286626,0.9980734966592427,0.9994670397388494,0.9989467407477582,0.9984226471152803,89627,16,30005,173
20,2,giraffe,None,125,0.45,135074,257,135074,15,0,45257,27,158,0.9998001495177682,0.997990335879893,0.999405836010739,0.9988944229368415,0.9983461291678651,135074,27,45415,272
20,2,safari,None,125,0.45,135075,256,135075,15,0,45257,27,158,0.9998001509970245,0.9979977243509228,0.999405836010739,0.9988981245932674,0.9983516605084408,135075,27,45415,271
20,2,giraffe,None,125,0.4,119714,218,119714,13,0,40044,24,141,0.9997995623778583,0.9980741173037643,0.9994031187047676,0.9989360947584935,0.9984077825093348,119714,24,40185,231
20,2,safari,None,125,0.4,119715,217,119715,13,0,40044,24,141,0.9997995640518127,0.9980824544582934,0.9994031187047676,0.9989402713572871,0.9984140264994943,119715,24,40185,230
20,2,giraffe,None,125,0.55,165101,317,165101,17,0,55340,33,191,0.9998001622924413,0.997981080182549,0.9994060902742783,0.9988897930537951,0.9983393590016244,165101,33,55531,334
20,2,safari,None,125,0.55,165102,316,165102,17,0,55340,33,191,0.9998001635025888,0.9979871248526612,0.9994060902742783,0.9988928214901532,0.998343883908977,165102,33,55531,333
20,2,giraffe,None,125,0.5,150165,285,150165,15,0,50383,31,178,0.9997936030253801,0.9980061808393978,0.9993872549019608,0.9988990923332257,0.9983537006918436,150165,31,50561,300
20,2,safari,None,125,0.5,150166,284,150166,15,0,50383,31,178,0.9997936043995552,0.9980128269032665,0.9993872549019608,0.9989024219888114,0.9983586744057655,150166,31,50561,299
20,2,giraffe,None,125,0.65,195285,388,195285,22,0,65464,36,239,0.9998156880212573,0.9979049030378906,0.999452379865833,0.9988593817132801,0.9982940244956662,195285,36,65703,410
20,2,safari,None,125,0.65,195286,387,195286,22,0,65464,36,239,0.9998156889648887,0.9979100130304811,0.999452379865833,0.9988619420639001,0.9982978495528508,195286,36,65703,409
20,2,giraffe,None,125,0.6,180192,351,180192,20,0,60360,34,211,0.9998113479742101,0.9979453154854538,0.9994389901823282,0.9988774602329893,0.9983206727260665,180192,34,60571,371
20,2,safari,None,125,0.6,180193,350,180193,20,0,60360,34,211,0.9998113490209569,0.9979508537186467,0.9994389901823282,0.9988802350397737,0.9983248192131626,180193,34,60571,370
20,2,giraffe,None,125,0.75,225110,432,225110,25,0,75415,41,279,0.9998178999871198,0.9979739944229431,0.9994586386743249,0.9988950962686204,0.9983471732680168,225110,41,75694,457
20,2,safari,None,125,0.75,225112,430,225112,25,0,75415,41,279,0.9998179016046866,0.997982860968138,0.9994586386743249,0.998899538516152,0.9983538111263782,225112,41,75694,455
20,2,giraffe,None,125,0.7,210275,413,210275,23,0,70491,39,258,0.9998145629867722,0.9979308151923725,0.9994490591625699,0.9988718009619382,0.998312605018135,210275,39,70749,436
20,2,safari,None,125,0.7,210277,411,210277,23,0,70491,39,258,0.9998145647501855,0.9979403068658019,0.9994490591625699,0.9988765566103837,0.9983197098391113,210277,39,70749,434
20,2,giraffe,None,125,0.85,255131,484,255131,29,0,85291,47,326,0.9998158148429723,0.9979933031872448,0.9994513447889428,0.9989037277172871,0.9983592532258253,255131,47,85617,513
20,2,safari,None,125,0.85,255133,482,255133,29,0,85291,47,326,0.9998158162865428,0.9980011265666318,0.9994513447889428,0.9989076472522826,0.9983651130357332,255133,47,85617,511
20,2,giraffe,None,125,0.8,239990,456,239990,26,0,80299,44,300,0.99981669263521,0.9979956086363485,0.9994543853775281,0.9989053206411574,0.9983619575541473,239990,44,80599,482
20,2,safari,None,125,0.8,239992,454,239992,26,0,80299,44,300,0.9998166941625423,0.9980039256129611,0.9994543853775281,0.9989094874591058,0.9983681858524205,239992,44,80599,480
20,2,giraffe,None,125,0.95,285000,551,285000,33,0,95218,49,356,0.9998280997302218,0.9979550675107849,0.9994875709818768,0.9988907055848505,0.9983394848468156,285000,49,95574,584
20,2,safari,None,125,0.95,285002,549,285002,33,0,95218,49,356,0.9998281009363237,0.9979620707042411,0.9994875709818768,0.998894214340165,0.9983447313401905,285002,49,95574,582
20,2,giraffe,None,125,0.9,269990,521,269990,32,0,90238,49,341,0.9998185447287243,0.9979559626381019,0.9994593282429272,0.9988863854142387,0.9983331995093737,269990,49,90579,553
20,2,safari,None,125,0.9,269992,519,269992,32,0,90238,49,341,0.9998185460726334,0.9979633551782896,0.9994593282429272,0.9988900892368253,0.998338737052532,269992,49,90579,551
20,2,giraffe,Single-stranded,125,0.15,44849,94,44849,18,0,14958,6,54,0.9998662356481998,0.9975089522030204,0.9996004794246903,0.9986862029037142,0.998032644758999,44849,6,15012,112
20,2,safari,Single-stranded,125,0.15,44849,94,44849,18,0,14958,6,54,0.9998662356481998,0.9975089522030204,0.9996004794246903,0.9986862029037142,0.998032644758999,44849,6,15012,112
20,2,giraffe,Single-stranded,125,0.1,29876,67,29876,12,0,10014,4,29,0.9998661311914324,0.9973627107327658,0.999601871205335,0.9986128520096934,0.9979251037448128,29876,4,10043,79
20,2,safari,Single-stranded,125,0.1,29876,67,29876,12,0,10014,4,29,0.9998661311914324,0.9973627107327658,0.999601871205335,0.9986128520096934,0.9979251037448128,29876,4,10043,79
20,2,giraffe,Single-stranded,125,0.25,74813,154,74813,33,0,24987,13,95,0.9998262635982145,0.9975066666666667,0.9994819685196255,0.9986651182037829,0.9980018981967131,74813,13,25082,187
20,2,safari,Single-stranded,125,0.25,74813,154,74813,33,0,24987,13,95,0.9998262635982145,0.9975066666666667,0.9994819685196255,0.9986651182037829,0.9980018981967131,74813,13,25082,187
20,2,giraffe,Single-stranded,125,0.2,59862,111,59862,20,0,19911,9,76,0.999849676805131,0.9978164119147234,0.9995499099819964,0.9988320096108924,0.9982497593419095,59862,9,19987,131
20,2,safari,Single-stranded,125,0.2,59862,111,59862,20,0,19911,9,76,0.999849676805131,0.9978164119147234,0.9995499099819964,0.9988320096108924,0.9982497593419095,59862,9,19987,131
20,2,giraffe,Single-stranded,125,0.35,104688,208,104688,50,0,35010,20,129,0.9998089926271154,0.9975415928191641,0.9994311556073836,0.9986740057427953,0.9980157738838729,104688,20,35139,258
20,2,safari,Single-stranded,125,0.35,104688,208,104688,50,0,35010,20,129,0.9998089926271154,0.9975415928191641,0.9994311556073836,0.9986740057427953,0.9980157738838729,104688,20,35139,258
20,2,giraffe,Single-stranded,125,0.3,89571,187,89571,42,0,29885,16,118,0.9998214026588679,0.9974498886414254,0.9994670042306539,0.998634237709533,0.9979552491674943,89571,16,30003,229
20,2,safari,Single-stranded,125,0.3,89571,187,89571,42,0,29885,16,118,0.9998214026588679,0.9974498886414254,0.9994670042306539,0.998634237709533,0.9979552491674943,89571,16,30003,229
20,2,giraffe,Single-stranded,125,0.45,135030,253,135030,63,0,45255,27,158,0.9998000844088052,0.9976652431545816,0.999405809859155,0.9987315229490799,0.9981027291936323,135030,27,45413,316
20,2,safari,Single-stranded,125,0.45,135030,253,135030,63,0,45255,27,158,0.9998000844088052,0.9976652431545816,0.999405809859155,0.9987315229490799,0.9981027291936323,135030,27,45413,316
20,2,giraffe,Single-stranded,125,0.4,119654,233,119654,58,0,40042,24,141,0.9997994618894033,0.9975738880320146,0.9994030890143507,0.9986854350375381,0.9980331185373895,119654,24,40183,291
20,2,safari,Single-stranded,125,0.4,119654,233,119654,58,0,40042,24,141,0.9997994618894033,0.9975738880320146,0.9994030890143507,0.9986854350375381,0.9980331185373895,119654,24,40183,291
20,2,giraffe,Single-stranded,125,0.55,165035,317,165035,81,0,55339,33,191,0.9998000823902876,0.997594192210744,0.9994060795853356,0.9986959192256605,0.9980497384568047,165035,33,55530,398
20,2,safari,Single-stranded,125,0.55,165035,317,165035,81,0,55339,33,191,0.9998000823902876,0.997594192210744,0.9994060795853356,0.9986959192256605,0.9980497384568047,165035,33,55530,398
20,2,giraffe,Single-stranded,125,0.5,150111,282,150111,72,0,50381,31,178,0.9997935287927429,0.9976472933904895,0.9993872306779996,0.9987192580345767,0.9980851010917411,150111,31,50559,354
20,2,safari,Single-stranded,125,0.5,150111,282,150111,72,0,50381,31,178,0.9997935287927429,0.9976472933904895,0.9993872306779996,0.9987192580345767,0.9980851010917411,150111,31,50559,354
20,2,giraffe,Single-stranded,125,0.65,195222,378,195222,94,0,65463,36,239,0.9998156285529914,0.9975880711723405,0.9994523715354894,0.9987006077472427,0.9980568560849475,195222,36,65702,472
20,2,safari,Single-stranded,125,0.65,195222,378,195222,94,0,65463,36,239,0.9998156285529914,0.9975880711723405,0.9994523715354894,0.9987006077472427,0.9980568560849475,195222,36,65702,472
20,2,giraffe,Single-stranded,125,0.6,180130,347,180130,85,0,60359,34,211,0.9998112830532182,0.9976074700103011,0.9994389809253514,0.9987081607646802,0.9980677209888624,180130,34,60570,432
20,2,safari,Single-stranded,125,0.6,180130,347,180130,85,0,60359,34,211,0.9998112830532182,0.9976074700103011,0.9994389809253514,0.9987081607646802,0.9980677209888624,180130,34,60570,432
20,2,giraffe,Single-stranded,125,0.75,225009,449,225009,108,0,75414,41,279,0.9998178182626083,0.9975306562159191,0.9994586315261309,0.9986729277256023,0.9980152671755725,225009,41,75693,557
20,2,safari,Single-stranded,125,0.75,225010,448,225010,108,0,75414,41,279,0.9998178190721214,0.9975350895081706,0.9994586315261309,0.9986751498500944,0.998018586126784,225010,41,75693,556
20,2,giraffe,Single-stranded,125,0.7,210199,412,210199,99,0,70490,39,258,0.9998144959522065,0.9975748659294765,0.9994490513794906,0.9986934253161911,0.9980461603498438,210199,39,70748,511
20,2,safari,Single-stranded,125,0.7,210200,411,210200,99,0,70490,39,258,0.9998144968345549,0.9975796117887143,0.9994490513794906,0.9986958040047605,0.9980497127855714,210200,39,70748,510
20,2,giraffe,Single-stranded,125,0.85,255023,498,255023,122,0,85292,47,326,0.9998157368565492,0.9975747429031893,0.999451351193603,0.9986939827261105,0.9980457533957598,255023,47,85618,620
20,2,safari,Single-stranded,125,0.85,255025,496,255025,122,0,85292,47,326,0.9998157383013424,0.9975825663131789,0.999451351193603,0.9986979039190156,0.9980516132056676,255025,47,85618,618
20,2,giraffe,Single-stranded,125,0.8,239885,469,239885,117,0,80300,44,300,0.9998166124145059,0.9975631157187353,0.9994543921432468,0.9986885928393006,0.9980380860439406,239885,44,80600,586
20,2,safari,Single-stranded,125,0.8,239886,468,239886,117,0,80300,44,300,0.9998166131788438,0.9975672742243348,0.9994543921432468,0.9986906771634531,0.9980412001930773,239886,44,80600,585
20,2,giraffe,Single-stranded,125,0.95,284898,553,284898,131,0,95219,49,356,0.999828038196577,0.9976048910645628,0.9994875763406676,0.9987152274468081,0.9980771551339696,284898,49,95575,684
20,2,safari,Single-stranded,125,0.95,284900,551,284900,131,0,95219,49,356,0.9998280394035424,0.9976118943070642,0.9994875763406676,0.9987187374568604,0.9980824016411074,284900,49,95575,682
20,2,giraffe,Single-stranded,125,0.9,269883,529,269883,129,0,90239,49,341,0.9998184728005571,0.9975678362983799,0.999459334208697,0.9986918865512245,0.9980424730736218,269883,49,90580,658
20,2,safari,Single-stranded,125,0.9,269885,527,269885,129,0,90239,49,341,0.9998184741455318,0.9975752288932177,0.999459334208697,0.9986955918405106,0.9980480106321123,269885,49,90580,656
29,11,giraffe,High,125,0.15,30873,49,30873,14038,0,14956,2,58,0.9999352226720648,0.6866770462633452,0.9998668087373468,0.8142150721962155,0.7650893690809657,30873,2,15014,14087
29,11,safari,High,125,0.15,37439,63,37439,7458,0,14956,3,57,0.999919876074996,0.8327179715302491,0.9998002131060203,0.9086915366131889,0.8745498199279712,37439,3,15013,7521
29,11,giraffe,High,125,0.1,20620,34,20620,9300,0,10014,1,32,0.999951505746569,0.6883888629231488,0.9999004678013337,0.8154226396440929,0.7666308342291442,20620,1,10046,9334
29,11,safari,High,125,0.1,24964,42,24964,4948,0,10014,2,31,0.9999198910518304,0.8334112305535154,0.9998009356026675,0.9091041514930808,0.875203119922002,24964,2,10045,4990
29,11,giraffe,High,125,0.25,51484,99,51484,23416,0,24986,3,105,0.9999417328646066,0.6864624861664822,0.999880449509843,0.8140663788877821,0.7650385141818109,51484,3,25091,23515
29,11,safari,High,125,0.25,62439,116,62439,12444,0,24986,7,101,0.9998879031483201,0.8325311004146722,0.9997210488563003,0.9085670631889119,0.8744467645090066,62439,7,25087,12560
29,11,giraffe,High,125,0.2,41194,70,41194,18728,0,19910,2,83,0.9999514515972424,0.6866582210961462,0.9998999749937484,0.814207218247223,0.7649618062935227,41194,2,19993,18798
29,11,safari,High,125,0.2,49957,87,49957,9948,0,19910,4,81,0.99991993755129,0.8327276970262701,0.9997999499874969,0.9086973525051613,0.8744921049670571,49957,4,19991,10035
29,11,giraffe,High,125,0.35,72111,140,72111,32693,0,35010,4,145,0.9999445330375095,0.6871379021192255,0.9998862311214767,0.8145420453069316,0.7656224349228782,72111,4,35155,32833
29,11,safari,High,125,0.35,87467,164,87467,17313,0,35010,8,141,0.9999085452986568,0.8334635615185242,0.9997724622429535,0.9091305952114916,0.8751989607645804,87467,8,35151,17477
29,11,giraffe,High,125,0.3,61646,121,61646,28032,0,29885,4,130,0.9999351175993512,0.6864887136827804,0.9998667510576634,0.8140826284755923,0.7650019195780267,61646,4,30015,28153
29,11,safari,High,125,0.3,74773,143,74773,14883,0,29885,8,126,0.9998930209545205,0.8326707424358846,0.999733502115327,0.9086523271357394,0.8745263649868968,74773,8,30011,15026
29,11,giraffe,High,125,0.45,92911,181,92911,42252,0,45255,7,178,0.9999246647581739,0.6864803759309611,0.9998459507042253,0.81407330173222,0.765244711921409,92911,7,45433,42433
29,11,safari,High,125,0.45,112791,216,112791,22337,0,45255,13,172,0.9998847558597213,0.8333653505142452,0.9997139084507042,0.9090623337685574,0.8751770068147624,112791,13,45427,22553
29,11,giraffe,High,125,0.4,82375,158,82375,37410,0,40042,5,160,0.9999393056567127,0.6867845559974322,0.9998756435446564,0.814291998438141,0.7653886980955354,82375,5,40202,37568
29,11,safari,High,125,0.4,99931,187,99931,19825,0,40042,11,154,0.9998899361629745,0.8331540815220563,0.9997264157982441,0.9089387634445277,0.8749734623790196,99931,11,40196,20012
29,11,giraffe,High,125,0.55,113486,223,113486,51724,0,55338,8,216,0.9999295116922481,0.6859937255565697,0.9998560167020626,0.8137326253822684,0.7649041833525645,113486,8,55554,51947
29,11,safari,High,125,0.55,137783,262,137783,27388,0,55338,16,208,0.9998838888526042,0.8328628508217828,0.9997120334041251,0.9087629273955257,0.8748116473223376,137783,16,55546,27650
29,11,giraffe,High,125,0.5,103284,200,103284,46979,0,50381,8,201,0.9999225496650272,0.686441184876016,0.9998418659814192,0.8140450434474198,0.7653006918573709,103284,8,50582,47179
29,11,safari,High,125,0.5,125390,238,125390,24835,0,50381,16,193,0.9998724143980352,0.8333610256342091,0.9996837319628386,0.9090546600016675,0.8752120087738059,125390,16,50574,25073
29,11,giraffe,High,125,0.65,134166,268,134166,61259,0,65462,8,267,0.9999403759297628,0.6855942726617712,0.9998783029344205,0.8134551197907035,0.7646215048005203,134166,8,65729,61527
29,11,safari,High,125,0.65,163011,313,163011,32369,0,65462,18,257,0.9998895901956094,0.8329935153531296,0.9997261816024461,0.908843059527991,0.8749187162911678,163011,18,65719,32682
29,11,giraffe,High,125,0.6,123750,254,123750,56557,0,60358,8,237,0.9999353577142488,0.6853639490255371,0.9998679933336634,0.8132913160203602,0.7643968419830489,123750,8,60595,56811
29,11,safari,High,125,0.6,150378,297,150378,29886,0,60358,16,229,0.9998936127771054,0.8328376559722199,0.9997359866673267,0.9087519451284918,0.8747781592609178,150378,16,60587,30183
29,11,giraffe,High,125,0.75,154703,299,154703,70565,0,75413,9,311,0.9999418273954186,0.6858405706508488,0.999881161448774,0.8136289408565817,0.7647759707932293,154703,9,75724,70864
29,11,safari,High,125,0.75,188001,349,188001,37217,0,75413,19,301,0.9998989469205404,0.8334596816023621,0.9997491186140784,0.9091243196715565,0.8752572187188848,188001,19,75714,37566
29,11,giraffe,High,125,0.7,144550,280,144550,65881,0,70489,9,288,0.9999377416833265,0.6860106971159551,0.9998728562145057,0.8137472907929181,0.7649353279075798,144550,9,70777,66161
29,11,safari,High,125,0.7,175626,329,175626,34756,0,70489,19,278,0.9998918272652224,0.8334923188632772,0.9997315853417342,0.9091407924297799,0.8752952962198531,175626,19,70767,35085
29,11,giraffe,High,125,0.85,175346,342,175346,79958,0,85287,11,362,0.9999372708246606,0.6858937749857225,0.9998715853373803,0.8136648700821109,0.7646950244062513,175346,11,85649,80300
29,11,safari,High,125,0.85,213047,399,213047,42200,0,85287,23,350,0.9998920542544704,0.8333672343787895,0.9997314966145225,0.9090664709546932,0.8751208592875601,213047,23,85637,42599
29,11,giraffe,High,125,0.8,164909,321,164909,75244,0,80297,9,335,0.9999454274245383,0.685766444605238,0.9998883942411428,0.8135779689781741,0.764651293150429,164909,9,80632,75565
29,11,safari,High,125,0.8,200393,372,200393,39709,0,80297,21,323,0.9998952169010149,0.8333250164258922,0.9997395865626666,0.9090426593602003,0.8751163913239806,200393,21,80620,40081
29,11,giraffe,High,125,0.95,195815,399,195815,89372,0,95215,11,394,0.9999438276837601,0.6856603615023146,0.9998849613051662,0.8135027793241548,0.7644790480737449,195815,11,95609,89771
29,11,safari,High,125,0.95,237924,460,237924,47202,0,95215,24,381,0.9998991376267083,0.8331080655214191,0.9997490064839991,0.9089151802939255,0.874907530311695,237924,24,95596,47662
29,11,giraffe,High,125,0.9,185539,374,185539,84632,0,90235,11,379,0.9999407167879277,0.6857971871592526,0.9998786206896552,0.8135980442670935,0.764606694908215,185539,11,90614,85006
29,11,safari,High,125,0.9,225364,432,225364,44749,0,90235,24,366,0.9998935169574246,0.8330000554436415,0.9997351724137931,0.9088485743033838,0.8748373342193427,225364,24,90601,45181
29,11,giraffe,Mid,125,0.15,43434,79,43434,1446,0,14956,2,65,0.9999539552444977,0.9660802064102849,0.9998668707981095,0.9827252672662482,0.9745423627088127,43434,2,15021,1525
29,11,safari,Mid,125,0.15,44071,78,44071,810,0,14956,3,64,0.9999319326587104,0.9802486710113659,0.9998003061971643,0.989992474700392,0.9851455436630989,44071,3,15020,888
29,11,giraffe,Mid,125,0.1,28951,54,28951,948,0,10014,1,45,0.9999654600718431,0.9665475912262544,0.9999005964214712,0.9829725829725829,0.9749331467273136,28951,1,10059,1002
29,11,safari,Mid,125,0.1,29371,54,29371,528,0,10014,2,44,0.9999319102577197,0.9805695589757286,0.9998011928429423,0.9901560867073457,0.985404743458376,29371,2,10058,582
29,11,giraffe,Mid,125,0.25,72454,138,72454,2405,0,24986,6,107,0.9999171956941761,0.9660919770124138,0.999760946651261,0.9827136046440657,0.9745344469309463,72454,6,25093,2543
29,11,safari,Mid,125,0.25,73517,136,73517,1344,0,24986,9,104,0.9998775943203765,0.9802658773017587,0.9996414199768915,0.989974616726029,0.985124280690537,73517,9,25090,1480
29,11,giraffe,Mid,125,0.2,57961,104,57961,1925,0,19910,3,88,0.9999482437374922,0.9661776962827138,0.999850007499625,0.9827729453854892,0.9745971421784951,57961,3,19998,2029
29,11,safari,Mid,125,0.2,58808,103,58808,1079,0,19910,5,86,0.999914984782276,0.9802967161193532,0.999750012499375,0.9900086698147352,0.9851608305934417,58808,5,19996,1182
29,11,giraffe,Mid,125,0.35,101369,181,101369,3393,0,35010,8,146,0.9999210866370084,0.965943416902509,0.9997724945967467,0.9826386196200078,0.9744338255761668,101369,8,35156,3574
29,11,safari,Mid,125,0.35,102868,180,102868,1895,0,35010,11,143,0.9998930782764218,0.9802273615200633,0.9996871800705267,0.9899625641173697,0.9851113791602133,102868,11,35153,2075
29,11,giraffe,Mid,125,0.3,86759,162,86759,2876,0,29885,8,129,0.9999077990480252,0.9661681347929219,0.9997335287455865,0.9827484651457828,0.9745783223028067,86759,8,30014,3038
29,11,safari,Mid,125,0.3,88046,161,88046,1590,0,29885,11,126,0.9998750809134992,0.980500462153524,0.9996336020251816,0.9900929976272672,0.9852944858494896,88046,11,30011,1751
29,11,giraffe,Mid,125,0.45,130708,244,130708,4390,0,45257,9,187,0.9999311489706771,0.9657608133469285,0.9998019932677711,0.982548983496142,0.9743189800602893,130708,9,45444,4634
29,11,safari,Mid,125,0.45,132643,244,132643,2455,0,45257,12,184,0.9999095397836493,0.9800579273248511,0.9997359910236948,0.989884215121811,0.9850051162919329,132643,12,45441,2699
29,11,giraffe,Mid,125,0.4,115851,214,115851,3876,0,40042,9,165,0.9999223200414293,0.9658999007845525,0.9997762084742391,0.9826166979783802,0.9744063637555649,115851,9,40207,4090
29,11,safari,Mid,125,0.4,117551,214,117551,2176,0,40042,12,162,0.9998979270688907,0.9800735361552764,0.9997016112989855,0.989886486122339,0.9850022165749858,117551,12,40204,2390
29,11,giraffe,Mid,125,0.55,159709,300,159709,5422,0,55340,11,228,0.999931129476584,0.9654115613155938,0.9998020835207543,0.9823681920092511,0.9740599972851908,159709,11,55568,5722
29,11,safari,Mid,125,0.55,162077,301,162077,3053,0,55340,15,224,0.9999074599610098,0.9797256862377668,0.9997301138919376,0.9897136994959133,0.9847563458667029,162077,15,55564,3354
29,11,giraffe,Mid,125,0.5,145276,267,145276,4918,0,50383,10,210,0.9999311702435196,0.9655392427273513,0.9998023832579096,0.9824343104072061,0.9741624557354872,145276,10,50593,5185
29,11,safari,Mid,125,0.5,147439,268,147439,2754,0,50383,14,206,0.9999050544919398,0.9799150610457195,0.9997233365610735,0.98980913955034,0.9849003302431066,147439,14,50589,3022
29,11,giraffe,Mid,125,0.65,188897,348,188897,6448,0,65462,11,276,0.9999417705973278,0.9652721354366278,0.9998326970752407,0.9823011380625636,0.9739636324691519,188897,11,65738,6796
29,11,safari,Mid,125,0.65,191723,349,191723,3621,0,65462,15,272,0.9999217682462527,0.9797131220840807,0.9997718596480555,0.9897142975136218,0.984757613543348,191723,15,65734,3970
29,11,giraffe,Mid,125,0.6,174333,324,174333,5903,0,60360,11,249,0.9999369063460745,0.9655128489144883,0.9998185417354009,0.9824234159096544,0.9741355004560909,174333,11,60609,6227
29,11,safari,Mid,125,0.6,176912,325,176912,3323,0,60360,15,245,0.9999152192712248,0.9797961896322552,0.9997525569119102,0.9897534735528846,0.9848121734803881,176912,15,60605,3648
29,11,giraffe,Mid,125,0.75,217685,395,217685,7482,0,75413,13,316,0.9999402842469843,0.9650783376632589,0.9998283647117847,0.9822000631683436,0.9738138225844993,217685,13,75729,7877
29,11,safari,Mid,125,0.75,220990,396,220990,4176,0,75413,17,312,0.9999230793594773,0.979730628385987,0.9997755538538724,0.9897238724586794,0.9847695350874864,220990,17,75725,4572
29,11,giraffe,Mid,125,0.7,203365,377,203365,6964,0,70489,11,295,0.9999459129887499,0.9651599859519899,0.9998446217953245,0.9822450625721475,0.973882863648797,203365,11,70784,7341
29,11,safari,Mid,125,0.7,206428,378,206428,3900,0,70489,15,291,0.9999273407187456,0.9796968287566562,0.999788120629988,0.9897087131936071,0.9847496101257189,206428,15,70780,4278
29,11,giraffe,Mid,125,0.85,246721,442,246721,8475,0,85287,14,348,0.9999432589620443,0.9651186443330021,0.9998365421662834,0.9822223726195477,0.9738314087556807,246721,14,85635,8917
29,11,safari,Mid,125,0.85,250482,443,250482,4713,0,85287,18,344,0.9999281437125749,0.9798308545677873,0.9997898399280786,0.989777491514172,0.9848397389880071,250482,18,85631,5156
29,11,giraffe,Mid,125,0.8,232104,416,232104,7948,0,80297,13,335,0.9999439937617667,0.9652178252407805,0.9998387996775994,0.9822740882592549,0.973912610202639,232104,13,80632,8364
29,11,safari,Mid,125,0.8,235634,417,235634,4417,0,80297,17,331,0.9999278594192259,0.9798975331437031,0.9997891995783992,0.9898113706867401,0.9848931684484901,235634,17,80628,4834
29,11,giraffe,Mid,125,0.95,275498,496,275498,9583,0,95213,16,385,0.9999419267260465,0.9647065414931875,0.9998326604890497,0.9820082660388422,0.9735172131556097,275498,16,95598,10079
29,11,safari,Mid,125,0.95,279764,498,279764,5315,0,95213,21,380,0.99992494236646,0.9796447192876176,0.9997803668918778,0.9896809477821289,0.9846953364586257,279764,21,95593,5813
29,11,giraffe,Mid,125,0.9,261036,474,261036,9026,0,90235,15,368,0.9999425399634554,0.9648845255344944,0.9998344699728531,0.982100766196314,0.9736538983369976,261036,15,90603,9500
29,11,safari,Mid,125,0.9,265056,475,265056,5005,0,90235,20,363,0.9999245499403945,0.9797439157820031,0.9997792932971374,0.989731372710096,0.9847710395011546,265056,20,90598,5480
29,11,giraffe,None,125,0.15,44778,73,44778,110,0,14958,3,57,0.999933007302204,0.9959298058317209,0.9998002397123452,0.9979273918566557,0.996898914620117,44778,3,15015,183
29,11,safari,None,125,0.15,44778,73,44778,110,0,14958,3,57,0.999933007302204,0.9959298058317209,0.9998002397123452,0.9979273918566557,0.996898914620117,44778,3,15015,183
29,11,giraffe,None,125,0.1,29834,46,29834,75,0,10014,2,31,0.9999329668856415,0.9959606075780337,0.9998009356026675,0.997942834205817,0.9969251537423128,29834,2,10045,121
29,11,safari,None,125,0.1,29834,46,29834,75,0,10014,2,31,0.9999329668856415,0.9959606075780337,0.9998009356026675,0.997942834205817,0.9969251537423128,29834,2,10045,121
29,11,giraffe,None,125,0.25,74698,121,74698,181,0,24988,5,103,0.999933068283737,0.9959733333333334,0.9998007650621613,0.9979492728936628,0.9969329443734015,74698,5,25091,302
29,11,safari,None,125,0.25,74698,121,74698,181,0,24988,5,103,0.999933068283737,0.9959733333333334,0.9998007650621613,0.9979492728936628,0.9969329443734015,74698,5,25091,302
29,11,giraffe,None,125,0.2,59754,97,59754,142,0,19912,3,82,0.9999497966765399,0.9960162018902206,0.9998499774966245,0.9979791231732776,0.9969746218277284,59754,3,19994,239
29,11,safari,None,125,0.2,59754,97,59754,142,0,19912,3,82,0.9999497966765399,0.9960162018902206,0.9998499774966245,0.9979791231732776,0.9969746218277284,59754,3,19994,239
29,11,giraffe,None,125,0.35,104529,175,104529,242,0,35012,7,142,0.9999330374225147,0.996026527928649,0.9998009157873781,0.9979759597483315,0.9969737414975697,104529,7,35154,417
29,11,safari,None,125,0.35,104529,175,104529,242,0,35012,7,142,0.9999330374225147,0.996026527928649,0.9998009157873781,0.9979759597483315,0.9969737414975697,104529,7,35154,417
29,11,giraffe,None,125,0.3,89433,149,89433,218,0,29887,6,128,0.9999329151712341,0.995913140311804,0.9998001399020685,0.9979189796863406,0.9968870231428547,89433,6,30015,367
29,11,safari,None,125,0.3,89433,149,89433,218,0,29887,6,128,0.9999329151712341,0.995913140311804,0.9998001399020685,0.9979189796863406,0.9968870231428547,89433,6,30015,367
29,11,giraffe,None,125,0.45,134809,235,134809,302,0,45257,13,172,0.9999035765676225,0.9960323910569947,0.9997139210422077,0.9979642296645052,0.9969577626833639,134809,13,45429,537
29,11,safari,None,125,0.45,134809,235,134809,302,0,45257,13,172,0.9999035765676225,0.9960323910569947,0.9997139210422077,0.9979642296645052,0.9969577626833639,134809,13,45429,537
29,11,giraffe,None,125,0.4,119479,198,119479,268,0,40044,10,155,0.9999163102879763,0.9961148859894118,0.9997512994603198,0.9980119782487034,0.9970278606840915,119479,10,40199,466
29,11,safari,None,125,0.4,119479,198,119479,268,0,40044,10,155,0.9999163102879763,0.9961148859894118,0.9997512994603198,0.9980119782487034,0.9970278606840915,119479,10,40199,466
29,11,giraffe,None,125,0.55,164762,289,164762,384,0,55340,15,209,0.9999089678777985,0.9959319370145374,0.9997300410337628,0.9979164900124767,0.9968868637414648,164762,15,55549,673
29,11,safari,None,125,0.55,164762,289,164762,384,0,55340,15,209,0.9999089678777985,0.9959319370145374,0.9997300410337628,0.9979164900124767,0.9968868637414648,164762,15,55549,673
29,11,giraffe,None,125,0.5,149865,260,149865,340,0,50383,15,194,0.9998999199359487,0.9960123616787957,0.9997035104364327,0.9979523547919891,0.9969411659380176,149865,15,50577,600
29,11,safari,None,125,0.5,149865,260,149865,340,0,50383,15,194,0.9998999199359487,0.9960123616787957,0.9997035104364327,0.9979523547919891,0.9969411659380176,149865,15,50577,600
29,11,giraffe,None,125,0.65,194874,353,194874,468,0,65464,16,259,0.9999179024064857,0.9958046960831907,0.9997566132737036,0.9978570605630016,0.9967984271364857,194874,16,65723,821
29,11,safari,None,125,0.65,194874,353,194874,468,0,65464,16,259,0.9999179024064857,0.9958046960831907,0.9997566132737036,0.9978570605630016,0.9967984271364857,194874,16,65723,821
29,11,giraffe,None,125,0.6,179811,319,179811,433,0,60360,16,229,0.9999110255968237,0.9958352486389792,0.9997359953799192,0.9978689752767834,0.9968154979101705,179811,16,60589,752
29,11,safari,None,125,0.6,179811,319,179811,433,0,60360,16,229,0.9999110255968237,0.9958352486389792,0.9997359953799192,0.9978689752767834,0.9968154979101705,179811,16,60589,752
29,11,giraffe,None,125,0.75,224639,394,224639,534,0,75415,17,303,0.9999243287515134,0.9958859230295212,0.9997755331088665,0.997901040151214,0.9968636119242488,224639,17,75718,928
29,11,safari,None,125,0.75,224639,394,224639,534,0,75415,17,303,0.9999243287515134,0.9958859230295212,0.9997755331088665,0.997901040151214,0.9968636119242488,224639,17,75718,928
29,11,giraffe,None,125,0.7,209829,377,209829,505,0,70491,17,280,0.9999189882104019,0.9958141720175976,0.9997598463016331,0.997862358729019,0.9968063829711651,209829,17,70771,882
29,11,safari,None,125,0.7,209829,377,209829,505,0,70491,17,280,0.9999189882104019,0.9958141720175976,0.9997598463016331,0.997862358729019,0.9968063829711651,209829,17,70771,882
29,11,giraffe,None,125,0.85,254606,442,254606,596,0,85291,20,353,0.9999214534258088,0.9959396660981678,0.9997665296974225,0.9979265878848452,0.9969001605587915,254606,20,85644,1038
29,11,safari,None,125,0.85,254606,442,254606,596,0,85291,20,353,0.9999214534258088,0.9959396660981678,0.9997665296974225,0.9979265878848452,0.9969001605587915,254606,20,85644,1038
29,11,giraffe,None,125,0.8,239495,417,239495,560,0,80299,18,326,0.9999248475030583,0.9959371569247147,0.9997767940180797,0.9979270185526632,0.9969014216090809,239495,18,80625,977
29,11,safari,None,125,0.8,239495,417,239495,560,0,80299,18,326,0.9999248475030583,0.9959371569247147,0.9997767940180797,0.9979270185526632,0.9969014216090809,239495,18,80625,977
29,11,giraffe,None,125,0.95,284408,501,284408,675,0,95218,21,384,0.9999261678661459,0.995882122247745,0.9997803875636615,0.9979000478936444,0.9968599737150682,284408,21,95602,1176
29,11,safari,None,125,0.95,284408,501,284408,675,0,95218,21,384,0.9999261678661459,0.995882122247745,0.9997803875636615,0.9979000478936444,0.9968599737150682,284408,21,95602,1176
29,11,giraffe,None,125,0.9,269433,476,269433,634,0,90238,21,369,0.999922064619564,0.9958971401958284,0.9997682835326831,0.9979055439196884,0.9968685193440227,269433,21,90607,1110
29,11,safari,None,125,0.9,269433,476,269433,634,0,90238,21,369,0.999922064619564,0.9958971401958284,0.9997682835326831,0.9979055439196884,0.9968685193440227,269433,21,90607,1110
29,11,giraffe,Single-stranded,125,0.15,44484,84,44484,393,0,14958,3,57,0.9999325645694248,0.9893908053646494,0.9998002397123452,0.9946337536892944,0.9919971990196569,44484,3,15015,477
29,11,safari,Single-stranded,125,0.15,44606,84,44606,271,0,14958,3,57,0.9999327489968391,0.9921042681435022,0.9998002397123452,0.9960031260466673,0.9940312442688274,44606,3,15015,355
29,11,giraffe,Single-stranded,125,0.1,29634,58,29634,263,0,10014,2,31,0.9999325145093805,0.9892839258888333,0.9998009356026675,0.9945797184138545,0.9919254037298135,29634,2,10045,321
29,11,safari,Single-stranded,125,0.1,29713,58,29713,184,0,10014,2,31,0.9999326939256268,0.9919212151560675,0.9998009356026675,0.9959108429696665,0.9939003049847508,29713,2,10045,242
29,11,giraffe,Single-stranded,125,0.25,74255,141,74255,604,0,24987,5,103,0.999932669000808,0.9900666666666667,0.9998007571229328,0.9949752110411362,0.9925071182376742,74255,5,25090,745
29,11,safari,Single-stranded,125,0.25,74452,141,74452,407,0,24987,7,101,0.9999059885306008,0.9926933333333333,0.999721059972106,0.9962866070293526,0.9944552674958789,74452,7,25088,548
29,11,giraffe,Single-stranded,125,0.2,59402,100,59402,491,0,19911,3,82,0.999949499200404,0.9901488506992483,0.9998499699939988,0.9950250422955158,0.9925739789221018,59402,3,19993,591
29,11,safari,Single-stranded,125,0.2,59561,100,59561,332,0,19911,4,81,0.9999328464702426,0.9927991599019885,0.9997999599919984,0.9963532344134227,0.9945492505219468,59561,4,19992,432
29,11,giraffe,Single-stranded,125,0.35,103911,186,103911,849,0,35010,7,142,0.9999326391962894,0.9901377851466469,0.9998009044625843,0.9950111077064502,0.9925627208165304,103911,7,35152,1035
29,11,safari,Single-stranded,125,0.35,104201,186,104201,559,0,35010,9,140,0.9999136359274542,0.9929011110475864,0.9997440200233226,0.9963950352846679,0.9946183219728061,104201,9,35150,745
29,11,giraffe,Single-stranded,125,0.3,88903,170,88903,727,0,29885,6,128,0.9999325152684205,0.990011135857461,0.9998001265864952,0.9949470927597379,0.9924636326459075,88903,6,30013,897
29,11,safari,Single-stranded,125,0.3,89148,170,89148,482,0,29885,8,126,0.9999102696397326,0.992739420935412,0.999733502115327,0.9963119426004157,0.9944916916348826,89148,8,30011,652
29,11,giraffe,Single-stranded,125,0.45,134031,227,134031,1088,0,45255,13,172,0.9999030169198174,0.9902841605958063,0.9997139084507042,0.9950703441107688,0.9926542984523138,134031,13,45427,1315
29,11,safari,Single-stranded,125,0.45,134396,227,134396,723,0,45255,15,170,0.9998884019909084,0.9929809525216852,0.9996698943661971,0.9964227063616513,0.9946621972940383,134396,15,45425,950
29,11,giraffe,Single-stranded,125,0.4,118770,208,118770,967,0,40042,10,155,0.9999158107425492,0.990203843428238,0.9997512870893128,0.9950361294376373,0.9926007792597032,118770,10,40197,1175
29,11,safari,Single-stranded,125,0.4,119098,208,119098,639,0,40042,12,153,0.9998992527915372,0.9929384301138021,0.9997015445071754,0.996406684654159,0.9946363454718018,119098,12,40195,847
29,11,giraffe,Single-stranded,125,0.55,163819,289,163819,1325,0,55339,15,209,0.9999084439127409,0.9902437844928158,0.9997300361751525,0.9950526472437262,0.9926288258611016,163819,15,55548,1614
29,11,safari,Single-stranded,125,0.55,164158,289,164158,986,0,55339,16,208,0.9999025424245008,0.9922929524339158,0.9997120385868293,0.9960832142521245,0.9941582653079694,164158,16,55547,1275
29,11,giraffe,Single-stranded,125,0.5,149001,254,149001,1210,0,50381,15,194,0.9998993396682235,0.9902701624962615,0.9997034987151611,0.9950614563194327,0.9926438039342469,149001,15,50575,1464
29,11,safari,Single-stranded,125,0.5,149401,254,149401,810,0,50381,17,192,0.9998862252205223,0.9929285880437311,0.9996639652105159,0.9963952608183858,0.9946233617666808,149401,17,50573,1064
29,11,giraffe,Single-stranded,125,0.65,193765,340,193765,1589,0,65463,16,259,0.9999174325656283,0.9901427739225526,0.9997566095713286,0.9950060979523718,0.992560206860675,193765,16,65722,1929
29,11,safari,Single-stranded,125,0.65,194201,340,194201,1153,0,65463,18,257,0.9999073211168835,0.992370742076916,0.9997261857677446,0.9961247765527181,0.994220294378653,194201,18,65720,1493
29,11,giraffe,Single-stranded,125,0.6,178791,314,178791,1457,0,60359,16,229,0.9999105180445955,0.9901917346950078,0.9997359910236948,0.9950273952399901,0.9925901661096506,178791,16,60588,1771
29,11,safari,Single-stranded,125,0.6,178839,314,178839,1409,0,60359,16,229,0.9999105420592099,0.9904575713605299,0.9997359910236948,0.9951616089389205,0.9927891991408407,178839,16,60588,1723
29,11,giraffe,Single-stranded,125,0.75,223362,407,223362,1797,0,75414,17,303,0.9999238961585467,0.9902290238777121,0.9997755301449811,0.9950528461170076,0.9926286093594424,223362,17,75717,2204
29,11,safari,Single-stranded,125,0.75,223583,407,223583,1576,0,75414,17,303,0.9999239713774597,0.9912087814652918,0.9997755301449811,0.9955473032241976,0.9933620975771656,223583,17,75717,1983
29,11,giraffe,Single-stranded,125,0.7,208647,372,208647,1691,0,70490,17,280,0.9999185293102787,0.9902092923923876,0.9997598429090088,0.9950402266234911,0.9926109336866823,208647,17,70770,2063
29,11,safari,Single-stranded,125,0.7,209111,372,209111,1227,0,70490,19,278,0.9999091474202649,0.9924113710787338,0.9997315891335979,0.9961461509146341,0.9942521589928134,209111,19,70768,1599
29,11,giraffe,Single-stranded,125,0.85,253162,452,253162,2029,0,85292,20,353,0.999921005442725,0.990295059907762,0.9997665324228098,0.9950847540903061,0.9926723077103379,253162,20,85645,2481
29,11,safari,Single-stranded,125,0.85,253235,452,253235,1956,0,85292,20,353,0.999921028212671,0.9905806143723865,0.9997665324228098,0.9952289063820254,0.9928861907719714,253235,20,85645,2408
29,11,giraffe,Single-stranded,125,0.8,238133,426,238133,1912,0,80300,18,326,0.9999244177013743,0.9902774139085379,0.9997767967858737,0.9950775350903218,0.9926630646341653,238133,18,80626,2338
29,11,safari,Single-stranded,125,0.8,238611,426,238611,1434,0,80300,19,325,0.9999203788291497,0.9922651795850643,0.9997643966073111,0.9960780712208908,0.9941485137723246,238611,19,80625,1860
29,11,giraffe,Single-stranded,125,0.95,282804,502,282804,2276,0,95219,21,384,0.9999257491381597,0.9902724961657248,0.9997803898602862,0.9950757115939811,0.9926575132605467,282804,21,95603,2778
29,11,safari,Single-stranded,125,0.95,282892,502,282892,2188,0,95219,21,384,0.9999257722338669,0.990580638835781,0.9997803898602862,0.995231268524789,0.9928883595746132,282892,21,95603,2690
29,11,giraffe,Single-stranded,125,0.9,267891,480,267891,2170,0,90239,21,369,0.9999216160530323,0.9902048118399799,0.9997682860894416,0.9950394927690996,0.9926045906359886,267891,21,90608,2650
29,11,safari,Single-stranded,125,0.9,267973,480,267973,2088,0,90239,21,369,0.9999216400367172,0.9905079082283277,0.9997682860894416,0.9951925130214379,0.9928316305340975,267973,21,90608,2568
30,15,giraffe,High,125,0.15,22769,27,22769,22164,0,14956,0,60,1.0,0.5064279359430605,1.0,0.6723560070280087,0.6300020008003201,22769,0,15016,22191
30,15,safari,High,125,0.15,24362,31,24362,20567,0,14956,0,60,1.0,0.5418594306049822,1.0,0.702864891376475,0.65656262505002,24362,0,15016,20598
30,15,giraffe,High,125,0.1,15169,19,15169,14766,0,10014,0,33,1.0,0.5064098284035521,1.0,0.6723400483123906,0.6303842403939901,15169,0,10047,14785
30,15,safari,High,125,0.1,16231,21,16231,13702,0,10014,0,33,1.0,0.5418641917606998,1.0,0.7028688968279745,0.6569335766605835,16231,0,10047,13723
30,15,giraffe,High,125,0.25,38075,50,38075,36874,0,24986,1,107,0.9999737367370523,0.5076734356458086,0.9999601498366143,0.6734468273269952,0.6310930834324079,38075,1,25093,36924
30,15,safari,High,125,0.25,40753,55,40753,34191,0,24986,3,105,0.9999263912062027,0.5433805784077121,0.999880449509843,0.7041250917886916,0.6578282197556272,40753,3,25091,34246
30,15,giraffe,High,125,0.2,30390,36,30390,29566,0,19910,0,85,1.0,0.5065675423389785,1.0,0.672479033435861,0.6299148611649393,30390,0,19995,29602
30,15,safari,High,125,0.2,32500,40,32500,27452,0,19910,0,85,1.0,0.5417388985198026,1.0,0.7027634822471133,0.6562941477990173,32500,0,19995,27492
30,15,giraffe,High,125,0.35,53293,66,53293,51585,0,35010,2,147,0.9999624730274885,0.5078232200030492,0.9999431155607383,0.6735760463602525,0.6313212422289316,53293,2,35157,51651
30,15,safari,High,125,0.35,57010,72,57010,47862,0,35010,4,145,0.9999298417932437,0.5432421100777558,0.9998862311214767,0.7040096815223701,0.6578374481631372,57010,4,35155,47934
30,15,giraffe,High,125,0.3,45588,60,45588,44151,0,29885,2,132,0.9999561307304233,0.5076671232419069,0.9999333755288318,0.6734372807244311,0.6309986813333556,45588,2,30017,44211
30,15,safari,High,125,0.3,48779,64,48779,40956,0,29885,4,130,0.9999180042227825,0.5432020401118053,0.9998667510576634,0.7039730989594608,0.6576140479727587,48779,4,30015,41020
30,15,giraffe,High,125,0.45,68693,84,68693,66567,0,45255,5,180,0.9999272176773705,0.5075437403948457,0.9998899647887324,0.6733221591633095,0.6312948048499867,68693,5,45435,66651
30,15,safari,High,125,0.45,73597,92,73597,61655,0,45255,7,178,0.9999048964730177,0.5437773377467786,0.9998459507042253,0.704452782510481,0.658410036286397,73597,7,45433,61747
30,15,giraffe,High,125,0.4,60861,74,60861,59008,0,40042,3,162,0.9999507097791798,0.5074160226107401,0.9999253861267938,0.6732150856991156,0.6310646269122697,60861,3,40204,59082
30,15,safari,High,125,0.4,65157,82,65157,54704,0,40042,5,160,0.9999232681624259,0.5432330356919537,0.9998756435446564,0.704000432187137,0.6578769903215735,65157,5,40202,54786
30,15,giraffe,High,125,0.55,83939,106,83939,81388,0,55338,6,218,0.9999285246292215,0.5073896985486571,0.9998920125265469,0.6731868889797817,0.6312133758682323,83939,6,55556,81494
30,15,safari,High,125,0.55,89916,116,89916,75401,0,55338,8,216,0.9999110359859437,0.5435191285898219,0.9998560167020626,0.704237596776278,0.6582501866558067,89916,8,55554,75517
30,15,giraffe,High,125,0.5,76327,94,76327,74042,0,50381,6,203,0.9999213970366683,0.5072808597462499,0.9998813994860645,0.6730894724774688,0.6312315658060312,76327,6,50584,74136
30,15,safari,High,125,0.5,81782,103,81782,68578,0,50381,8,201,0.9999021885316053,0.5435356200527705,0.9998418659814192,0.7042492454349352,0.6583537674145623,81782,8,50582,68681
30,15,giraffe,High,125,0.65,99283,135,99283,96275,0,65462,6,269,0.999939570345154,0.5073405793768812,0.9999087272008154,0.673146158070662,0.6311976437287228,99283,6,65731,96410
30,15,safari,High,125,0.65,106309,146,106309,89238,0,65462,9,266,0.9999153482947384,0.5432437542477248,0.999863090801223,0.704007469926592,0.6580614313582986,106309,9,65728,89384
30,15,giraffe,High,125,0.6,91585,125,91585,88851,0,60358,6,239,0.9999344913801574,0.5072247052242732,0.9999009950002475,0.6730430053793468,0.6310311655139241,91585,6,60597,88976
30,15,safari,High,125,0.6,98092,136,98092,82333,0,60358,8,237,0.9999184505606524,0.5432623877803069,0.9998679933336634,0.7040238856531771,0.6580045114527873,98092,8,60595,82469
30,15,giraffe,High,125,0.75,114498,153,114498,110916,0,75413,6,314,0.9999476000838399,0.5076008458684116,0.9999207742991827,0.6733770300907751,0.6313474941918353,114498,6,75727,111069
30,15,safari,High,125,0.75,122590,164,122590,102813,0,75413,9,311,0.9999265899395591,0.5434748877273715,0.999881161448774,0.7042043163318646,0.658194490540989,122590,9,75724,102977
30,15,giraffe,High,125,0.7,106949,142,106949,103620,0,70489,6,291,0.999943901640877,0.5075624908049413,0.9999152374763371,0.673342441432196,0.6313708494229068,106949,6,70780,103762
30,15,safari,High,125,0.7,114537,153,114537,96021,0,70489,9,288,0.9999214289455765,0.5435738997964036,0.9998728562145057,0.7042861491067064,0.6583160744164236,114537,9,70777,96174
30,15,giraffe,High,125,0.85,129906,180,129906,125560,0,85287,8,365,0.9999384208014532,0.508147985886734,0.9999066075180948,0.6738562091503268,0.6315681529184954,129906,8,85652,125740
30,15,safari,High,125,0.85,139029,193,139029,116424,0,85287,11,362,0.9999208860759494,0.5438340517747198,0.9998715853373803,0.7045043401590124,0.6582890426772456,139029,11,85649,116617
30,15,giraffe,High,125,0.8,122075,167,122075,118232,0,80297,6,338,0.9999508523029792,0.5076432379384049,0.9999255961607619,0.6734150680586394,0.6312691714806222,122075,6,80635,118399
30,15,safari,High,125,0.8,130684,179,130684,109611,0,80297,9,335,0.9999311363271177,0.5434433660187796,0.9998883942411428,0.7041789814288448,0.6580695389502204,130684,9,80632,109790
30,15,giraffe,High,125,0.95,145114,209,145114,140263,0,95215,8,397,0.9999448739681096,0.5081271490899414,0.9999163354946664,0.6738393528794451,0.6314853386358033,145114,8,95612,140472
30,15,safari,High,125,0.95,155282,223,155282,130081,0,95215,11,394,0.9999291661568777,0.5437311352797406,0.9998849613051662,0.7044200336146651,0.6581507111640426,155282,11,95609,130304
30,15,giraffe,High,125,0.9,137522,196,137522,132827,0,90235,8,382,0.999941830873264,0.5083146981093718,0.9999117241379311,0.6740035532683943,0.6316665282277044,137522,8,90617,133023
30,15,safari,High,125,0.9,147130,210,147130,123205,0,90235,11,379,0.9999252417748962,0.5438281986360864,0.9998786206896552,0.7045005099524525,0.6582606528781461,147130,11,90614,123415
30,15,giraffe,Mid,125,0.15,34564,57,34564,10338,0,14956,1,66,0.999971069000434,0.7687893413999421,0.9999334353990548,0.8692721694079775,0.8266813377346537,34564,1,15022,10395
30,15,safari,Mid,125,0.15,34715,57,34715,10187,0,14956,1,66,0.999971194838115,0.7721479570275139,0.9999334353990548,0.8714151239410103,0.8291987596278884,34715,1,15022,10244
30,15,giraffe,Mid,125,0.1,23094,43,23094,6816,0,10014,1,45,0.9999567005845421,0.7710079123960872,0.9999005964214712,0.8706831548786006,0.8285557193911979,23094,1,10059,6859
30,15,safari,Mid,125,0.1,23181,43,23181,6729,0,10014,1,45,0.9999568630834268,0.7739124628584783,0.9999005964214712,0.8725322292274396,0.8307300127458576,23181,1,10059,6772
30,15,giraffe,Mid,125,0.25,57584,103,57584,17310,0,24986,3,110,0.999947904909094,0.7678173793618411,0.9998804733256305,0.868641766729017,0.8260070332480819,57584,3,25096,17413
30,15,safari,Mid,125,0.25,57827,103,57827,17067,0,24986,3,110,0.9999481238111707,0.7710575089670253,0.9998804733256305,0.8707115270238732,0.828434702685422,57827,3,25096,17170
30,15,giraffe,Mid,125,0.2,46015,79,46015,13896,0,19910,1,90,0.9999782684283728,0.767044507417903,0.999950002499875,0.868158406127955,0.8252803440387043,46015,1,20000,13975
30,15,safari,Mid,125,0.2,46199,79,46199,13712,0,19910,1,90,0.999978354978355,0.7701116852808801,0.999950002499875,0.8701195969488651,0.827580602817817,46199,1,20000,13791
30,15,giraffe,Mid,125,0.35,80637,137,80637,24169,0,35010,5,149,0.9999379975695047,0.7683885537863412,0.9998578091229666,0.8690034216127381,0.8264826168571163,80637,5,35159,24306
30,15,safari,Mid,125,0.35,80988,137,80988,23818,0,35010,5,149,0.9999382662699245,0.7717332266087304,0.9998578091229666,0.8711384562430083,0.8289878450041753,80988,5,35159,23955
30,15,giraffe,Mid,125,0.3,68963,122,68963,20712,0,29885,5,132,0.999927502609906,0.767987794692473,0.9998334554659916,0.8687431108871603,0.8260793363323012,68963,5,30017,20834
30,15,safari,Mid,125,0.3,69256,122,69256,20419,0,29885,5,132,0.9999278093010496,0.7712507099346303,0.9998334554659916,0.8708269939267437,0.8285246914095428,69256,5,30017,20541
30,15,giraffe,Mid,125,0.45,103922,183,103922,31237,0,45257,5,191,0.9999518893069174,0.7678473792318719,0.9998899962598728,0.8686624677664052,0.8261843524433751,103922,5,45448,31420
30,15,safari,Mid,125,0.45,104382,183,104382,30777,0,45257,5,191,0.9999521013152979,0.7712461763532384,0.9998899962598728,0.8708333159525965,0.8287286705937664,104382,5,45448,30960
30,15,giraffe,Mid,125,0.4,92165,162,92165,27614,0,40042,5,169,0.9999457524140176,0.7684194729075129,0.9998756713745773,0.8690261231147842,0.8265389586468278,92165,5,40211,27776
30,15,safari,Mid,125,0.4,92564,162,92564,27215,0,40042,5,169,0.9999459862372932,0.7717461085033475,0.9998756713745773,0.8711495929603313,0.8290302640533976,92564,5,40211,27377
30,15,giraffe,Mid,125,0.55,126879,225,126879,38327,0,55340,6,233,0.9999527130866532,0.7669602432434066,0.999892045556775,0.8680948015161675,0.8255373060042532,126879,6,55573,38552
30,15,safari,Mid,125,0.55,127462,225,127462,37744,0,55340,6,233,0.9999529293626636,0.7704843711275395,0.999892045556775,0.8703477990706694,0.8281751956925026,127462,6,55573,37969
30,15,giraffe,Mid,125,0.5,115481,199,115481,34781,0,50383,5,215,0.9999567047087958,0.7675145054200092,0.9999011916289549,0.868451232764423,0.8260006764015437,115481,5,50598,34980
30,15,safari,Mid,125,0.5,115996,199,115996,34266,0,50383,5,215,0.9999568969233024,0.7709373193053349,0.9999011916289549,0.8706382148298819,0.828562049894561,115996,5,50598,34465
30,15,giraffe,Mid,125,0.65,149980,265,149980,45448,0,65462,6,281,0.9999599962663182,0.7664045213676524,0.9999087438592222,0.867741459562195,0.8251275617536585,149980,6,65743,45713
30,15,safari,Mid,125,0.65,150671,265,150671,44757,0,65462,6,281,0.9999601797221872,0.7699355623348817,0.9999087438592222,0.8700002887086064,0.8277705953901822,150671,6,65743,45022
30,15,giraffe,Mid,125,0.6,138420,246,138420,41894,0,60360,6,254,0.999956655541589,0.766614975631369,0.9999010227647641,0.867875079157079,0.8252508499875612,138420,6,60614,42140
30,15,safari,Mid,125,0.6,139058,246,139058,41256,0,60360,6,254,0.999956854397975,0.7701484271156402,0.9999010227647641,0.8701349085175081,0.8278961771291152,139058,6,60614,41502
30,15,giraffe,Mid,125,0.75,172964,299,172964,52299,0,75413,7,322,0.999959530788398,0.7668135590214664,0.9999075809986533,0.8680034024785902,0.8254088893609113,172964,7,75735,52598
30,15,safari,Mid,125,0.75,173773,300,173773,51489,0,75413,7,322,0.9999597191851767,0.7704001560546546,0.9999075809986533,0.8702966379694598,0.8280938852454663,173773,7,75735,51789
30,15,giraffe,Mid,125,0.7,161558,286,161558,48862,0,70489,6,300,0.9999628630140378,0.7667460822188262,0.9999152482519952,0.8679614258468316,0.8253860554669433,161558,6,70789,49148
30,15,safari,Mid,125,0.7,162309,287,162309,48110,0,70489,6,300,0.9999630348396636,0.7703102901673422,0.9999152482519952,0.870240549459682,0.828053896788999,162309,6,70789,48397
30,15,giraffe,Mid,125,0.85,196048,333,196048,59257,0,85287,8,354,0.999959195331946,0.7668969402045079,0.9999065955235905,0.868056693248084,0.8253727800941729,196048,8,85641,59590
30,15,safari,Mid,125,0.85,196964,334,196964,58340,0,85287,8,354,0.9999593850902666,0.7704801320617436,0.9999065955235905,0.8703475398245731,0.8280567381705134,196964,8,85641,58674
30,15,giraffe,Mid,125,0.8,184469,316,184469,55683,0,80297,7,341,0.9999620546846202,0.7671249397009166,0.9999131998263997,0.8682038103844272,0.8255878771647364,184469,7,80638,55999
30,15,safari,Mid,125,0.8,185335,317,185335,54816,0,80297,7,341,0.9999622319819577,0.7707262504782341,0.9999131998263997,0.8705056245743408,0.8282847471139443,185335,7,80638,55133
30,15,giraffe,Mid,125,0.95,219091,369,219091,66117,0,95213,10,391,0.9999543589486127,0.7671871334176071,0.9998954128056561,0.8682407396399289,0.825557266567154,219091,10,95604,66486
30,15,safari,Mid,125,0.95,220115,370,220115,65092,0,95213,10,391,0.9999545712663259,0.7707728563574797,0.9998954128056561,0.8705324479634251,0.8282435839251189,220115,10,95604,65462
30,15,giraffe,Mid,125,0.9,207546,353,207546,62637,0,90235,9,374,0.9999566379995664,0.7671659224650323,0.9999006819837118,0.8682280151686603,0.8255619486424074,207546,9,90609,62990
30,15,safari,Mid,125,0.9,208524,354,208524,61658,0,90235,9,374,0.9999568413632375,0.7707809681521128,0.9999006819837118,0.8705384819305778,0.828269934709293,208524,9,90609,62012
30,15,giraffe,None,125,0.15,35814,52,35814,9095,0,14958,1,59,0.9999720787379589,0.7965570160806031,0.9999334132374484,0.8867485391700506,0.8474799513162941,35814,1,15017,9147
30,15,safari,None,125,0.15,35814,52,35814,9095,0,14958,1,59,0.9999720787379589,0.7965570160806031,0.9999334132374484,0.8867485391700506,0.8474799513162941,35814,1,15017,9147
30,15,giraffe,None,125,0.1,23877,34,23877,6044,0,10014,0,33,1.0,0.7970956434651978,1.0,0.8870931787784218,0.848057597120144,23877,0,10047,6078
30,15,safari,None,125,0.1,23877,34,23877,6044,0,10014,0,33,1.0,0.7970956434651978,1.0,0.8870931787784218,0.848057597120144,23877,0,10047,6078
30,15,giraffe,None,125,0.25,59883,86,59883,15031,0,24988,3,105,0.9999499048191564,0.79844,0.9998804590372968,0.8879053422890442,0.8489450127877238,59883,3,25093,15117
30,15,safari,None,125,0.25,59883,86,59883,15031,0,24988,3,105,0.9999499048191564,0.79844,0.9998804590372968,0.8879053422890442,0.8489450127877238,59883,3,25093,15117
30,15,giraffe,None,125,0.2,47853,72,47853,12068,0,19912,1,84,0.9999791031052786,0.7976430583568083,0.9999499924988748,0.887423850454811,0.8482185273159145,47853,1,19996,12140
30,15,safari,None,125,0.2,47853,72,47853,12068,0,19912,1,84,0.9999791031052786,0.7976430583568083,0.9999499924988748,0.887423850454811,0.8482185273159145,47853,1,19996,12140
30,15,giraffe,None,125,0.35,83799,131,83799,21016,0,35012,4,145,0.9999522690118492,0.7984963695614887,0.9998862375927875,0.8879411281649175,0.849036807582776,83799,4,35157,21147
30,15,safari,None,125,0.35,83799,131,83799,21016,0,35012,4,145,0.9999522690118492,0.7984963695614887,0.9998862375927875,0.8879411281649175,0.849036807582776,83799,4,35157,21147
30,15,giraffe,None,125,0.3,71738,109,71738,17953,0,29887,4,130,0.9999442446544562,0.7988641425389755,0.9998667599347124,0.8881653068551832,0.8492250940986972,71738,4,30017,18062
30,15,safari,None,125,0.3,71738,109,71738,17953,0,29887,4,130,0.9999442446544562,0.7988641425389755,0.9998667599347124,0.8881653068551832,0.8492250940986972,71738,4,30017,18062
30,15,giraffe,None,125,0.45,108084,177,108084,27085,0,45257,8,177,0.9999259889723568,0.7985755027854535,0.9998239514105893,0.887979690927464,0.8491603425006085,108084,8,45434,27262
30,15,safari,None,125,0.45,108084,177,108084,27085,0,45257,8,177,0.9999259889723568,0.7985755027854535,0.9998239514105893,0.887979690927464,0.8491603425006085,108084,8,45434,27262
30,15,giraffe,None,125,0.4,95755,150,95755,24040,0,40044,5,160,0.9999477861319966,0.798324231939639,0.99987564973016,0.8878329199601307,0.8489266580915868,95755,5,40204,24190
30,15,safari,None,125,0.4,95755,150,95755,24040,0,40044,5,160,0.9999477861319966,0.798324231939639,0.99987564973016,0.8878329199601307,0.8489266580915868,95755,5,40204,24190
30,15,giraffe,None,125,0.55,132064,220,132064,33151,0,55340,9,215,0.9999318558675884,0.7982833136881554,0.9998380246202577,0.8878013364346505,0.848958592572817,132064,9,55555,33371
30,15,safari,None,125,0.55,132064,220,132064,33151,0,55340,9,215,0.9999318558675884,0.7982833136881554,0.9998380246202577,0.8878013364346505,0.848958592572817,132064,9,55555,33371
30,15,giraffe,None,125,0.5,120135,195,120135,30135,0,50383,9,200,0.9999250898921295,0.7984248828631243,0.9998221062618596,0.8878862122102369,0.8491024933227891,120135,9,50583,30330
30,15,safari,None,125,0.5,120135,195,120135,30135,0,50383,9,200,0.9999250898921295,0.7984248828631243,0.9998221062618596,0.8878862122102369,0.8491024933227891,120135,9,50583,30330
30,15,giraffe,None,125,0.65,156176,274,156176,39245,0,65464,9,266,0.9999423760284278,0.7980582028156059,0.9998630949664583,0.8876662498579062,0.8488031396069371,156176,9,65730,39519
30,15,safari,None,125,0.65,156176,274,156176,39245,0,65464,9,266,0.9999423760284278,0.7980582028156059,0.9998630949664583,0.8876662498579062,0.8488031396069371,156176,9,65730,39519
30,15,giraffe,None,125,0.6,144057,246,144057,36260,0,60360,9,236,0.99993752863271,0.797821259061934,0.9998514974012045,0.8875177510327174,0.8485910236847343,144057,9,60596,36506
30,15,safari,None,125,0.6,144057,246,144057,36260,0,60360,9,236,0.99993752863271,0.797821259061934,0.9998514974012045,0.8875177510327174,0.8485910236847343,144057,9,60596,36506
30,15,giraffe,None,125,0.75,179906,309,179906,45352,0,75415,9,311,0.999949976377734,0.7975723399256097,0.9998811645870469,0.8873686131566876,0.8484245043179268,179906,9,75726,45661
30,15,safari,None,125,0.75,179906,309,179906,45352,0,75415,9,311,0.999949976377734,0.7975723399256097,0.9998811645870469,0.8873686131566876,0.8484245043179268,179906,9,75726,45661
30,15,giraffe,None,125,0.7,168124,294,168124,42293,0,70491,9,288,0.9999464709485942,0.7978890518292827,0.9998728598067469,0.8875632186335272,0.848681522847328,168124,9,70779,42587
30,15,safari,None,125,0.7,168124,294,168124,42293,0,70491,9,288,0.9999464709485942,0.7978890518292827,0.9998728598067469,0.8875632186335272,0.848681522847328,168124,9,70779,42587
30,15,giraffe,None,125,0.85,203823,342,203823,51479,0,85291,11,362,0.9999460345182845,0.7972923283941732,0.9998715913335824,0.8871937285354251,0.848137166430321,203823,11,85653,51821
30,15,safari,None,125,0.85,203823,342,203823,51479,0,85291,11,362,0.9999460345182845,0.7972923283941732,0.9998715913335824,0.8871937285354251,0.848137166430321,203823,11,85653,51821
30,15,giraffe,None,125,0.8,191753,325,191753,48394,0,80299,9,335,0.9999530668224152,0.7974026082038658,0.9998883970090399,0.8872647686207007,0.8482537408716504,191753,9,80634,48719
30,15,safari,None,125,0.8,191753,325,191753,48394,0,80299,9,335,0.9999530668224152,0.7974026082038658,0.9998883970090399,0.8872647686207007,0.8482537408716504,191753,9,80634,48719
30,15,giraffe,None,125,0.95,227585,390,227585,57609,0,95218,12,393,0.9999472752277051,0.7969108913664631,0.9998745071792351,0.8869580128648568,0.8478228364117133,227585,12,95611,57999
30,15,safari,None,125,0.95,227585,390,227585,57609,0,95218,12,393,0.9999472752277051,0.7969108913664631,0.9998745071792351,0.8869580128648568,0.8478228364117133,227585,12,95611,57999
30,15,giraffe,None,125,0.9,215626,368,215626,54549,0,90238,12,378,0.9999443511811462,0.797011935256133,0.9998675905901045,0.8870194433760267,0.8479141459308749,215626,12,90616,54917
30,15,safari,None,125,0.9,215626,368,215626,54549,0,90238,12,378,0.9999443511811462,0.797011935256133,0.9998675905901045,0.8870194433760267,0.8479141459308749,215626,12,90616,54917
30,15,giraffe,Single-stranded,125,0.15,35518,69,35518,9374,0,14958,1,59,0.9999718460542245,0.7899735326171571,0.9999334132374484,0.8826540755467196,0.8425448907117491,35518,1,15017,9443
30,15,safari,Single-stranded,125,0.15,35554,69,35554,9338,0,14958,2,58,0.9999437507031163,0.7907742265519005,0.9998668264748968,0.8831426903635258,0.8431284282832324,35554,2,15016,9407
30,15,giraffe,Single-stranded,125,0.1,23643,49,23643,6263,0,10014,0,33,1.0,0.7892839258888332,1.0,0.882234411731781,0.8422078896055197,23643,0,10047,6312
30,15,safari,Single-stranded,125,0.1,23664,49,23664,6242,0,10014,1,32,0.9999577435030635,0.7899849774661993,0.9999004678013337,0.8826557254755688,0.8427078646067696,23664,1,10046,6291
30,15,giraffe,Single-stranded,125,0.25,59417,112,59417,15471,0,24987,3,105,0.9999495119488387,0.7922266666666666,0.9998804542737597,0.8840499925606308,0.8442879264698536,59417,3,25092,15583
30,15,safari,Single-stranded,125,0.25,59481,112,59481,15407,0,24987,4,104,0.9999327561570144,0.79308,0.9998406056983463,0.8845744878610998,0.844917328537889,59481,4,25091,15519
30,15,giraffe,Single-stranded,125,0.2,47495,81,47495,12417,0,19911,1,84,0.9999789455954186,0.791675695497808,0.9999499899979996,0.8837183339690573,0.8437410143894786,47495,1,19995,12498
30,15,safari,Single-stranded,125,0.2,47545,81,47545,12367,0,19911,2,83,0.9999579363577092,0.7925091260647076,0.9998999799959992,0.8842291240468663,0.8443535986198102,47545,2,19994,12448
30,15,giraffe,Single-stranded,125,0.35,83063,147,83063,21736,0,35010,4,145,0.999951846100136,0.7914832389991043,0.9998862311214767,0.8835878370112704,0.8437814496270654,83063,4,35155,21883
30,15,safari,Single-stranded,125,0.35,83147,147,83147,21652,0,35010,5,144,0.9999398691552819,0.7922836506393764,0.9998577889018458,0.884081702091463,0.8443738624602977,83147,5,35154,21799
30,15,giraffe,Single-stranded,125,0.3,71061,134,71061,18605,0,29885,4,130,0.9999437135017237,0.7913251670378619,0.9998667510576634,0.8834861529854224,0.8435723883524315,71061,4,30015,18739
30,15,safari,Single-stranded,125,0.3,71136,134,71136,18530,0,29885,5,129,0.9999297170408062,0.7921603563474388,0.9998334388220793,0.8840009692993084,0.844189986563066,71136,5,30014,18664
30,15,giraffe,Single-stranded,125,0.45,107199,177,107199,27970,0,45255,8,177,0.9999253780070331,0.792036705924076,0.9998239436619718,0.8839222767807449,0.8442633832265772,107199,8,45432,28147
30,15,safari,Single-stranded,125,0.45,107303,177,107303,27866,0,45255,9,176,0.9999161323989861,0.7928051069111758,0.9998019366197183,0.8843969702214639,0.8448331176086644,107303,9,45431,28043
30,15,giraffe,Single-stranded,125,0.4,94981,160,94981,24804,0,40042,5,160,0.9999473606636767,0.7918712743340698,0.9998756435446564,0.8838278331185356,0.8440918627304062,94981,5,40202,24964
30,15,safari,Single-stranded,125,0.4,95075,160,95075,24710,0,40042,6,159,0.9999368959098032,0.7926549668598107,0.9998507722535876,0.8843116646359046,0.8446725610669864,95075,6,40201,24870
30,15,giraffe,Single-stranded,125,0.55,130929,226,130929,34278,0,55339,9,215,0.9999312651789396,0.7914321810037901,0.9998380217050915,0.8835479854641648,0.8438297525747073,130929,9,55554,34504
30,15,safari,Single-stranded,125,0.55,131020,226,131020,34187,0,55339,10,214,0.9999236815996336,0.7919822526339968,0.9998200241167684,0.8838877026812789,0.8442369997647017,131020,10,55553,34413
30,15,giraffe,Single-stranded,125,0.5,119123,199,119123,31143,0,50381,9,200,0.9999244535473256,0.7916990662280264,0.9998220992290967,0.8837116140016394,0.8440675437069458,119123,9,50581,31342
30,15,safari,Single-stranded,125,0.5,119235,199,119235,31031,0,50381,10,199,0.9999161390414693,0.792443425381318,0.9998023324767741,0.8841718883244968,0.8446196314441322,119235,10,50580,31230
30,15,giraffe,Single-stranded,125,0.65,154847,263,154847,40584,0,65463,9,266,0.9999418814899003,0.7912710660521017,0.9998630928838723,0.8834517187277137,0.8437222681232596,154847,9,65729,40847
30,15,safari,Single-stranded,125,0.65,154957,263,154957,40474,0,65463,10,265,0.9999354701323507,0.7918331681093953,0.9998478809820803,0.8837994530329863,0.8441392025459775,154957,10,65728,40737
30,15,giraffe,Single-stranded,125,0.6,142911,245,142911,37406,0,60359,9,236,0.9999370277078086,0.7914788272172439,0.9998514949508284,0.8835793027123612,0.8438420009454068,142911,9,60595,37651
30,15,safari,Single-stranded,125,0.6,142930,245,142930,37387,0,60359,10,235,0.9999300405764656,0.7915840542306798,0.9998349943898093,0.8836421413159733,0.8439166383321032,142930,10,60594,37632
30,15,giraffe,Single-stranded,125,0.75,178546,308,178546,46712,0,75414,9,311,0.9999495953627734,0.7915465983348554,0.9998811630179312,0.8836264386161571,0.8439130434782609,178546,9,75725,47020
30,15,safari,Single-stranded,125,0.75,178604,308,178604,46654,0,75414,10,310,0.999944013347218,0.791803729285442,0.9998679589088124,0.883784452471671,0.8441022236973117,178604,10,75724,46962
30,15,giraffe,Single-stranded,125,0.7,166765,284,166765,43661,0,70490,9,288,0.9999460347536187,0.7914432157942195,0.9998728580106516,0.8835606277352153,0.8438562400309773,166765,9,70778,43945
30,15,safari,Single-stranded,125,0.7,166878,284,166878,43548,0,70490,10,287,0.9999400795743253,0.7919794978880926,0.9998587311229463,0.883892393497847,0.8442541128324635,166878,10,70777,43832
30,15,giraffe,Single-stranded,125,0.85,202255,351,202255,53037,0,85292,11,362,0.9999456161688074,0.7911618937346221,0.9998715928325453,0.8833851267391556,0.8435460053675858,202255,11,85654,53388
30,15,safari,Single-stranded,125,0.85,202281,351,202281,53011,0,85292,12,361,0.9999406801026234,0.7912635980644883,0.9998599194536859,0.8834465951574019,0.8436192529914329,202281,12,85653,53362
30,15,giraffe,Single-stranded,125,0.8,190298,326,190298,49847,0,80300,9,335,0.9999527079928747,0.7913552985599095,0.9998883983929369,0.8835084428638417,0.8437257680270308,190298,9,80635,50173
30,15,safari,Single-stranded,125,0.8,190415,326,190415,49730,0,80300,10,334,0.9999474858868321,0.7918418437150425,0.9998759982143743,0.8838095503323307,0.8440870093268766,190415,10,80634,50056
30,15,giraffe,Single-stranded,125,0.95,225996,387,225996,59199,0,95219,12,393,0.9999469045343528,0.7913523961594218,0.9998745084915921,0.8835043687327743,0.8436593337985236,225996,12,95612,59586
30,15,safari,Single-stranded,125,0.95,226024,387,226024,59171,0,95219,13,392,0.9999424872919035,0.7914504415544397,0.9998640508658914,0.8835637456779362,0.8437301616448849,226024,13,95611,59558
30,15,giraffe,Single-stranded,125,0.9,214083,371,214083,56087,0,90239,12,378,0.9999439501156029,0.7913144403251263,0.9998675920511094,0.8834795599171338,0.843647036021818,214083,12,90617,56458
30,15,safari,Single-stranded,125,0.9,214110,371,214110,56060,0,90239,13,377,0.9999392872321049,0.791414240355436,0.9998565580553685,0.883539936946008,0.843719024282194,214110,13,90616,56431
30,5,giraffe,High,125,0.15,30873,49,30873,14038,0,14956,2,58,0.9999352226720648,0.6866770462633452,0.9998668087373468,0.8142150721962155,0.7650893690809657,30873,2,15014,14087
30,5,safari,High,125,0.15,37439,63,37439,7458,0,14956,3,57,0.999919876074996,0.8327179715302491,0.9998002131060203,0.9086915366131889,0.8745498199279712,37439,3,15013,7521
30,5,giraffe,High,125,0.1,20620,34,20620,9300,0,10014,1,32,0.999951505746569,0.6883888629231488,0.9999004678013337,0.8154226396440929,0.7666308342291442,20620,1,10046,9334
30,5,safari,High,125,0.1,24964,42,24964,4948,0,10014,2,31,0.9999198910518304,0.8334112305535154,0.9998009356026675,0.9091041514930808,0.875203119922002,24964,2,10045,4990
30,5,giraffe,High,125,0.25,51484,99,51484,23416,0,24986,3,105,0.9999417328646066,0.6864624861664822,0.999880449509843,0.8140663788877821,0.7650385141818109,51484,3,25091,23515
30,5,safari,High,125,0.25,62439,116,62439,12444,0,24986,7,101,0.9998879031483201,0.8325311004146722,0.9997210488563003,0.9085670631889119,0.8744467645090066,62439,7,25087,12560
30,5,giraffe,High,125,0.2,41194,70,41194,18728,0,19910,2,83,0.9999514515972424,0.6866582210961462,0.9998999749937484,0.814207218247223,0.7649618062935227,41194,2,19993,18798
30,5,safari,High,125,0.2,49957,87,49957,9948,0,19910,4,81,0.99991993755129,0.8327276970262701,0.9997999499874969,0.9086973525051613,0.8744921049670571,49957,4,19991,10035
30,5,giraffe,High,125,0.35,72111,140,72111,32693,0,35010,4,145,0.9999445330375095,0.6871379021192255,0.9998862311214767,0.8145420453069316,0.7656224349228782,72111,4,35155,32833
30,5,safari,High,125,0.35,87467,164,87467,17313,0,35010,8,141,0.9999085452986568,0.8334635615185242,0.9997724622429535,0.9091305952114916,0.8751989607645804,87467,8,35151,17477
30,5,giraffe,High,125,0.3,61646,121,61646,28032,0,29885,4,130,0.9999351175993512,0.6864887136827804,0.9998667510576634,0.8140826284755923,0.7650019195780267,61646,4,30015,28153
30,5,safari,High,125,0.3,74773,143,74773,14883,0,29885,8,126,0.9998930209545205,0.8326707424358846,0.999733502115327,0.9086523271357394,0.8745263649868968,74773,8,30011,15026
30,5,giraffe,High,125,0.45,92911,181,92911,42252,0,45255,7,178,0.9999246647581739,0.6864803759309611,0.9998459507042253,0.81407330173222,0.765244711921409,92911,7,45433,42433
30,5,safari,High,125,0.45,112791,216,112791,22337,0,45255,13,172,0.9998847558597213,0.8333653505142452,0.9997139084507042,0.9090623337685574,0.8751770068147624,112791,13,45427,22553
30,5,giraffe,High,125,0.4,82375,158,82375,37410,0,40042,5,160,0.9999393056567127,0.6867845559974322,0.9998756435446564,0.814291998438141,0.7653886980955354,82375,5,40202,37568
30,5,safari,High,125,0.4,99931,187,99931,19825,0,40042,11,154,0.9998899361629745,0.8331540815220563,0.9997264157982441,0.9089387634445277,0.8749734623790196,99931,11,40196,20012
30,5,giraffe,High,125,0.55,113486,223,113486,51724,0,55338,8,216,0.9999295116922481,0.6859937255565697,0.9998560167020626,0.8137326253822684,0.7649041833525645,113486,8,55554,51947
30,5,safari,High,125,0.55,137783,262,137783,27388,0,55338,16,208,0.9998838888526042,0.8328628508217828,0.9997120334041251,0.9087629273955257,0.8748116473223376,137783,16,55546,27650
30,5,giraffe,High,125,0.5,103284,200,103284,46979,0,50381,8,201,0.9999225496650272,0.686441184876016,0.9998418659814192,0.8140450434474198,0.7653006918573709,103284,8,50582,47179
30,5,safari,High,125,0.5,125390,238,125390,24835,0,50381,16,193,0.9998724143980352,0.8333610256342091,0.9996837319628386,0.9090546600016675,0.8752120087738059,125390,16,50574,25073
30,5,giraffe,High,125,0.65,134166,268,134166,61259,0,65462,8,267,0.9999403759297628,0.6855942726617712,0.9998783029344205,0.8134551197907035,0.7646215048005203,134166,8,65729,61527
30,5,safari,High,125,0.65,163011,313,163011,32369,0,65462,18,257,0.9998895901956094,0.8329935153531296,0.9997261816024461,0.908843059527991,0.8749187162911678,163011,18,65719,32682
30,5,giraffe,High,125,0.6,123750,254,123750,56557,0,60358,8,237,0.9999353577142488,0.6853639490255371,0.9998679933336634,0.8132913160203602,0.7643968419830489,123750,8,60595,56811
30,5,safari,High,125,0.6,150378,297,150378,29886,0,60358,16,229,0.9998936127771054,0.8328376559722199,0.9997359866673267,0.9087519451284918,0.8747781592609178,150378,16,60587,30183
30,5,giraffe,High,125,0.75,154703,299,154703,70565,0,75413,9,311,0.9999418273954186,0.6858405706508488,0.999881161448774,0.8136289408565817,0.7647759707932293,154703,9,75724,70864
30,5,safari,High,125,0.75,188001,349,188001,37217,0,75413,19,301,0.9998989469205404,0.8334596816023621,0.9997491186140784,0.9091243196715565,0.8752572187188848,188001,19,75714,37566
30,5,giraffe,High,125,0.7,144550,280,144550,65881,0,70489,9,288,0.9999377416833265,0.6860106971159551,0.9998728562145057,0.8137472907929181,0.7649353279075798,144550,9,70777,66161
30,5,safari,High,125,0.7,175626,329,175626,34756,0,70489,19,278,0.9998918272652224,0.8334923188632772,0.9997315853417342,0.9091407924297799,0.8752952962198531,175626,19,70767,35085
30,5,giraffe,High,125,0.85,175346,342,175346,79958,0,85287,11,362,0.9999372708246606,0.6858937749857225,0.9998715853373803,0.8136648700821109,0.7646950244062513,175346,11,85649,80300
30,5,safari,High,125,0.85,213047,399,213047,42200,0,85287,23,350,0.9998920542544704,0.8333672343787895,0.9997314966145225,0.9090664709546932,0.8751208592875601,213047,23,85637,42599
30,5,giraffe,High,125,0.8,164909,321,164909,75244,0,80297,9,335,0.9999454274245383,0.685766444605238,0.9998883942411428,0.8135779689781741,0.764651293150429,164909,9,80632,75565
30,5,safari,High,125,0.8,200393,372,200393,39709,0,80297,21,323,0.9998952169010149,0.8333250164258922,0.9997395865626666,0.9090426593602003,0.8751163913239806,200393,21,80620,40081
30,5,giraffe,High,125,0.95,195815,399,195815,89372,0,95215,11,394,0.9999438276837601,0.6856603615023146,0.9998849613051662,0.8135027793241548,0.7644790480737449,195815,11,95609,89771
30,5,safari,High,125,0.95,237924,460,237924,47202,0,95215,24,381,0.9998991376267083,0.8331080655214191,0.9997490064839991,0.9089151802939255,0.874907530311695,237924,24,95596,47662
30,5,giraffe,High,125,0.9,185539,374,185539,84632,0,90235,11,379,0.9999407167879277,0.6857971871592526,0.9998786206896552,0.8135980442670935,0.764606694908215,185539,11,90614,85006
30,5,safari,High,125,0.9,225364,432,225364,44749,0,90235,24,366,0.9998935169574246,0.8330000554436415,0.9997351724137931,0.9088485743033838,0.8748373342193427,225364,24,90601,45181
30,5,giraffe,Mid,125,0.15,43434,79,43434,1446,0,14956,2,65,0.9999539552444977,0.9660802064102849,0.9998668707981095,0.9827252672662482,0.9745423627088127,43434,2,15021,1525
30,5,safari,Mid,125,0.15,44071,78,44071,810,0,14956,3,64,0.9999319326587104,0.9802486710113659,0.9998003061971643,0.989992474700392,0.9851455436630989,44071,3,15020,888
30,5,giraffe,Mid,125,0.1,28951,54,28951,948,0,10014,1,45,0.9999654600718431,0.9665475912262544,0.9999005964214712,0.9829725829725829,0.9749331467273136,28951,1,10059,1002
30,5,safari,Mid,125,0.1,29371,54,29371,528,0,10014,2,44,0.9999319102577197,0.9805695589757286,0.9998011928429423,0.9901560867073457,0.985404743458376,29371,2,10058,582
30,5,giraffe,Mid,125,0.25,72454,138,72454,2405,0,24986,6,107,0.9999171956941761,0.9660919770124138,0.999760946651261,0.9827136046440657,0.9745344469309463,72454,6,25093,2543
30,5,safari,Mid,125,0.25,73517,136,73517,1344,0,24986,9,104,0.9998775943203765,0.9802658773017587,0.9996414199768915,0.989974616726029,0.985124280690537,73517,9,25090,1480
30,5,giraffe,Mid,125,0.2,57961,104,57961,1925,0,19910,3,88,0.9999482437374922,0.9661776962827138,0.999850007499625,0.9827729453854892,0.9745971421784951,57961,3,19998,2029
30,5,safari,Mid,125,0.2,58808,103,58808,1079,0,19910,5,86,0.999914984782276,0.9802967161193532,0.999750012499375,0.9900086698147352,0.9851608305934417,58808,5,19996,1182
30,5,giraffe,Mid,125,0.35,101369,181,101369,3393,0,35010,8,146,0.9999210866370084,0.965943416902509,0.9997724945967467,0.9826386196200078,0.9744338255761668,101369,8,35156,3574
30,5,safari,Mid,125,0.35,102868,180,102868,1895,0,35010,11,143,0.9998930782764218,0.9802273615200633,0.9996871800705267,0.9899625641173697,0.9851113791602133,102868,11,35153,2075
30,5,giraffe,Mid,125,0.3,86759,162,86759,2876,0,29885,8,129,0.9999077990480252,0.9661681347929219,0.9997335287455865,0.9827484651457828,0.9745783223028067,86759,8,30014,3038
30,5,safari,Mid,125,0.3,88046,161,88046,1590,0,29885,11,126,0.9998750809134992,0.980500462153524,0.9996336020251816,0.9900929976272672,0.9852944858494896,88046,11,30011,1751
30,5,giraffe,Mid,125,0.45,130708,244,130708,4390,0,45257,9,187,0.9999311489706771,0.9657608133469285,0.9998019932677711,0.982548983496142,0.9743189800602893,130708,9,45444,4634
30,5,safari,Mid,125,0.45,132643,244,132643,2455,0,45257,12,184,0.9999095397836493,0.9800579273248511,0.9997359910236948,0.989884215121811,0.9850051162919329,132643,12,45441,2699
30,5,giraffe,Mid,125,0.4,115851,214,115851,3876,0,40042,9,165,0.9999223200414293,0.9658999007845525,0.9997762084742391,0.9826166979783802,0.9744063637555649,115851,9,40207,4090
30,5,safari,Mid,125,0.4,117551,214,117551,2176,0,40042,12,162,0.9998979270688907,0.9800735361552764,0.9997016112989855,0.989886486122339,0.9850022165749858,117551,12,40204,2390
30,5,giraffe,Mid,125,0.55,159709,300,159709,5422,0,55340,11,228,0.999931129476584,0.9654115613155938,0.9998020835207543,0.9823681920092511,0.9740599972851908,159709,11,55568,5722
30,5,safari,Mid,125,0.55,162077,301,162077,3053,0,55340,15,224,0.9999074599610098,0.9797256862377668,0.9997301138919376,0.9897136994959133,0.9847563458667029,162077,15,55564,3354
30,5,giraffe,Mid,125,0.5,145276,267,145276,4918,0,50383,10,210,0.9999311702435196,0.9655392427273513,0.9998023832579096,0.9824343104072061,0.9741624557354872,145276,10,50593,5185
30,5,safari,Mid,125,0.5,147439,268,147439,2754,0,50383,14,206,0.9999050544919398,0.9799150610457195,0.9997233365610735,0.98980913955034,0.9849003302431066,147439,14,50589,3022
30,5,giraffe,Mid,125,0.65,188897,348,188897,6448,0,65462,11,276,0.9999417705973278,0.9652721354366278,0.9998326970752407,0.9823011380625636,0.9739636324691519,188897,11,65738,6796
30,5,safari,Mid,125,0.65,191723,349,191723,3621,0,65462,15,272,0.9999217682462527,0.9797131220840807,0.9997718596480555,0.9897142975136218,0.984757613543348,191723,15,65734,3970
30,5,giraffe,Mid,125,0.6,174333,324,174333,5903,0,60360,11,249,0.9999369063460745,0.9655128489144883,0.9998185417354009,0.9824234159096544,0.9741355004560909,174333,11,60609,6227
30,5,safari,Mid,125,0.6,176912,325,176912,3323,0,60360,15,245,0.9999152192712248,0.9797961896322552,0.9997525569119102,0.9897534735528846,0.9848121734803881,176912,15,60605,3648
30,5,giraffe,Mid,125,0.75,217685,395,217685,7482,0,75413,13,316,0.9999402842469843,0.9650783376632589,0.9998283647117847,0.9822000631683436,0.9738138225844993,217685,13,75729,7877
30,5,safari,Mid,125,0.75,220990,396,220990,4176,0,75413,17,312,0.9999230793594773,0.979730628385987,0.9997755538538724,0.9897238724586794,0.9847695350874864,220990,17,75725,4572
30,5,giraffe,Mid,125,0.7,203365,377,203365,6964,0,70489,11,295,0.9999459129887499,0.9651599859519899,0.9998446217953245,0.9822450625721475,0.973882863648797,203365,11,70784,7341
30,5,safari,Mid,125,0.7,206428,378,206428,3900,0,70489,15,291,0.9999273407187456,0.9796968287566562,0.999788120629988,0.9897087131936071,0.9847496101257189,206428,15,70780,4278
30,5,giraffe,Mid,125,0.85,246721,442,246721,8475,0,85287,14,348,0.9999432589620443,0.9651186443330021,0.9998365421662834,0.9822223726195477,0.9738314087556807,246721,14,85635,8917
30,5,safari,Mid,125,0.85,250482,443,250482,4713,0,85287,18,344,0.9999281437125749,0.9798308545677873,0.9997898399280786,0.989777491514172,0.9848397389880071,250482,18,85631,5156
30,5,giraffe,Mid,125,0.8,232104,416,232104,7948,0,80297,13,335,0.9999439937617667,0.9652178252407805,0.9998387996775994,0.9822740882592549,0.973912610202639,232104,13,80632,8364
30,5,safari,Mid,125,0.8,235634,417,235634,4417,0,80297,17,331,0.9999278594192259,0.9798975331437031,0.9997891995783992,0.9898113706867401,0.9848931684484901,235634,17,80628,4834
30,5,giraffe,Mid,125,0.95,275498,496,275498,9583,0,95213,16,385,0.9999419267260465,0.9647065414931875,0.9998326604890497,0.9820082660388422,0.9735172131556097,275498,16,95598,10079
30,5,safari,Mid,125,0.95,279764,498,279764,5315,0,95213,21,380,0.99992494236646,0.9796447192876176,0.9997803668918778,0.9896809477821289,0.9846953364586257,279764,21,95593,5813
30,5,giraffe,Mid,125,0.9,261036,474,261036,9026,0,90235,15,368,0.9999425399634554,0.9648845255344944,0.9998344699728531,0.982100766196314,0.9736538983369976,261036,15,90603,9500
30,5,safari,Mid,125,0.9,265056,475,265056,5005,0,90235,20,363,0.9999245499403945,0.9797439157820031,0.9997792932971374,0.989731372710096,0.9847710395011546,265056,20,90598,5480
30,5,giraffe,None,125,0.15,44778,73,44778,110,0,14958,3,57,0.999933007302204,0.9959298058317209,0.9998002397123452,0.9979273918566557,0.996898914620117,44778,3,15015,183
30,5,safari,None,125,0.15,44778,73,44778,110,0,14958,3,57,0.999933007302204,0.9959298058317209,0.9998002397123452,0.9979273918566557,0.996898914620117,44778,3,15015,183
30,5,giraffe,None,125,0.1,29834,46,29834,75,0,10014,2,31,0.9999329668856415,0.9959606075780337,0.9998009356026675,0.997942834205817,0.9969251537423128,29834,2,10045,121
30,5,safari,None,125,0.1,29834,46,29834,75,0,10014,2,31,0.9999329668856415,0.9959606075780337,0.9998009356026675,0.997942834205817,0.9969251537423128,29834,2,10045,121
30,5,giraffe,None,125,0.25,74698,121,74698,181,0,24988,5,103,0.999933068283737,0.9959733333333334,0.9998007650621613,0.9979492728936628,0.9969329443734015,74698,5,25091,302
30,5,safari,None,125,0.25,74698,121,74698,181,0,24988,5,103,0.999933068283737,0.9959733333333334,0.9998007650621613,0.9979492728936628,0.9969329443734015,74698,5,25091,302
30,5,giraffe,None,125,0.2,59754,97,59754,142,0,19912,3,82,0.9999497966765399,0.9960162018902206,0.9998499774966245,0.9979791231732776,0.9969746218277284,59754,3,19994,239
30,5,safari,None,125,0.2,59754,97,59754,142,0,19912,3,82,0.9999497966765399,0.9960162018902206,0.9998499774966245,0.9979791231732776,0.9969746218277284,59754,3,19994,239
30,5,giraffe,None,125,0.35,104529,175,104529,242,0,35012,7,142,0.9999330374225147,0.996026527928649,0.9998009157873781,0.9979759597483315,0.9969737414975697,104529,7,35154,417
30,5,safari,None,125,0.35,104529,175,104529,242,0,35012,7,142,0.9999330374225147,0.996026527928649,0.9998009157873781,0.9979759597483315,0.9969737414975697,104529,7,35154,417
30,5,giraffe,None,125,0.3,89433,149,89433,218,0,29887,6,128,0.9999329151712341,0.995913140311804,0.9998001399020685,0.9979189796863406,0.9968870231428547,89433,6,30015,367
30,5,safari,None,125,0.3,89433,149,89433,218,0,29887,6,128,0.9999329151712341,0.995913140311804,0.9998001399020685,0.9979189796863406,0.9968870231428547,89433,6,30015,367
30,5,giraffe,None,125,0.45,134809,235,134809,302,0,45257,13,172,0.9999035765676225,0.9960323910569947,0.9997139210422077,0.9979642296645052,0.9969577626833639,134809,13,45429,537
30,5,safari,None,125,0.45,134809,235,134809,302,0,45257,13,172,0.9999035765676225,0.9960323910569947,0.9997139210422077,0.9979642296645052,0.9969577626833639,134809,13,45429,537
30,5,giraffe,None,125,0.4,119479,198,119479,268,0,40044,10,155,0.9999163102879763,0.9961148859894118,0.9997512994603198,0.9980119782487034,0.9970278606840915,119479,10,40199,466
30,5,safari,None,125,0.4,119479,198,119479,268,0,40044,10,155,0.9999163102879763,0.9961148859894118,0.9997512994603198,0.9980119782487034,0.9970278606840915,119479,10,40199,466
30,5,giraffe,None,125,0.55,164762,289,164762,384,0,55340,15,209,0.9999089678777985,0.9959319370145374,0.9997300410337628,0.9979164900124767,0.9968868637414648,164762,15,55549,673
30,5,safari,None,125,0.55,164762,289,164762,384,0,55340,15,209,0.9999089678777985,0.9959319370145374,0.9997300410337628,0.9979164900124767,0.9968868637414648,164762,15,55549,673
30,5,giraffe,None,125,0.5,149865,260,149865,340,0,50383,15,194,0.9998999199359487,0.9960123616787957,0.9997035104364327,0.9979523547919891,0.9969411659380176,149865,15,50577,600
30,5,safari,None,125,0.5,149865,260,149865,340,0,50383,15,194,0.9998999199359487,0.9960123616787957,0.9997035104364327,0.9979523547919891,0.9969411659380176,149865,15,50577,600
30,5,giraffe,None,125,0.65,194874,353,194874,468,0,65464,16,259,0.9999179024064857,0.9958046960831907,0.9997566132737036,0.9978570605630016,0.9967984271364857,194874,16,65723,821
30,5,safari,None,125,0.65,194874,353,194874,468,0,65464,16,259,0.9999179024064857,0.9958046960831907,0.9997566132737036,0.9978570605630016,0.9967984271364857,194874,16,65723,821
30,5,giraffe,None,125,0.6,179811,319,179811,433,0,60360,16,229,0.9999110255968237,0.9958352486389792,0.9997359953799192,0.9978689752767834,0.9968154979101705,179811,16,60589,752
30,5,safari,None,125,0.6,179811,319,179811,433,0,60360,16,229,0.9999110255968237,0.9958352486389792,0.9997359953799192,0.9978689752767834,0.9968154979101705,179811,16,60589,752
30,5,giraffe,None,125,0.75,224639,394,224639,534,0,75415,17,303,0.9999243287515134,0.9958859230295212,0.9997755331088665,0.997901040151214,0.9968636119242488,224639,17,75718,928
30,5,safari,None,125,0.75,224639,394,224639,534,0,75415,17,303,0.9999243287515134,0.9958859230295212,0.9997755331088665,0.997901040151214,0.9968636119242488,224639,17,75718,928
30,5,giraffe,None,125,0.7,209829,377,209829,505,0,70491,17,280,0.9999189882104019,0.9958141720175976,0.9997598463016331,0.997862358729019,0.9968063829711651,209829,17,70771,882
30,5,safari,None,125,0.7,209829,377,209829,505,0,70491,17,280,0.9999189882104019,0.9958141720175976,0.9997598463016331,0.997862358729019,0.9968063829711651,209829,17,70771,882
30,5,giraffe,None,125,0.85,254606,442,254606,596,0,85291,20,353,0.9999214534258088,0.9959396660981678,0.9997665296974225,0.9979265878848452,0.9969001605587915,254606,20,85644,1038
30,5,safari,None,125,0.85,254606,442,254606,596,0,85291,20,353,0.9999214534258088,0.9959396660981678,0.9997665296974225,0.9979265878848452,0.9969001605587915,254606,20,85644,1038
30,5,giraffe,None,125,0.8,239495,417,239495,560,0,80299,18,326,0.9999248475030583,0.9959371569247147,0.9997767940180797,0.9979270185526632,0.9969014216090809,239495,18,80625,977
30,5,safari,None,125,0.8,239495,417,239495,560,0,80299,18,326,0.9999248475030583,0.9959371569247147,0.9997767940180797,0.9979270185526632,0.9969014216090809,239495,18,80625,977
30,5,giraffe,None,125,0.95,284408,501,284408,675,0,95218,21,384,0.9999261678661459,0.995882122247745,0.9997803875636615,0.9979000478936444,0.9968599737150682,284408,21,95602,1176
30,5,safari,None,125,0.95,284408,501,284408,675,0,95218,21,384,0.9999261678661459,0.995882122247745,0.9997803875636615,0.9979000478936444,0.9968599737150682,284408,21,95602,1176
30,5,giraffe,None,125,0.9,269433,476,269433,634,0,90238,21,369,0.999922064619564,0.9958971401958284,0.9997682835326831,0.9979055439196884,0.9968685193440227,269433,21,90607,1110
30,5,safari,None,125,0.9,269433,476,269433,634,0,90238,21,369,0.999922064619564,0.9958971401958284,0.9997682835326831,0.9979055439196884,0.9968685193440227,269433,21,90607,1110
30,5,giraffe,Single-stranded,125,0.15,44484,84,44484,393,0,14958,3,57,0.9999325645694248,0.9893908053646494,0.9998002397123452,0.9946337536892944,0.9919971990196569,44484,3,15015,477
30,5,safari,Single-stranded,125,0.15,44606,84,44606,271,0,14958,3,57,0.9999327489968391,0.9921042681435022,0.9998002397123452,0.9960031260466673,0.9940312442688274,44606,3,15015,355
30,5,giraffe,Single-stranded,125,0.1,29634,58,29634,263,0,10014,2,31,0.9999325145093805,0.9892839258888333,0.9998009356026675,0.9945797184138545,0.9919254037298135,29634,2,10045,321
30,5,safari,Single-stranded,125,0.1,29713,58,29713,184,0,10014,2,31,0.9999326939256268,0.9919212151560675,0.9998009356026675,0.9959108429696665,0.9939003049847508,29713,2,10045,242
30,5,giraffe,Single-stranded,125,0.25,74255,141,74255,604,0,24987,5,103,0.999932669000808,0.9900666666666667,0.9998007571229328,0.9949752110411362,0.9925071182376742,74255,5,25090,745
30,5,safari,Single-stranded,125,0.25,74452,141,74452,407,0,24987,7,101,0.9999059885306008,0.9926933333333333,0.999721059972106,0.9962866070293526,0.9944552674958789,74452,7,25088,548
30,5,giraffe,Single-stranded,125,0.2,59402,100,59402,491,0,19911,3,82,0.999949499200404,0.9901488506992483,0.9998499699939988,0.9950250422955158,0.9925739789221018,59402,3,19993,591
30,5,safari,Single-stranded,125,0.2,59561,100,59561,332,0,19911,4,81,0.9999328464702426,0.9927991599019885,0.9997999599919984,0.9963532344134227,0.9945492505219468,59561,4,19992,432
30,5,giraffe,Single-stranded,125,0.35,103911,186,103911,849,0,35010,7,142,0.9999326391962894,0.9901377851466469,0.9998009044625843,0.9950111077064502,0.9925627208165304,103911,7,35152,1035
30,5,safari,Single-stranded,125,0.35,104201,186,104201,559,0,35010,9,140,0.9999136359274542,0.9929011110475864,0.9997440200233226,0.9963950352846679,0.9946183219728061,104201,9,35150,745
30,5,giraffe,Single-stranded,125,0.3,88903,170,88903,727,0,29885,6,128,0.9999325152684205,0.990011135857461,0.9998001265864952,0.9949470927597379,0.9924636326459075,88903,6,30013,897
30,5,safari,Single-stranded,125,0.3,89148,170,89148,482,0,29885,8,126,0.9999102696397326,0.992739420935412,0.999733502115327,0.9963119426004157,0.9944916916348826,89148,8,30011,652
30,5,giraffe,Single-stranded,125,0.45,134031,227,134031,1088,0,45255,13,172,0.9999030169198174,0.9902841605958063,0.9997139084507042,0.9950703441107688,0.9926542984523138,134031,13,45427,1315
30,5,safari,Single-stranded,125,0.45,134396,227,134396,723,0,45255,15,170,0.9998884019909084,0.9929809525216852,0.9996698943661971,0.9964227063616513,0.9946621972940383,134396,15,45425,950
30,5,giraffe,Single-stranded,125,0.4,118770,208,118770,967,0,40042,10,155,0.9999158107425492,0.990203843428238,0.9997512870893128,0.9950361294376373,0.9926007792597032,118770,10,40197,1175
30,5,safari,Single-stranded,125,0.4,119098,208,119098,639,0,40042,12,153,0.9998992527915372,0.9929384301138021,0.9997015445071754,0.996406684654159,0.9946363454718018,119098,12,40195,847
30,5,giraffe,Single-stranded,125,0.55,163819,289,163819,1325,0,55339,15,209,0.9999084439127409,0.9902437844928158,0.9997300361751525,0.9950526472437262,0.9926288258611016,163819,15,55548,1614
30,5,safari,Single-stranded,125,0.55,164158,289,164158,986,0,55339,16,208,0.9999025424245008,0.9922929524339158,0.9997120385868293,0.9960832142521245,0.9941582653079694,164158,16,55547,1275
30,5,giraffe,Single-stranded,125,0.5,149001,254,149001,1210,0,50381,15,194,0.9998993396682235,0.9902701624962615,0.9997034987151611,0.9950614563194327,0.9926438039342469,149001,15,50575,1464
30,5,safari,Single-stranded,125,0.5,149401,254,149401,810,0,50381,17,192,0.9998862252205223,0.9929285880437311,0.9996639652105159,0.9963952608183858,0.9946233617666808,149401,17,50573,1064
30,5,giraffe,Single-stranded,125,0.65,193765,340,193765,1589,0,65463,16,259,0.9999174325656283,0.9901427739225526,0.9997566095713286,0.9950060979523718,0.992560206860675,193765,16,65722,1929
30,5,safari,Single-stranded,125,0.65,194201,340,194201,1153,0,65463,18,257,0.9999073211168835,0.992370742076916,0.9997261857677446,0.9961247765527181,0.994220294378653,194201,18,65720,1493
30,5,giraffe,Single-stranded,125,0.6,178791,314,178791,1457,0,60359,16,229,0.9999105180445955,0.9901917346950078,0.9997359910236948,0.9950273952399901,0.9925901661096506,178791,16,60588,1771
30,5,safari,Single-stranded,125,0.6,178839,314,178839,1409,0,60359,16,229,0.9999105420592099,0.9904575713605299,0.9997359910236948,0.9951616089389205,0.9927891991408407,178839,16,60588,1723
30,5,giraffe,Single-stranded,125,0.75,223362,407,223362,1797,0,75414,17,303,0.9999238961585467,0.9902290238777121,0.9997755301449811,0.9950528461170076,0.9926286093594424,223362,17,75717,2204
30,5,safari,Single-stranded,125,0.75,223583,407,223583,1576,0,75414,17,303,0.9999239713774597,0.9912087814652918,0.9997755301449811,0.9955473032241976,0.9933620975771656,223583,17,75717,1983
30,5,giraffe,Single-stranded,125,0.7,208647,372,208647,1691,0,70490,17,280,0.9999185293102787,0.9902092923923876,0.9997598429090088,0.9950402266234911,0.9926109336866823,208647,17,70770,2063
30,5,safari,Single-stranded,125,0.7,209111,372,209111,1227,0,70490,19,278,0.9999091474202649,0.9924113710787338,0.9997315891335979,0.9961461509146341,0.9942521589928134,209111,19,70768,1599
30,5,giraffe,Single-stranded,125,0.85,253162,452,253162,2029,0,85292,20,353,0.999921005442725,0.990295059907762,0.9997665324228098,0.9950847540903061,0.9926723077103379,253162,20,85645,2481
30,5,safari,Single-stranded,125,0.85,253235,452,253235,1956,0,85292,20,353,0.999921028212671,0.9905806143723865,0.9997665324228098,0.9952289063820254,0.9928861907719714,253235,20,85645,2408
30,5,giraffe,Single-stranded,125,0.8,238133,426,238133,1912,0,80300,18,326,0.9999244177013743,0.9902774139085379,0.9997767967858737,0.9950775350903218,0.9926630646341653,238133,18,80626,2338
30,5,safari,Single-stranded,125,0.8,238611,426,238611,1434,0,80300,19,325,0.9999203788291497,0.9922651795850643,0.9997643966073111,0.9960780712208908,0.9941485137723246,238611,19,80625,1860
30,5,giraffe,Single-stranded,125,0.95,282804,502,282804,2276,0,95219,21,384,0.9999257491381597,0.9902724961657248,0.9997803898602862,0.9950757115939811,0.9926575132605467,282804,21,95603,2778
30,5,safari,Single-stranded,125,0.95,282892,502,282892,2188,0,95219,21,384,0.9999257722338669,0.990580638835781,0.9997803898602862,0.995231268524789,0.9928883595746132,282892,21,95603,2690
30,5,giraffe,Single-stranded,125,0.9,267891,480,267891,2170,0,90239,21,369,0.9999216160530323,0.9902048118399799,0.9997682860894416,0.9950394927690996,0.9926045906359886,267891,21,90608,2650
30,5,safari,Single-stranded,125,0.9,267973,480,267973,2088,0,90239,21,369,0.9999216400367172,0.9905079082283277,0.9997682860894416,0.9951925130214379,0.9928316305340975,267973,21,90608,2568
,,anc,High,125,0.15,41212,2,41212,3748,0,14956,2,58,0.9999514728005047,0.9165962368222054,0.9998668087373468,0.9564611956925363,0.9374437293674347,41212,2,15014,3750
,,aln,High,125,0.15,36878,2,36878,8082,0,14956,2,58,0.9999457700650759,0.820203727592189,0.9998668087373468,0.9011998729258816,0.8651839007636133,36878,2,15014,8084
,,bowtie2,Single-stranded,125,0.75,224502,114,224502,951,0,75414,12,301,0.999946551217296,0.9952785646836638,0.9998415360439473,0.9976070973891366,0.9964254183621314,224502,12,75715,1065
,,bowtie2,Single-stranded,125,0.7,209706,105,209706,900,0,70490,10,282,0.999952316466078,0.9952304341016843,0.9998587211437936,0.9975857877824212,0.9963942264994157,209706,10,70772,1005
,,bowtie2,Single-stranded,125,0.85,254437,129,254437,1080,0,85291,10,344,0.9999606990846817,0.9952708041588759,0.9998832389514858,0.9976102397013877,0.9964282679590144,254437,10,85635,1209
,,bowtie2,Single-stranded,125,0.8,239338,119,239338,1017,0,80299,13,321,0.9999456864604702,0.9952759965734341,0.9998387756873737,0.99760537696035,0.9964217534964981,239338,13,80620,1136
,,bowtie2,Single-stranded,125,0.95,284256,137,284256,1193,0,95219,14,383,0.9999507510465403,0.9953429089661258,0.9998535809906292,0.9976415094339623,0.9964743102082361,284256,14,95602,1330
,,mem,High,125,0.15,41623,98,41623,3257,0,14956,7,53,0.9998318520297862,0.925407977233314,0.9995338305807139,0.9611814151117679,0.943961062772944,41623,7,15009,3355
,,shrimp,High,125,0.15,44796,62,44796,104,0,14956,14,46,0.9996875697388976,0.996307993416663,0.9990676611614278,0.9979949204651785,0.9969988995965188,44796,14,15002,166
,,anc,High,125,0.1,27487,1,27487,2466,0,10014,0,36,1.0,0.9176403819189424,1.0,0.9570515833637995,0.9383311668833116,27487,0,10050,2467
,,aln,High,125,0.1,24554,1,24554,5399,0,10014,0,36,1.0,0.8197235761500968,1.0,0.9009319732883248,0.865013498650135,24554,0,10050,5400
,,mem,High,125,0.1,27748,65,27748,2153,0,10014,4,32,0.9998558662438743,0.9259827804845492,0.9996019900497513,0.9615024775633252,0.9444722111155538,27748,4,10046,2218
,,shrimp,High,125,0.1,29842,39,29842,73,0,10014,7,29,0.9997654862809474,0.9962609334312613,0.9993034825870647,0.9980101332709062,0.9970252974702529,29842,7,10043,112
,,anc,High,125,0.25,68739,3,68739,6258,0,24986,4,107,0.999941812257248,0.91652,0.9998406184006057,0.9564152689174429,0.9374107116097385,68739,4,25093,6261
,,aln,High,125,0.25,61587,3,61587,13410,0,24986,3,108,0.9999512907939601,0.82116,0.9998804638004543,0.9017790467823412,0.8659700090911816,61587,3,25094,13413
,,mem,High,125,0.25,69475,153,69475,5403,0,24986,11,100,0.9998416947298736,0.925950607082406,0.9995617006016655,0.9614785803746272,0.9444011665068712,69475,11,25086,5556
,,shrimp,High,125,0.25,74729,99,74729,172,0,24986,19,92,0.9997458125969926,0.9963866666666666,0.9992429374028768,0.9980634132008441,0.9971028102740341,74729,19,25078,271
,,anc,High,125,0.2,54966,3,54966,5024,0,19910,2,81,0.9999636151942949,0.9162068908039271,0.9998999649877457,0.9562547298649107,0.937126497136999,54966,2,19991,5027
,,aln,High,125,0.2,49210,3,49210,10780,0,19910,2,81,0.9999593595058116,0.82026236394246,0.9998999649877457,0.9012407856783116,0.8651639036831446,49210,2,19991,10783
,,bowtie2,Single-stranded,125,0.55,164662,77,164662,694,0,55338,8,221,0.9999514179874901,0.995339503001215,0.9998560296578904,0.9976401305047212,0.996475113122172,164662,8,55559,771
,,mem,High,125,0.2,55555,128,55555,4336,0,19910,8,75,0.9998560192934147,0.9256235525416951,0.9995998599509829,0.9613088543198768,0.9441083837424387,55555,8,19985,4464
,,shrimp,High,125,0.2,59774,80,59774,139,0,19910,14,69,0.999765839298856,0.9963495741169803,0.99929975491422,0.9980547833128793,0.9970869902232891,59774,14,19979,219
,,anc,High,125,0.35,96243,3,96243,8699,0,35010,5,144,0.9999480508685895,0.9170803754347515,0.9998577889018458,0.9567231464315359,0.937853308970479,96243,5,35154,8702
,,aln,High,125,0.35,86232,3,86232,18710,0,35010,4,145,0.9999536156593534,0.8216875506217542,0.9998862311214767,0.9020980118317197,0.8664063838291555,86232,4,35155,18713
,,bowtie2,Single-stranded,125,0.5,149771,71,149771,621,0,50381,10,203,0.9999332358576856,0.9954008626705568,0.9998023481045183,0.997661901653322,0.9965084528268103,149771,10,50584,692
,,mem,High,125,0.35,97238,214,97238,7537,0,35010,12,137,0.9998766066838046,0.926173218146663,0.9996586933644301,0.9616147231740663,0.9446085566686645,97238,12,35147,7751
,,shrimp,High,125,0.35,104559,138,104559,248,0,35010,24,125,0.9997705171968676,0.9963218828910382,0.9993173867288603,0.9980432209537627,0.997073602466739,104559,24,35135,386
,,anc,High,125,0.3,82365,3,82365,7432,0,29885,4,128,0.9999514380410106,0.9172048997772828,0.9998667421794316,0.9567924539260843,0.9379136516521028,82365,4,30013,7435
,,aln,High,125,0.3,73755,3,73755,16042,0,29885,3,129,0.9999593264459449,0.821325167037862,0.9999000566345737,0.901881901221585,0.8660624118447299,73755,3,30014,16045
,,bb,Single-stranded,125,0.95,284820,511,284820,267,0,95219,67,319,0.9997648190335116,0.9972758912877541,0.9992991998326447,0.9985188041753947,0.9977833332896121,284820,67,95538,778
,,bb,Single-stranded,125,0.9,269828,479,269828,251,0,90239,65,303,0.9997591638167719,0.9973018724266146,0.9992826161334113,0.9985290063298986,0.9977987900267191,269828,65,90542,730
,,bowtie2,Single-stranded,125,0.6,179707,87,179707,767,0,60358,9,248,0.9999499209864453,0.9952702964649066,0.9998515219005196,0.9976046208889272,0.9964217003350251,179707,9,60606,854
,,mem,High,125,0.3,83204,182,83204,6452,0,29885,11,121,0.9998678122934567,0.9261559696342305,0.999633540993437,0.961601359121194,0.9445580075925076,83204,11,30006,6634
,,shrimp,High,125,0.3,89471,119,89471,210,0,29885,22,110,0.9997541707172628,0.9963363028953229,0.9992670819868741,0.9980423106312014,0.9970705325621573,89471,22,29995,329
,,anc,High,125,0.45,124214,4,124214,11129,0,45255,7,188,0.9999436488194428,0.9177447597656394,0.9998459845984599,0.9570825371386302,0.9383839333617261,124214,7,45443,11133
,,aln,High,125,0.45,111273,4,111273,24070,0,45255,6,189,0.9999460814708975,0.8221312626064855,0.9998679867986798,0.9023622813490872,0.8668119493133183,111273,6,45444,24074
,,bowtie2,Single-stranded,125,0.65,194777,94,194777,822,0,65463,12,261,0.999938394878561,0.9953191989493748,0.9998174516246805,0.9976234499925734,0.9964502790432584,194777,12,65724,916
,,bowtie2,Single-stranded,125,0.4,119389,54,119389,500,0,40041,7,168,0.9999413715702369,0.9953811393745362,0.9998259399244082,0.9976560443554958,0.9964972308768162,119389,7,40209,554
,,mem,High,125,0.45,125444,288,125444,9675,0,45255,13,182,0.9998963788389648,0.9264218245733233,0.9997139713971397,0.9617578508341511,0.9448403987680875,125444,13,45437,9963
,,shrimp,High,125,0.45,134843,184,134843,320,0,45255,31,164,0.999770155849163,0.9962762381138851,0.9993179317931793,0.9980201390713527,0.9970408801030991,134843,31,45419,504
,,anc,High,125,0.4,110067,3,110067,9876,0,40042,5,166,0.9999545751871503,0.9176379370716823,0.9998756620993211,0.9570294498691406,0.9382863279615882,110067,5,40208,9879
,,aln,High,125,0.4,98607,3,98607,21336,0,40042,4,167,0.9999594365740131,0.8220949427242259,0.9999005296794569,0.9023458411306889,0.866738678438302,98607,4,40209,21339
,,mem,High,125,0.4,111122,243,111122,8631,0,40042,12,159,0.9998920222434179,0.9260475349178305,0.9997015890383707,0.9615541037511358,0.9445349512199689,111122,12,40201,8874
,,shrimp,High,125,0.4,119504,161,119504,281,0,40042,26,145,0.9997824813854262,0.9963150084204558,0.9993534429164698,0.9980457331841186,0.9970779038330659,119504,26,40187,442
,,anc,High,125,0.55,151914,4,151914,13518,0,55338,8,225,0.9999473413988758,0.9182644648081433,0.9998560400208742,0.9573667593065245,0.9387802196310524,151914,8,55563,13522
,,aln,High,125,0.55,136111,4,136111,29321,0,55338,6,227,0.9999559202744698,0.8227411204332793,0.9998920300156556,0.9027335161646544,0.8672847466369843,136111,6,55565,29325
,,bb,Single-stranded,125,0.7,210155,372,210155,195,0,70490,50,239,0.9997621369615376,0.997309251051148,0.9992935757781263,0.9985341876382365,0.9978081783013204,210155,50,70729,567
,,bb,Single-stranded,125,0.85,254964,457,254964,238,0,85292,60,294,0.9997647280255976,0.9972815351698943,0.9992994418887047,0.9985215877560052,0.9977879023161103,254964,60,85586,695
,,bowtie2,Single-stranded,125,0.3,89397,38,89397,364,0,29884,4,138,0.9999552577711659,0.9955233354491698,0.9998667821221608,0.997734375,0.996611725432923,89397,4,30022,402
,,bowtie2,Single-stranded,125,0.45,134737,58,134737,549,0,45254,8,186,0.9999406285947531,0.9955151318122709,0.99982397465235,0.9977229727978556,0.9965983008097703,134737,8,45440,607
,,mem,High,125,0.55,153402,346,153402,11767,0,55338,15,218,0.99990222726295,0.9268163006374045,0.9997300750391391,0.9619730851717608,0.9451435188116841,153402,15,55556,12113
,,shrimp,High,125,0.55,164825,223,164825,388,0,55338,42,191,0.999745249200871,0.996306728886095,0.9992442101095895,0.9980230273415621,0.9970453424552164,164825,42,55529,611
,,anc,High,125,0.5,138118,4,138118,12344,0,50381,7,213,0.9999493212669683,0.9179349487591881,0.9998616628129879,0.9571885471133889,0.9385528207015572,138118,7,50594,12348
,,aln,High,125,0.5,123718,4,123718,26744,0,50381,6,214,0.9999515049626588,0.8222322650964338,0.9998814252682753,0.9024253255042124,0.8669398757628054,123718,6,50595,26748
,,bb,Single-stranded,125,0.8,239834,434,239834,219,0,80300,58,274,0.9997582245343738,0.9972846765105806,0.9992806826074015,0.9985199186475678,0.9977858675444305,239834,58,80574,653
,,mem,High,125,0.5,139485,320,139485,10730,0,50381,14,206,0.9998996408576406,0.9265951439864484,0.9997233256259758,0.9618527482984754,0.9449924429241906,139485,14,50587,11050
,,shrimp,High,125,0.5,149904,209,149904,353,0,50381,39,181,0.9997399011624417,0.9962649369292731,0.9992292642437897,0.9979993941592962,0.9970109465998895,149904,39,50562,562
,,anc,High,125,0.65,179652,4,179652,16041,0,65462,11,258,0.9999387742606992,0.9180110068115505,0.9998326512604403,0.957225063938619,0.9385834723136007,179652,11,65720,16045
,,aln,High,125,0.65,161041,4,161041,34652,0,65462,9,260,0.9999441167339336,0.8229099066413895,0.9998630783039966,0.9028302971013071,0.8674013495111464,161041,9,65722,34656
,,bb,Single-stranded,125,0.75,224973,401,224973,206,0,75414,53,257,0.9997644716610525,0.9973091586133522,0.9993000897997992,0.9985353057882053,0.9978095212808327,224973,53,75671,607
,,bowtie2,Single-stranded,125,0.25,74655,30,74655,314,0,24986,5,109,0.9999330297347977,0.9954132721769624,0.999800796812749,0.9976680319927301,0.996513451682834,74655,5,25095,344
,,bowtie2,Single-stranded,125,0.2,59728,24,59728,240,0,19911,3,84,0.9999497748237933,0.9955994132551007,0.9998499849984999,0.997769852075207,0.9966620827603451,59728,3,19995,264
,,bowtie2,Single-stranded,125,0.35,104471,45,104471,428,0,35009,6,155,0.9999425710922021,0.9954928342735173,0.9998294000568666,0.997712741320116,0.9965813551822088,104471,6,35164,473
,,mem,High,125,0.65,181494,404,181494,13895,0,65462,19,250,0.9998953243018407,0.926968788465369,0.999710943086215,0.9620520214361817,0.9452516786222297,181494,19,65712,14299
,,shrimp,High,125,0.65,194990,255,194990,452,0,65462,52,217,0.9997333907568626,0.9963872721605339,0.9992088968675359,0.9980575268913521,0.9970967149654972,194990,52,65679,707
,,anc,High,125,0.6,165789,4,165789,14773,0,60358,11,242,0.9999336550060314,0.918162887808336,0.9998185147910446,0.9573052782316971,0.9386840370350407,165789,11,60600,14777
,,aln,High,125,0.6,148594,4,148594,31968,0,60358,9,244,0.9999394359467844,0.8229345502475549,0.9998515121017637,0.9028432203518557,0.8673961447401701,148594,9,60602,31972
,,mem,High,125,0.6,167470,377,167470,12805,0,60358,18,235,0.9998925296140619,0.9270309766844541,0.9997030242035274,0.9620842189923594,0.9452879223088497,167470,18,60593,13182
,,shrimp,High,125,0.6,179902,241,179902,423,0,60358,47,206,0.99973881488644,0.9963226742576122,0.9992245631980994,0.99802782131118,0.9970519576908246,179902,47,60564,664
,,anc,High,125,0.75,207038,4,207038,18529,0,75413,11,299,0.9999468724794613,0.9178396159080733,0.9998547337004609,0.9571355924367806,0.9384521430894741,207038,11,75712,18533
,,aln,High,125,0.75,185612,4,185612,39955,0,75413,9,301,0.9999515141067012,0.822854001622549,0.9998811457549226,0.9027996653631394,0.8673455163395222,185612,9,75714,39959
,,bb,Single-stranded,125,0.6,180065,333,180065,174,0,60359,44,209,0.999755703490664,0.9971922557207098,0.9992740711410282,0.9984723342787671,0.9977154371765955,180065,44,60568,507
,,mem,High,125,0.75,209150,485,209150,16048,0,75413,23,287,0.9998900431700076,0.9267423775827156,0.9996962613736909,0.9619276266166272,0.9450707683324154,209150,23,75700,16533
,,shrimp,High,125,0.75,224736,305,224736,530,0,75413,58,252,0.9997419859960676,0.9962982830239703,0.999234050420612,0.9980171638559836,0.9970361175463169,224736,58,75665,835
,,anc,High,125,0.7,193448,4,193448,17263,0,70489,11,278,0.9999431404070113,0.918055193033244,0.9998445844754019,0.9572510849287683,0.9386201433072936,193448,11,70767,17267
,,aln,High,125,0.7,173457,4,173457,37254,0,70489,9,280,0.9999481166338072,0.823182972261111,0.9998728418435107,0.9029962439579261,0.8676094965061298,173457,9,70769,37258
,,bb,Single-stranded,125,0.55,164975,305,164975,161,0,55339,38,195,0.9997697151133547,0.9971832858843939,0.9993162024040884,0.9984748255430408,0.9977195911552714,164975,38,55534,466
,,mem,High,125,0.7,195433,440,195433,14946,0,70489,20,269,0.9998976736095123,0.9270179632765547,0.9997174263189127,0.9620795919974795,0.945290610340309,195433,20,70758,15386
,,shrimp,High,125,0.7,209943,277,209943,495,0,70489,54,235,0.9997428534693352,0.9963362836058183,0.9992370510610642,0.9980366616592824,0.9970656463926278,209943,54,70724,772
,,anc,High,125,0.85,234580,4,234580,21066,0,85287,12,342,0.9999488473605238,0.9175826325053784,0.9998598801975689,0.9569967485445964,0.9382286670319463,234580,12,85629,21070
,,aln,High,125,0.85,210323,4,210323,45323,0,85287,10,344,0.999952456343037,0.8226990025425386,0.9998832334979741,0.902706751104654,0.8671602825741083,210323,10,85631,45327
,,bb,Single-stranded,125,0.4,119611,217,119611,124,0,40042,24,147,0.9997993898106742,0.9971571962118181,0.9994031780767414,0.9984765450546148,0.9977211001155059,119611,24,40189,341
,,bb,Single-stranded,125,0.65,195163,351,195163,189,0,65463,49,220,0.999748990840727,0.9972407168004578,0.9992545487738088,0.9984932785899747,0.9977470499359306,195163,49,65683,540
,,mem,High,125,0.85,236991,552,236991,18238,0,85287,26,328,0.9998903032271946,0.9265387186694868,0.9996964070947326,0.9618180268588752,0.9448893158613094,236991,26,85615,18790
,,shrimp,High,125,0.85,254698,340,254698,612,0,85287,64,290,0.999748785140641,0.9962761588108743,0.9992526943870342,0.9980094511884516,0.9970230682906962,254698,64,85577,952
,,anc,High,125,0.8,220663,4,220663,19811,0,80297,12,320,0.9999456213889204,0.9176016101264981,0.999851170174503,0.9570055925040063,0.9382542267842183,220663,12,80617,19815
,,aln,High,125,0.8,197815,4,197815,42659,0,80297,10,322,0.9999494502717048,0.8225908399105115,0.9998759751454191,0.9026404108573293,0.8671066030949185,197815,10,80619,42663
,,bowtie2,Single-stranded,125,0.15,44757,20,44757,183,0,14957,2,61,0.9999553162492459,0.9954848754448399,0.999866844207723,0.9977150882198865,0.9965821940646882,44757,2,15018,203
,,bowtie2,Single-stranded,125,0.1,29813,15,29813,126,0,10013,1,39,0.9999664587106728,0.9952927822661414,0.9999005272058092,0.9976241467005755,0.9964506211413002,29813,1,10052,141
,,mem,High,125,0.8,222910,524,222910,17167,0,80297,26,306,0.9998833746007822,0.9264716272999697,0.9996775353780898,0.9617786713897704,0.944846371758553,222910,26,80603,17691
,,shrimp,High,125,0.8,239575,326,239575,577,0,80297,63,269,0.9997371034643922,0.996244978750655,0.9992186434161406,0.9979879862366595,0.996991656986612,239575,63,80566,903
,,anc,High,125,0.95,262075,4,262075,23510,0,95215,15,371,0.9999427677515357,0.9176648960569209,0.9998430978755453,0.9570387033280444,0.9382748760460663,262075,15,95586,23514
,,aln,High,125,0.95,234947,4,234947,50638,0,95215,12,374,0.9999489272596496,0.8226752430940968,0.9998744783004362,0.9026910102430515,0.8671161363099766,234947,12,95589,50642
,,bb,Single-stranded,125,0.5,150045,275,150045,151,0,50381,36,184,0.9997601295300538,0.9971688896863847,0.999288551609652,0.9984628283957518,0.9977023155884459,150045,36,50565,426
,,bowtie2,None,125,0.8,239428,126,239428,933,0,80298,15,319,0.9999373546104918,0.9955964355661636,0.9998139696398453,0.997762173650324,0.9966554454890555,239428,15,80617,1059
,,mem,High,125,0.95,264691,622,264691,20419,0,95215,30,356,0.9998866731388896,0.9263610656139319,0.9996861957510905,0.9617206191990959,0.9447438328180356,264691,30,95571,21041
,,shrimp,High,125,0.95,284522,381,284522,686,0,95215,72,314,0.9997470080184403,0.9962638617033569,0.9992468698026171,0.9980023957220752,0.9970119887720035,284522,72,95529,1067
,,anc,High,125,0.9,248231,4,248231,22314,0,90235,15,353,0.9999395760656767,0.9175084735112679,0.9998344425681269,0.9569521680047032,0.9381617712209818,248231,15,90588,22318
,,aln,High,125,0.9,222508,4,222508,48037,0,90235,12,356,0.9999460722631673,0.8224314264698817,0.9998675540545016,0.9025430517838274,0.8669452197412724,222508,12,90591,48041
,,bowtie2,None,125,0.95,284345,141,284345,1111,0,95218,16,381,0.9999437334936929,0.9956162004502849,0.9998326622391884,0.9977752746693617,0.9966737668279068,284345,16,95599,1252
,,mem,High,125,0.9,250750,588,250750,19347,0,90235,29,339,0.9998843603332017,0.9263535105380793,0.9996799222983787,0.9617154779620454,0.9447421447709307,250750,29,90574,19935
,,shrimp,High,125,0.9,269534,366,269534,649,0,90235,68,300,0.9997477763518074,0.9962483690569915,0.9992494729755086,0.9979950051004255,0.9970012626262627,269534,68,90535,1015
,,anc,Mid,125,0.15,44731,1,44731,234,0,14956,3,57,0.9999329369159923,0.9947738291153316,0.9998002131060203,0.9973467112597547,0.9960321429762262,44731,3,15013,235
,,aln,Mid,125,0.15,44707,1,44707,258,0,14956,3,57,0.9999329009170208,0.9942400925143442,0.9998002131060203,0.9970783710245773,0.9956320229402154,44707,3,15013,259
,,bb,Single-stranded,125,0.3,89554,163,89554,89,0,29885,21,111,0.9997655595869384,0.9971939514063648,0.9993003964420162,0.9984780996872579,0.9977216394181417,89554,21,29996,252
,,bb,Single-stranded,125,0.45,134973,245,134973,135,0,45255,29,166,0.9997851883675798,0.9971925262092455,0.9993619361936193,0.9984871742708661,0.9977378693937601,134973,29,45421,380
,,bowtie2,None,125,0.85,254538,134,254538,987,0,85290,17,337,0.9999332167900846,0.995615253130146,0.9998015038998646,0.9977695633596882,0.9966657193168533,254538,17,85627,1121
,,mem,Mid,125,0.15,44804,107,44804,85,0,14956,6,54,0.9998661013166704,0.9957329540403591,0.9996004262120405,0.9977952475335724,0.9967006598680264,44804,6,15010,192
,,shrimp,Mid,125,0.15,44815,64,44815,87,0,14956,17,43,0.999620806566738,0.9966419072187875,0.998867874267448,0.99812913427916,0.9971991597479244,44815,17,14999,151
,,anc,Mid,125,0.1,29813,1,29813,142,0,10014,1,35,0.9999664587106728,0.9952263319535318,0.9999004975124378,0.9975907645976242,0.9964005399190121,29813,1,10049,143
,,aln,Mid,125,0.1,29795,1,29795,160,0,10014,1,35,0.9999664384481138,0.9946254506609694,0.9999004975124378,0.9972887936805462,0.9959506074088886,29795,1,10049,161
,,bowtie2,None,125,0.9,269365,137,269365,1055,0,90237,14,362,0.9999480286139603,0.9955942740346766,0.9998454967830223,0.9977664019439342,0.9966608522302517,269365,14,90599,1192
,,mem,Mid,125,0.1,29848,70,29848,55,0,10014,3,33,0.9998995008542427,0.9958295799552931,0.9997014925373134,0.9978603904787375,0.996801838942608,29848,3,10047,125
,,shrimp,Mid,125,0.1,29868,47,29868,41,0,10014,9,27,0.9996987649362385,0.9970623581252503,0.9991044776119403,0.9983788210519279,0.9975753636954456,29868,9,10041,88
,,anc,Mid,125,0.25,74621,3,74621,381,0,24986,6,105,0.9999196001447197,0.9948803413105793,0.9997609276009085,0.9973936056458511,0.9961039739465745,74621,6,25091,384
,,aln,Mid,125,0.25,74580,1,74580,424,0,24986,5,106,0.9999329623919019,0.9943337110859276,0.9998007730007571,0.9971254763018917,0.9957043815308385,74580,5,25092,425
,,bowtie2,None,125,0.6,179766,99,179766,707,0,60359,11,246,0.9999388130850999,0.9955364065303591,0.9998185297611192,0.997732753525055,0.9966126009585883,179766,11,60605,806
,,bowtie2,None,125,0.75,224590,121,224590,869,0,75415,15,298,0.9999332160904699,0.9956113130596684,0.9998019226706106,0.997767584437509,0.9966645425942889,224590,15,75713,990
,,mem,Mid,125,0.25,74728,176,74728,150,0,24986,11,100,0.9998528211509387,0.9956564606816426,0.9995617006016655,0.9977502286488688,0.9966350810276483,74728,11,25086,326
,,shrimp,Mid,125,0.25,74769,107,74769,129,0,24986,25,86,0.999665748589459,0.9968535430971268,0.9990038650037854,0.9982576652714638,0.9973926594873229,74769,25,25072,236
,,anc,Mid,125,0.2,59699,2,59699,295,0,19910,3,80,0.9999497504271214,0.9950496699779985,0.9998499474816186,0.997493692459356,0.9962494843040918,59699,3,19990,297
,,aln,Mid,125,0.2,59666,1,59666,329,0,19910,3,80,0.9999497226365449,0.9944996333088872,0.9998499474816186,0.9972172314377638,0.9958369275775419,59666,3,19990,330
,,bb,Single-stranded,125,0.2,59825,112,59825,59,0,19911,14,69,0.9997660388709705,0.9971498099873325,0.9992997899369811,0.9984562106229399,0.9976872109013627,59825,14,19980,171
,,mem,Mid,125,0.2,59779,139,59779,116,0,19910,7,76,0.9998829157327802,0.995752406969384,0.99964987745711,0.9978133867467869,0.9967261049395829,59779,7,19986,255
,,shrimp,Mid,125,0.2,59806,84,59806,106,0,19910,19,64,0.9996824070204764,0.9968331222081472,0.9990496673835843,0.9982557314661036,0.9973871407318506,59806,19,19974,190
,,anc,Mid,125,0.35,104415,3,104415,531,0,35010,7,142,0.999932964317864,0.9949118143098076,0.9998009044625843,0.9974160700383529,0.9961386930082508,104415,7,35152,534
,,aln,Mid,125,0.35,104351,1,104351,597,0,35010,6,143,0.9999425050547639,0.9943019943019943,0.9998293466822151,0.9971142728827649,0.9956890398835184,104351,6,35153,598
,,bb,Single-stranded,125,0.25,74803,132,74803,72,0,24987,18,93,0.9997594258296467,0.9972802538429747,0.9992828113793928,0.9985183009851297,0.9977823285550173,74803,18,25080,204
,,bb,Single-stranded,125,0.35,104658,186,104658,107,0,35010,23,126,0.9997802848654483,0.9972082209793142,0.9993458289484911,0.998492596550145,0.9977446292198987,104658,23,35136,293
,,bowtie2,None,125,0.7,209803,112,209803,807,0,70491,12,280,0.9999428067583347,0.9956388037319311,0.9998304677676844,0.9977861638809427,0.9966927763272411,209803,12,70771,919
,,mem,Mid,125,0.35,104578,244,104578,202,0,35010,13,136,0.9998757063227237,0.995753351614869,0.9996302511447993,0.9978102712115069,0.9967257085381251,104578,13,35146,446
,,shrimp,Mid,125,0.35,104628,148,104628,173,0,35010,32,117,0.9996942480412765,0.9969413715233113,0.9990898489718137,0.9983159120075951,0.9974805150312616,104628,32,35127,321
,,anc,Mid,125,0.3,89345,3,89345,456,0,29885,6,126,0.9999328491007375,0.9948888690926907,0.9998001132691475,0.9974044821523261,0.996119211156642,89345,6,30011,459
,,aln,Mid,125,0.3,89297,1,89297,506,0,29885,5,127,0.9999440102125372,0.9943543717429068,0.9998334277242895,0.9971413576317935,0.9957269593810768,89297,5,30012,507
,,bb,None,125,0.9,269782,516,269782,269,0,90238,66,302,0.9997554178648721,0.9970986853533506,0.9992715714191113,0.9984252842722722,0.9976437884337976,269782,66,90540,785
,,bowtie2,None,125,0.5,149793,82,149793,596,0,50383,11,202,0.9999265707190729,0.9954941483741053,0.9997825915092102,0.9977054366830407,0.9965732815429683,149793,11,50585,678
,,mem,Mid,125,0.3,89475,207,89475,182,0,29885,11,121,0.9998770757436918,0.9956712365352087,0.999633540993437,0.9977697240033454,0.9966633578298479,89475,11,30006,389
,,shrimp,Mid,125,0.3,89529,125,89529,150,0,29885,30,102,0.9996650252905905,0.996937775600196,0.9990005663457374,0.9982995378088011,0.9974545363500555,89529,30,29987,275
,,anc,Mid,125,0.45,134673,5,134673,673,0,45257,10,185,0.9999257515796351,0.994990801693375,0.9997799876793101,0.997452172689365,0.9961947534056403,134673,10,45442,678
,,aln,Mid,125,0.45,134589,1,134589,761,0,45257,9,186,0.9999331342219052,0.9943701930536162,0.9998019889113791,0.9971439049598259,0.995735690226379,134589,9,45443,762
,,bb,None,125,0.95,284790,534,284790,282,0,95218,68,318,0.9997612845698559,0.9971429171656058,0.9992887326890089,0.9984503842486117,0.9976810681776449,284790,68,95536,816
,,bowtie2,None,125,0.65,194841,104,194841,758,0,65463,12,261,0.9999384151129312,0.9955953664481383,0.9998174516246805,0.9977621647087741,0.9966569639571755,194841,12,65724,862
,,mem,Mid,125,0.45,134862,312,134862,264,0,45257,16,179,0.999881374278978,0.9957471315288177,0.999647980286896,0.9978099705529825,0.9967272928298966,134862,16,45436,576
,,shrimp,Mid,125,0.45,134939,195,134939,217,0,45257,40,155,0.999703657605998,0.9969560623859447,0.9991199507172401,0.9983279695187364,0.9975000414816125,134939,40,45412,412
,,anc,Mid,125,0.4,119336,4,119336,610,0,40042,8,163,0.9999329668856415,0.9948812005002085,0.9998010593589138,0.9974006870209867,0.9961164563600832,119336,8,40205,614
,,aln,Mid,125,0.4,119260,1,119260,689,0,40042,7,164,0.9999413081573276,0.9942476031679867,0.9998259269390496,0.9970863274767262,0.9956481834131479,119260,7,40206,690
,,bowtie2,None,125,0.45,134749,71,134749,533,0,45257,9,185,0.9999332136125499,0.9955375942904848,0.9998019845547953,0.9977305626205523,0.996609588283445,134749,9,45442,604
,,bowtie2,None,125,0.55,164698,92,164698,651,0,55340,9,220,0.9999453575136454,0.995508972987349,0.999838039194515,0.9977222336649019,0.9965974390299082,164698,9,55560,743
,,mem,Mid,125,0.4,119516,285,119516,232,0,40042,14,157,0.9998828745921526,0.9956928511326052,0.9996518538780991,0.9977834640574714,0.9966863447449547,119516,14,40199,517
,,shrimp,Mid,125,0.4,119578,174,119578,198,0,40042,34,137,0.9997157475838545,0.9968987077949145,0.9991545022753836,0.998305240397058,0.9974650824472568,119578,34,40179,372
,,anc,Mid,125,0.55,164617,9,164617,814,0,55340,12,221,0.9999271088325872,0.9950253868471953,0.9997840678027099,0.9974702259224586,0.9962219416957373,164617,12,55561,823
,,aln,Mid,125,0.55,164514,2,164514,924,0,55340,10,223,0.9999392185942476,0.9944028046421663,0.9998200565022582,0.9971633269083899,0.995764955002647,164514,10,55563,926
,,bb,Single-stranded,125,0.15,44841,85,44841,40,0,14958,13,47,0.9997101707762964,0.9972201218698572,0.9991343720868291,0.9984635938543754,0.9976993865030674,44841,13,15005,125
,,bb,Single-stranded,125,0.1,29874,55,29874,27,0,10014,8,28,0.9997322803025233,0.9972626518894379,0.9992039800995025,0.9984959390353956,0.9977503374493826,29874,8,10042,82
,,mem,Mid,125,0.55,164829,377,164829,341,0,55340,21,212,0.9998726114649682,0.9956628631144026,0.9996221186547424,0.9977632968822356,0.9966579232995658,164829,21,55552,718
,,shrimp,Mid,125,0.55,164938,234,164938,268,0,55340,51,182,0.9996908884834746,0.996965667311412,0.9990822881615172,0.9983264180807374,0.9974978847398117,164938,51,55522,502
,,anc,Mid,125,0.5,149721,6,149721,743,0,50383,11,209,0.9999265354099324,0.9950222635741344,0.9997826215837006,0.9974683712966601,0.9962202782074172,149721,11,50592,749
,,aln,Mid,125,0.5,149630,1,149630,839,0,50383,9,211,0.999939855251639,0.9944174918588423,0.9998221449321186,0.9971710278598777,0.9957776528922332,149630,9,50594,840
,,bowtie2,None,125,0.35,104501,56,104501,394,0,35012,7,154,0.9999330194817622,0.9957122847805167,0.9998009837090951,0.9978181887624785,0.9967386029516714,104501,7,35166,450
,,mem,Mid,125,0.5,149925,349,149925,293,0,50383,20,200,0.9998666177598453,0.9957361174759409,0.9996047665158192,0.9977970929613459,0.9967092508823383,149925,20,50583,642
,,shrimp,Mid,125,0.5,150015,221,150015,234,0,50383,48,172,0.9996801343435757,0.9969761414235396,0.9990514396379662,0.9983263069280246,0.997498420971488,150015,48,50555,455
,,anc,Mid,125,0.65,194712,9,194712,981,0,65462,15,254,0.9999229690797886,0.99494128828525,0.9997717971733276,0.9974259084238107,0.996155802825198,194712,15,65716,990
,,aln,Mid,125,0.65,194586,2,194586,1114,0,65462,13,256,0.9999331959568137,0.9942974522488273,0.9998022242168839,0.9971073607292833,0.9956814939200483,194586,13,65718,1116
,,bb,None,125,0.7,210119,415,210119,197,0,70491,51,238,0.9997573392967598,0.997095823585519,0.9992794574738627,0.9984248077338852,0.9976448522437844,210119,51,70729,612
,,bb,None,125,0.85,254919,491,254919,258,0,85291,61,293,0.9997607655502392,0.9970704194502246,0.9992877576040633,0.9984137801381775,0.9976268117534345,254919,61,85584,749
,,bb,None,125,0.8,239788,464,239788,244,0,80299,59,273,0.9997540098479447,0.9970560840928747,0.9992682715084769,0.9984032243625908,0.9976115368685909,239788,59,80572,708
,,bowtie2,None,125,0.4,119417,64,119417,471,0,40044,6,169,0.9999497584217446,0.9955398826197146,0.9998508167781397,0.997739947780679,0.9966223598529073,119417,6,40213,535
,,mem,Mid,125,0.65,194977,451,194977,404,0,65462,26,243,0.9998666687179172,0.9956340128273213,0.999604448433768,0.9977458518300562,0.9966317866059038,194977,26,65705,855
,,shrimp,Mid,125,0.65,195093,277,195093,332,0,65462,64,205,0.999672058906419,0.9968881258239568,0.9990263346061979,0.9982781514561517,0.9974257266680182,195093,64,65667,609
,,anc,Mid,125,0.6,179674,9,179674,888,0,60360,15,238,0.9999165224359866,0.99503242491873,0.9997525283355055,0.9974684949758508,0.9962186546371236,179674,15,60598,897
,,aln,Mid,125,0.6,179558,2,179558,1011,0,60360,13,240,0.9999276052369258,0.9943900183307397,0.9997855245574382,0.9971511237234202,0.9957459864667639,179558,13,60600,1013
,,bowtie2,None,125,0.3,89420,49,89420,337,0,29887,7,135,0.9999217238641573,0.9957018462018128,0.9997668920043957,0.9978073234281634,0.9967204906746777,89420,7,30022,386
,,mem,Mid,125,0.6,179903,408,179903,374,0,60360,24,229,0.9998666125706537,0.9956720259014307,0.9996040453368089,0.9977649107628144,0.9966597319497054,179903,24,60589,782
,,shrimp,Mid,125,0.6,180024,254,180024,293,0,60360,57,196,0.9996834757692372,0.996970720658356,0.9990596076749212,0.9983252553708284,0.9974956879394985,180024,57,60556,547
,,anc,Mid,125,0.75,224433,9,224433,1135,0,75413,15,295,0.9999331693755347,0.9949285609791778,0.9998019095915376,0.9974245875229154,0.9961533355459675,224433,15,75708,1144
,,aln,Mid,125,0.75,224289,2,224289,1286,0,75413,13,297,0.9999420424249449,0.9942901980255079,0.9998283216459992,0.9971081112921475,0.9956820444739463,224289,13,75710,1288
,,bb,None,125,0.5,150040,295,150040,146,0,50383,36,184,0.9997601215384205,0.9970693974654607,0.9992885797284746,0.998412946629092,0.9976278570149788,150040,36,50567,441
,,bowtie2,None,125,0.1,29820,21,29820,115,0,10013,1,39,0.9999664665839509,0.9954600080117506,0.9999005272058092,0.9977081486190341,0.9965757704516484,29820,1,10052,136
,,bowtie2,None,125,0.25,74679,38,74679,290,0,24988,5,109,0.9999330512559584,0.9956270748063514,0.9998008126842483,0.9977754173597612,0.9966736257479347,74679,5,25097,328
,,mem,Mid,125,0.75,224745,516,224745,464,0,75413,30,280,0.9998665331998665,0.995658433935098,0.9996038191830752,0.9977580466148723,0.9966495050555984,224745,30,75693,980
,,shrimp,Mid,125,0.75,224870,321,224870,386,0,75413,72,238,0.9996799174898419,0.9968658152205234,0.9990491660393803,0.9982708831370043,0.997414537006306,224870,72,75651,707
,,anc,Mid,125,0.7,209642,9,209642,1068,0,70489,15,274,0.9999284545710374,0.9948889279087315,0.9997880697391844,0.997402325537138,0.9961207401855082,209642,15,70763,1077
,,aln,Mid,125,0.7,209507,2,209507,1210,0,70489,13,276,0.9999379534173348,0.9942482642761212,0.9998163271072932,0.9970849921116317,0.9956482662337431,209507,13,70765,1212
,,bb,None,125,0.75,224940,431,224940,219,0,75415,54,256,0.9997599935998294,0.9971186666075624,0.9992868933641466,0.9984375832253254,0.9976635746643878,224940,54,75671,650
,,mem,Mid,125,0.7,209931,492,209931,434,0,70489,27,262,0.9998714028519989,0.9956083981086709,0.9996185255305321,0.997735346886399,0.9966161876187264,209931,27,70751,926
,,shrimp,Mid,125,0.7,210051,308,210051,360,0,70489,67,222,0.9996811315546502,0.9968299014327137,0.9990533781683574,0.9982534805637336,0.9973889597402459,210051,67,70711,668
,,anc,Mid,125,0.85,254352,11,254352,1293,0,85287,18,336,0.9999292369383181,0.9948993960634602,0.9997898202963534,0.9974079752796916,0.9961265408134264,254352,18,85623,1304
,,aln,Mid,125,0.85,254190,2,254190,1464,0,85287,16,338,0.9999370589207178,0.9942657320774791,0.9998131735967586,0.9970933311366605,0.9956577409118744,254190,16,85625,1466
,,bb,None,125,0.6,180073,342,180073,166,0,60360,45,208,0.999750163781521,0.9971868579750915,0.9992575850065167,0.998466865724607,0.9977072398152524,180073,45,60568,508
,,bowtie2,None,125,0.2,59736,31,59736,229,0,19911,3,84,0.9999497815497413,0.9956663777585172,0.9998499849984999,0.9978034826909424,0.9967122534190064,59736,3,19995,260
,,mem,Mid,125,0.85,254722,583,254722,521,0,85287,33,321,0.9998704637789249,0.9956845668540336,0.9996146705433145,0.997773125126082,0.9966702492480972,254722,33,85608,1104
,,shrimp,Mid,125,0.85,254866,359,254866,431,0,85287,80,274,0.999686208059746,0.9969099101918203,0.9990658679837928,0.9982961288831615,0.9974509005353109,254866,80,85561,790
,,anc,Mid,125,0.8,239263,10,239263,1211,0,80297,18,314,0.9999247746373511,0.9949227391427289,0.9997767552617545,0.9974174856440133,0.9961415451881425,239263,18,80611,1221
,,aln,Mid,125,0.8,239113,2,239113,1369,0,80297,16,316,0.9999330905076339,0.994298997022671,0.9998015602326706,0.9971080850602464,0.9956806482453218,239113,16,80613,1371
,,bb,None,125,0.65,195146,384,195146,182,0,65464,50,219,0.9997438472099838,0.9971079954218444,0.9992393470555124,0.9984241816488789,0.9976438639101914,195146,50,65683,566
,,bowtie2,Mid,125,0.95,283386,123,283386,2058,0,95212,13,384,0.9999541282785048,0.9923625629011755,0.9998640295369683,0.9961438820597364,0.9942441286964552,283386,13,95596,2181
,,mem,Mid,125,0.8,239602,547,239602,492,0,80297,33,299,0.9998622905669038,0.9956823650167678,0.9995907179798832,0.9977679500953619,0.9966632427553148,239602,33,80596,1039
,,shrimp,Mid,125,0.8,239737,338,239737,409,0,80297,78,254,0.9996747492859079,0.9968937642421117,0.9990326061342693,0.9982823199715177,0.9974308109606276,239737,78,80551,747
,,anc,Mid,125,0.95,284118,13,284118,1464,0,95213,22,364,0.99992257337932,0.9948283408322974,0.9997698720697915,0.9973689522321781,0.9960676191125778,284118,22,95577,1477
,,aln,Mid,125,0.95,283940,3,283940,1652,0,95213,20,366,0.9999295675447246,0.9942050806211593,0.9997907927907196,0.9970591075488758,0.9956059119503455,283940,20,95579,1655
,,bb,None,125,0.55,164972,324,164972,154,0,55340,39,194,0.9997636521201617,0.9971109096403747,0.9992982203588073,0.998435518866069,0.9976608769223112,164972,39,55534,478
,,bowtie2,Mid,125,0.9,268483,117,268483,1928,0,90234,14,362,0.9999478578904047,0.992440708540336,0.9998454916675864,0.9961801400677149,0.9942985783827789,268483,14,90596,2045
,,mem,Mid,125,0.95,284528,666,284528,591,0,95213,38,348,0.9998664633160673,0.9956015886068198,0.9996025063023671,0.9977294683449315,0.9966044721330732,284528,38,95561,1257
,,shrimp,Mid,125,0.95,284685,411,284685,499,0,95213,90,296,0.9996839610218594,0.9968136697071027,0.9990585675582381,0.9982467521082805,0.9973766638509526,284685,90,95509,910
,,anc,Mid,125,0.9,269163,11,269163,1381,0,90235,21,347,0.9999219864479315,0.9948550202361812,0.9997682195953776,0.9973820679995331,0.9960875849351254,269163,21,90582,1392
,,aln,Mid,125,0.9,268994,2,268994,1559,0,90235,19,349,0.9999293714430157,0.9942303782964647,0.9997902939196274,0.9970717314592413,0.9956251834377198,268994,19,90584,1561
,,bb,None,125,0.45,134976,261,134976,127,0,45257,29,166,0.9997851931409948,0.9971336544428356,0.9993619642699991,0.9984576634155543,0.9976937881603398,134976,29,45423,388
,,bb,None,125,0.4,119620,229,119620,112,0,40044,24,147,0.9997994049012069,0.9971574094914181,0.9994032077582992,0.9984766595020973,0.9977212566177205,119620,24,40191,341
,,bowtie2,None,125,0.15,44766,23,44766,177,0,14957,3,60,0.999932989345306,0.9955521949917716,0.9998002663115846,0.997737783473561,0.9966158770379755,44766,3,15017,200
,,mem,Mid,125,0.9,269560,629,269560,551,0,90235,36,332,0.9998664668615261,0.9956415749427495,0.9996026621635046,0.9977495484291257,0.9966347763759088,269560,36,90567,1180
,,shrimp,Mid,125,0.9,269706,383,269706,466,0,90235,85,283,0.9996849413064187,0.9968620058768087,0.9990618412193857,0.998271477904898,0.9974138742600192,269706,85,90518,849
,,anc,None,125,0.15,44733,4,44733,236,0,14958,3,57,0.9999329399141631,0.9946634647455139,0.9998002397123452,0.9972912416814367,0.9959493924088614,44733,3,15015,240
,,aln,None,125,0.15,44733,2,44733,238,0,14958,3,57,0.9999329399141631,0.9946634647455139,0.9998002397123452,0.9972912416814367,0.9959493924088614,44733,3,15015,240
,,mem,None,125,0.15,44874,115,44874,20,0,14958,7,53,0.999844031995722,0.997000599880024,0.9995338926621388,0.9984202914673489,0.9976343978542989,44874,7,15011,135
,,shrimp,None,125,0.15,44822,72,44822,79,0,14958,17,43,0.9996208657641785,0.9966424299023858,0.9988680250366228,0.9981294259119048,0.9971995799369906,44822,17,15001,151
,,anc,None,125,0.1,29794,2,29794,165,0,10014,1,35,0.9999664373216983,0.9944260872467541,0.9999004975124378,0.9971885668384765,0.9958011546824623,29794,1,10049,167
,,aln,None,125,0.1,29794,1,29794,166,0,10014,1,35,0.9999664373216983,0.9944260872467541,0.9999004975124378,0.9971885668384765,0.9958011546824623,29794,1,10049,167
,,bowtie2,Mid,125,0.8,238637,100,238637,1724,0,80296,13,321,0.9999455269222711,0.9924145703461268,0.9998387696887014,0.9961658154373413,0.9942788804419931,238637,13,80617,1824
,,mem,None,125,0.1,29895,80,29895,13,0,10014,4,32,0.9998662162614135,0.9968987595038015,0.9996019900497513,0.9983802828660643,0.9975773015635147,29895,4,10046,93
,,shrimp,None,125,0.1,29860,49,29860,52,0,10014,9,27,0.9996986842545783,0.9966289509695938,0.9991044776119403,0.9981614574628113,0.9972507560420885,29860,9,10041,101
,,anc,None,125,0.25,74628,5,74628,379,0,24988,7,104,0.9999062102230857,0.994880819068949,0.9997211044264712,0.997387184507541,0.9960943352878305,74628,7,25092,384
,,aln,None,125,0.25,74628,2,74628,382,0,24988,5,106,0.9999330055069473,0.994880819068949,0.9998007888760508,0.9974005145511043,0.9961143131124451,74628,5,25094,384
,,bb,None,125,0.2,59833,113,59833,57,0,19912,14,69,0.9997660701455378,0.9971668083262504,0.999299824956239,0.9984647476011682,0.9976999424985624,59833,14,19981,170
,,bb,None,125,0.35,104660,201,104660,99,0,35012,23,126,0.9997802890631716,0.997141768292683,0.9993458661585279,0.9984592855473352,0.9976948494515454,104660,23,35138,300
,,bb,None,125,0.3,89561,162,89561,90,0,29887,21,111,0.9997655779062758,0.9971941701090042,0.9993004430527332,0.9984782184564787,0.9977218105347486,89561,21,29998,252
,,bowtie2,Mid,125,0.75,223843,94,223843,1620,0,75412,11,302,0.9999508608289331,0.9924010338850047,0.9998547375371409,0.9961616426834234,0.9942744671105476,223843,11,75714,1714
,,mem,None,125,0.25,74842,177,74842,44,0,24988,12,99,0.999839687925829,0.9970558064559104,0.9995218933025221,0.9984458066796962,0.9976737684950381,74842,12,25087,221
,,shrimp,None,125,0.25,74771,109,74771,132,0,24988,25,86,0.9996657575271405,0.9967871807177519,0.9990039443802542,0.9982243938908469,0.9973429493262479,74771,25,25074,241
,,anc,None,125,0.2,59695,5,59695,303,0,19912,3,80,0.999949747060203,0.9948669233205006,0.9998499624906226,0.9974018596335871,0.9961124028100703,59695,3,19992,308
,,aln,None,125,0.2,59695,2,59695,306,0,19912,3,80,0.999949747060203,0.9948669233205006,0.9998499624906226,0.9974018596335871,0.9961124028100703,59695,3,19992,308
,,bowtie2,Mid,125,0.85,253691,110,253691,1828,0,85286,15,339,0.9999408764475416,0.9924187005386713,0.9998248482017749,0.9961655884633885,0.9942772417066889,253691,15,85625,1938
,,mem,None,125,0.2,59870,147,59870,29,0,19912,8,75,0.9998663950031731,0.9970689138327282,0.9995998999749938,0.9984656949401287,0.9977011781462001,59870,8,19987,176
,,shrimp,None,125,0.2,59811,93,59811,99,0,19912,19,64,0.9996824335617583,0.9968001599920004,0.9990497624406102,0.9982392162426043,0.9973624340608516,59811,19,19976,192
,,anc,None,125,0.35,104417,8,104417,535,0,35012,8,141,0.9999233899928178,0.9948266006097561,0.9997724751855749,0.9973684838933067,0.9960676843585187,104417,8,35153,543
,,aln,None,125,0.35,104417,4,104417,539,0,35012,6,143,0.9999425413941373,0.9948266006097561,0.9998293563891812,0.9973780106312357,0.9960819577365277,104417,6,35155,543
,,bb,None,125,0.15,44839,82,44839,52,0,14958,13,47,0.9997101578524926,0.997020434482912,0.9991343720868291,0.9983634845532982,0.9975496324448667,44839,13,15005,134
,,mem,None,125,0.35,104715,259,104715,59,0,35012,14,135,0.9998663216492089,0.9969723801091086,0.9996018315747561,0.9984172538400663,0.9976318530036948,104715,14,35147,318
,,shrimp,None,125,0.35,104623,166,104623,171,0,35012,32,117,0.999694233433663,0.9967892530487805,0.9990899007422998,0.9982396297974859,0.9973665617573383,104623,32,35129,337
,,anc,None,125,0.3,89352,5,89352,456,0,29887,7,125,0.9999216642979443,0.9948671127787737,0.9997668143509111,0.997387984729757,0.9960945323452834,89352,7,30012,461
,,aln,None,125,0.3,89352,2,89352,459,0,29887,5,127,0.9999440446747317,0.9948671127787737,0.9998334388220793,0.9973991181559413,0.9961112223779959,89352,5,30014,461
,,bb,Mid,125,0.9,269803,481,269803,271,0,90235,63,305,0.9997665508066966,0.9972205281735691,0.999304658786133,0.9984919164873312,0.9977433699378111,269803,63,90540,752
,,bowtie2,Mid,125,0.6,179179,72,179179,1304,0,60360,8,249,0.999955353904022,0.9923790534740107,0.9998680238217001,0.9961527983944048,0.994261357039789,179179,8,60609,1376
,,bowtie2,Mid,125,0.7,209107,84,209107,1509,0,70489,11,281,0.9999473981197219,0.9924394874228761,0.9998445910625733,0.9961792967428742,0.9943015692000525,209107,11,70770,1593
,,mem,None,125,0.3,89609,212,89609,53,0,29887,12,120,0.9998661028107252,0.9970514275541313,0.9996002531729904,0.9984567815259479,0.9976896065658546,89609,12,30007,265
,,shrimp,None,125,0.3,89527,132,89527,154,0,29887,30,102,0.9996650178098865,0.9968156057586318,0.9990006329324761,0.9982382784189107,0.9973629748314307,89527,30,29989,286
,,anc,None,125,0.45,134678,8,134678,678,0,45257,11,184,0.999918330375903,0.9949321828551165,0.999757986447241,0.9974190251543217,0.9961452526325104,134678,11,45441,686
,,aln,None,125,0.45,134678,4,134678,682,0,45257,9,186,0.9999331784062307,0.9949321828551165,0.9998019889113791,0.9974264120480946,0.9961563136005663,134678,9,45443,686
,,bb,None,125,0.25,74800,135,74800,77,0,24988,18,93,0.9997594161832714,0.9971737855276489,0.999282839953783,0.9984649269171728,0.9977025501693121,74800,18,25081,212
,,mem,None,125,0.45,135041,337,135041,80,0,45257,17,178,0.9998741281523493,0.9969215550207444,0.9996259790548271,0.9983956586671399,0.9976010170803162,135041,17,45435,417
,,shrimp,None,125,0.45,134929,209,134929,226,0,45257,41,154,0.9996962287915833,0.9967864424810141,0.9990979494851712,0.9982392151930574,0.9973674896026901,134929,41,45411,435
,,anc,None,125,0.4,119342,8,119342,611,0,40044,9,162,0.9999245921693157,0.9948399896633072,0.9997762029093622,0.9973758106572174,0.9960793127559684,119342,9,40206,619
,,aln,None,125,0.4,119342,4,119342,615,0,40044,7,164,0.9999413484821825,0.9948399896633072,0.9998259355961706,0.9973841460866658,0.9960917990210768,119342,7,40208,619
,,bb,None,125,0.1,29873,54,29873,34,0,10014,8,28,0.9997322713429939,0.9970628483695471,0.9992039800995025,0.9983957755422614,0.99760065981855,29873,8,10042,88
,,bowtie2,Mid,125,0.65,194195,75,194195,1417,0,65461,10,263,0.9999485080198759,0.9923755793690945,0.9998478717254389,0.9961476511444196,0.9942544784083911,194195,10,65724,1492
,,mem,None,125,0.4,119679,297,119679,70,0,40044,15,156,0.9998746804351095,0.9969428385785449,0.999627004848937,0.9984066071577543,0.99761638826664,119679,15,40200,367
,,shrimp,None,125,0.4,119574,186,119574,201,0,40044,35,136,0.9997073798794405,0.9967739515342486,0.999129677980853,0.9982385106649413,0.9973653980621316,119574,35,40180,387
,,anc,None,125,0.55,164605,10,164605,835,0,55340,13,220,0.999921029292058,0.99489271683288,0.9997660734529358,0.9974005356472,0.9961180510625591,164605,13,55560,845
,,aln,None,125,0.55,164604,5,164604,841,0,55340,11,222,0.9999331774139659,0.9948866727107888,0.9998020621524841,0.9974035417266296,0.9961225754785701,164604,11,55562,846
,,bowtie2,Mid,125,0.45,134289,54,134289,998,0,45257,9,185,0.9999329848545772,0.9922270413252451,0.9998019845547953,0.9960651092757353,0.9941313774945794,134289,9,45442,1052
,,bowtie2,Mid,125,0.5,149313,61,149313,1084,0,50382,7,206,0.9999531208143584,0.9923899028300257,0.9998616464077478,0.9961571562956587,0.9942701675677558,149313,7,50588,1145
,,mem,None,125,0.55,165049,408,165049,103,0,55340,22,211,0.9998667240157265,0.9969135056776999,0.9996041243049683,0.9983879309562624,0.99758968584517,165049,22,55551,511
,,shrimp,None,125,0.55,164909,262,164909,279,0,55340,52,181,0.9996847739768794,0.996730129948625,0.9990642938117431,0.9982052655631926,0.997317021305475,164909,52,55521,541
,,anc,None,125,0.5,149702,9,149702,770,0,50383,12,208,0.9999198471752808,0.9948232667247028,0.9997628599094915,0.9973650460533986,0.9960663205426588,149702,12,50591,779
,,aln,None,125,0.5,149701,5,149701,775,0,50383,10,210,0.9999332046409416,0.9948166213674816,0.9998023832579096,0.9973683509220767,0.996071293588749,149701,10,50593,780
,,bb,Mid,125,0.85,254952,448,254952,256,0,85287,58,296,0.9997725579389044,0.9972462997152424,0.9993227542882498,0.9985078309501709,0.9977673404688585,254952,58,85583,704
,,bb,Mid,125,0.8,239818,422,239818,244,0,80297,56,276,0.9997665441023204,0.997230584986943,0.9993054608143472,0.9984969543548771,0.9977515703194826,239818,56,80573,666
,,bb,Mid,125,0.95,284790,516,284790,289,0,95213,65,321,0.9997718137297924,0.997181323202437,0.9993200765698386,0.9984748882461214,0.9977176975503287,284790,65,95534,805
,,bowtie2,Mid,125,0.4,119006,51,119006,883,0,40042,6,169,0.9999495849158068,0.9922127730531932,0.9998508093592262,0.9960661555458836,0.9941307591925423,119006,6,40211,934
,,mem,None,125,0.5,150115,375,150115,94,0,50383,21,199,0.9998601268183513,0.9968854592785422,0.9995850048416102,0.9983705772811918,0.9975644549598135,150115,21,50582,469
,,shrimp,None,125,0.5,149983,237,149983,261,0,50383,49,171,0.9996734030073584,0.9966906121038537,0.9990316779637571,0.9981797792441591,0.9972797437886655,149983,49,50554,498
,,anc,None,125,0.65,194696,13,194696,1003,0,65464,16,253,0.9999178273552735,0.9948086984957488,0.9997565910577639,0.9973567198737783,0.9960527070703207,194696,16,65717,1016
,,aln,None,125,0.65,194695,6,194695,1011,0,65464,14,255,0.9999280978280408,0.9948035889470243,0.9997870171755435,0.9973592609004127,0.9960565319665704,194695,14,65719,1017
,,bowtie2,Mid,125,0.55,164163,66,164163,1198,0,55340,8,221,0.9999512703217986,0.9923591674877741,0.9998560348395689,0.9961407532812698,0.994244239714746,164163,8,55561,1264
,,mem,None,125,0.65,195245,489,195245,116,0,65464,27,242,0.9998617313286083,0.9969109011998979,0.9995892474099767,0.9983841358962166,0.9975839408524254,195245,27,65706,605
,,shrimp,None,125,0.65,195073,312,195073,327,0,65464,65,204,0.9996669023972778,0.9967349983649444,0.9990111511721662,0.9981987974926443,0.9973072730402188,195073,65,65668,639
,,anc,None,125,0.6,179665,12,179665,904,0,60360,16,237,0.9999109533005716,0.9949274840653225,0.9997360302245393,0.9974129938766786,0.9961358906108776,179665,16,60597,916
,,aln,None,125,0.6,179664,5,179664,912,0,60360,14,239,0.9999220828370752,0.9949219463841711,0.9997690264464719,0.9974157481145509,0.9961400366509946,179664,14,60599,917
,,bowtie2,Mid,125,0.3,89081,44,89081,672,0,29884,4,138,0.999955099062693,0.9920264596812811,0.9998667821221608,0.9959750002795139,0.9939911369269673,89081,4,30022,716
,,mem,None,125,0.6,180155,434,180155,110,0,60360,25,228,0.9998612498612499,0.9969894686744254,0.9995875472258426,0.9984232942343556,0.9976420567563984,180155,25,60588,544
,,shrimp,None,125,0.6,180004,278,180004,299,0,60360,58,195,0.9996778887272162,0.9968047579756453,0.9990431095639549,0.9982392559955414,0.9973672645256515,180004,58,60555,577
,,anc,None,125,0.75,224408,14,224408,1168,0,75415,16,294,0.9999287063772145,0.9947604060463673,0.9997887091449323,0.9973378605998925,0.9960240943862735,224408,16,75709,1182
,,aln,None,125,0.75,224407,7,224407,1176,0,75415,14,296,0.9999376172461579,0.9947559732257636,0.9998151205018158,0.9973400650206329,0.9960274131722616,224407,14,75711,1183
,,bb,Mid,125,0.7,210121,384,210121,214,0,70489,48,241,0.9997716123690934,0.9971620973903634,0.9993218231653904,0.9984651498736005,0.9977051265199984,210121,48,70730,598
,,bowtie2,Mid,125,0.2,59511,29,59511,454,0,19909,3,84,0.9999495916927109,0.991949194919492,0.9998499699939988,0.9959333266392207,0.9939242405300662,59511,3,19993,483
,,bowtie2,Mid,125,0.35,104119,46,104119,776,0,35010,7,154,0.9999327737548739,0.9921670271867049,0.9998009723920275,0.9960347639751849,0.9940833047847436,104119,7,35164,822
,,mem,None,125,0.75,225063,558,225063,131,0,75415,31,279,0.9998622797586786,0.9969479783124845,0.9995906239683063,0.9984030023555716,0.9976117581109006,225063,31,75694,689
,,shrimp,None,125,0.75,224851,350,224851,389,0,75415,73,237,0.9996754459284025,0.9967241455738286,0.9990359854737537,0.9981976142805774,0.9973051457776745,224851,73,75652,739
,,anc,None,125,0.7,209632,14,209632,1085,0,70491,16,273,0.9999236815996336,0.9947848204583094,0.9997739474427805,0.9973476315420133,0.9960392311490492,209632,16,70764,1099
,,aln,None,125,0.7,209631,7,209631,1093,0,70491,14,275,0.9999332204440841,0.9947800750720113,0.9998022040124329,0.997349991436238,0.9960427834081084,209631,14,70766,1100
,,bb,Mid,125,0.6,180082,317,180082,172,0,60360,42,211,0.9997668272967511,0.9972919239523511,0.9993070793394156,0.998527842082646,0.9977983614170094,180082,42,60571,489
,,bb,Mid,125,0.75,224947,400,224947,230,0,75413,51,259,0.9997733313185007,0.9972071620776941,0.9993264926112277,0.99848859790268,0.9977397942250249,224947,51,75672,630
,,mem,None,125,0.7,210228,526,210228,123,0,70491,28,261,0.9998668290084468,0.9969223765512597,0.9996044080248658,0.9983924318445716,0.9975963672126026,210228,28,70752,649
,,shrimp,None,125,0.7,210038,337,210038,356,0,70491,68,221,0.9996763538404424,0.9967114472953671,0.9990392766318169,0.9981916989238113,0.9972967308559879,210038,68,70712,693
,,anc,None,125,0.85,254312,17,254312,1339,0,85291,19,335,0.9999252942032234,0.9946962466949325,0.999778154007823,0.9973039162821887,0.9959714397049043,254312,19,85626,1356
,,aln,None,125,0.85,254311,7,254311,1350,0,85291,17,337,0.9999331571828505,0.9946923353724362,0.9998015062175258,0.997305861222441,0.9959743695669371,254311,17,85628,1357
,,bb,Mid,125,0.5,150060,269,150060,141,0,50383,34,186,0.999773475288819,0.997275204359673,0.9993281030768927,0.9985227771789036,0.997791846742228,150060,34,50569,410
,,bowtie2,Mid,125,0.25,74394,37,74394,568,0,24986,5,109,0.999932794795629,0.9919332257763437,0.999800796812749,0.9959169466793397,0.993906033027303,74394,5,25095,605
,,mem,None,125,0.85,255076,632,255076,147,0,85291,34,320,0.9998667241582062,0.996955306716695,0.9996030124350517,0.9984088929770141,0.997619326500732,255076,34,85611,779
,,shrimp,None,125,0.85,254817,395,254817,456,0,85291,81,273,0.9996822258315091,0.9966714645555955,0.9990542355070349,0.9981745748835607,0.9972693685854334,254817,81,85564,851
,,anc,None,125,0.8,239222,16,239222,1258,0,80299,19,313,0.9999205821744601,0.9947026145965006,0.9997643586213739,0.997304773240338,0.9959735556337523,239222,19,80612,1274
,,aln,None,125,0.8,239221,7,239221,1268,0,80299,17,315,0.9999289410545148,0.9946984565231854,0.9997891629770188,0.9973068408743179,0.9959766696665182,239221,17,80614,1275
,,bb,Mid,125,0.55,164991,289,164991,160,0,55340,37,196,0.999775795622561,0.9972860251450677,0.9993342090583557,0.9985293583645012,0.9978010343282975,164991,37,55536,449
,,bowtie2,Mid,125,0.15,44599,23,44599,341,0,14956,2,61,0.9999551579560997,0.9919044547739252,0.9998668353419002,0.9959135366888483,0.9938981694508352,44599,2,15017,364
,,mem,None,125,0.8,239931,595,239931,140,0,80299,34,298,0.9998583126705978,0.9969459749195981,0.9995783259540375,0.998400019973743,0.9976065758472691,239931,34,80597,735
,,shrimp,None,125,0.8,239693,376,239693,427,0,80299,79,253,0.9996705203276446,0.9966610671279356,0.9990202279520284,0.9981635253650044,0.9972534231005179,239693,79,80552,803
,,anc,None,125,0.95,284119,17,284119,1470,0,95218,23,363,0.9999190545572284,0.994793526746637,0.9997594242918706,0.9973497054838281,0.9960389286744838,284119,23,95581,1487
,,aln,None,125,0.95,284118,7,284118,1481,0,95218,21,365,0.9999260925110597,0.994790025419634,0.9997803439186644,0.9973514466998394,0.9960415519005272,284118,21,95583,1488
,,bb,Mid,125,0.4,119615,216,119615,119,0,40042,23,148,0.9998077533893913,0.9972071696540226,0.9994280456568772,0.998505768235471,0.9977647771332955,119615,23,40190,335
,,bowtie2,Mid,125,0.1,29703,14,29703,239,0,10013,1,39,0.999966334500404,0.9915542796100948,0.9999005272058092,0.9957425410660408,0.9936514284286035,29703,1,10052,253
,,mem,None,125,0.95,284962,682,284962,161,0,95218,39,347,0.9998631583748829,0.9970504364864156,0.9995920672775198,0.9984548165226014,0.9976875217941894,284962,39,95565,843
,,shrimp,None,125,0.95,284678,430,284678,498,0,95218,92,294,0.999676932261123,0.9967507685412772,0.9990376971674826,0.9982117059623826,0.9973243094357441,284678,92,95512,928
,,anc,None,125,0.9,269148,17,269148,1402,0,90238,22,346,0.99991826726604,0.9947554579826808,0.9997571904730371,0.9973301811808344,0.9960102222480639,269148,22,90584,1419
,,aln,None,125,0.9,269147,7,269147,1413,0,90238,20,348,0.9999256966864437,0.9947517620404558,0.9997792640663974,0.9973320191057077,0.996012991004311,269147,20,90586,1420
,,bb,Mid,125,0.65,195157,349,195157,196,0,65462,47,222,0.9997592262453638,0.9972151536519811,0.9992849644764267,0.9984855694207815,0.9977355574850918,195157,47,65684,545
,,mem,None,125,0.9,269946,660,269946,154,0,90238,37,331,0.9998629543341618,0.9969936475107106,0.9995916385228352,0.9984262394520134,0.997645046850008,269946,37,90569,814
,,shrimp,None,125,0.9,269675,416,269675,476,0,90238,86,282,0.9996811992838105,0.9967032195352722,0.9990508354855087,0.9981899883034009,0.9972921563904279,269675,86,90520,892
,,anc,Single-stranded,125,0.15,44745,3,44745,218,0,14958,3,57,0.9999329578975596,0.9950851754659076,0.9998002397123452,0.9975031767617094,0.9962656708455588,44745,3,15015,221
,,aln,Single-stranded,125,0.15,44744,3,44744,219,0,14958,3,57,0.9999329563993117,0.9950629364408664,0.9998002397123452,0.9974920022739179,0.9962489997332622,44744,3,15015,222
,,mem,Single-stranded,125,0.15,44859,110,44859,30,0,14958,7,53,0.9998439798511122,0.9968888197515501,0.9995338926621388,0.9983642129861459,0.9975506939700418,44859,7,15011,140
,,shrimp,Single-stranded,125,0.15,44826,69,44826,71,0,14958,17,43,0.9996208995829895,0.9968865364942401,0.9988680250366228,0.9982518455834047,0.9973826353694318,44826,17,15001,140
,,anc,Single-stranded,125,0.1,29819,3,29819,134,0,10014,1,35,0.9999664654594232,0.9954266257177193,0.9999004975124378,0.997691381156317,0.9965505174223867,29819,1,10049,137
,,aln,Single-stranded,125,0.1,29818,3,29818,135,0,10014,1,35,0.9999664643348201,0.9953932434236881,0.9999004975124378,0.9976746131325804,0.9965255211718242,29818,1,10049,138
,,bowtie2,High,125,0.8,196794,41,196794,43652,0,80296,6,328,0.999969512195122,0.818314503486675,0.9999255860101699,0.9000679187810294,0.8639156444535793,196794,6,80624,43693
,,bowtie2,High,125,0.95,233937,45,233937,51615,0,95214,3,394,0.9999871761990254,0.8191157470141494,0.9999686228572027,0.9005595366643762,0.8644755618979665,233937,3,95608,51660
,,bowtie2,High,125,0.9,221592,46,221592,48919,0,90235,3,373,0.9999864617883978,0.819021500090554,0.999966891437022,0.9005022838472668,0.8644176671244407,221592,3,90608,48965
,,mem,Single-stranded,125,0.1,29891,73,29891,16,0,10014,4,32,0.9998661983609299,0.9970313542361574,0.9996019900497513,0.9984467640918581,0.9976767424431676,29891,4,10046,89
,,shrimp,Single-stranded,125,0.1,29864,44,29864,48,0,10014,9,27,0.9996987246008101,0.9969288289491254,0.9991044776119403,0.9983118554547127,0.997475378693196,29864,9,10041,92
,,anc,Single-stranded,125,0.25,74637,4,74637,366,0,24987,7,104,0.9999062215315364,0.9950671270681403,0.9997210933142083,0.9974808053404255,0.9962339543479347,74637,7,25091,370
,,aln,Single-stranded,125,0.25,74636,3,74636,368,0,24987,5,106,0.999933012687397,0.9950537949791353,0.9998007809387203,0.9974874371859296,0.9962439438589481,74636,5,25093,371
,,bb,Mid,125,0.35,104664,185,104664,100,0,35010,22,127,0.9997898477351317,0.9972843952777063,0.9993742711681219,0.9985355498843228,0.997808833185828,104664,22,35137,285
,,bb,Mid,125,0.3,89563,157,89563,84,0,29885,20,112,0.9997767433553241,0.9973163778896263,0.9993337108971583,0.9985450450701556,0.9978217507782442,89563,20,29997,241
,,bb,Mid,125,0.45,134979,241,134979,131,0,45257,28,167,0.9997926033464931,0.9972515903096394,0.9993839655020681,0.9985204802521102,0.9977876473288607,134979,28,45424,372
,,mem,Single-stranded,125,0.25,74838,173,74838,44,0,24987,12,99,0.9998396793587174,0.9971087868896142,0.9995218742529285,0.9984723658316933,0.9977134983475283,74838,12,25086,217
,,shrimp,Single-stranded,125,0.25,74780,105,74780,122,0,24987,26,85,0.9996524342967141,0.9969736157958591,0.9989640608813452,0.9983112279975703,0.9974726537136007,74780,26,25072,227
,,anc,Single-stranded,125,0.2,59704,4,59704,288,0,19911,3,80,0.9999497546351349,0.9951330088672579,0.999849954986496,0.9975355671954754,0.9963120390048756,59704,3,19991,292
,,aln,Single-stranded,125,0.2,59703,3,59703,290,0,19911,3,80,0.9999497537935886,0.9951163410894059,0.999849954986496,0.9975271925281115,0.9962995374421802,59703,3,19991,293
,,bb,Mid,125,0.1,29874,57,29874,25,0,10014,7,29,0.9997657374251196,0.9972626518894379,0.9993034825870647,0.9985126259672109,0.997775333699945,29874,7,10043,82
,,bb,Mid,125,0.25,74798,136,74798,71,0,24986,17,94,0.9997727728396711,0.9972401839877342,0.999322628202574,0.998504872513683,0.9977622824718787,74798,17,25080,207
,,bb,Mid,125,0.2,59831,106,59831,59,0,19910,13,70,0.9997827685315153,0.9972498166544437,0.9993497724203472,0.9985146862483311,0.9977746940204278,59831,13,19980,165
,,mem,Single-stranded,125,0.2,59854,144,59854,37,0,19911,8,75,0.9998663592930407,0.9969850920296494,0.9995998799639892,0.9984236469636438,0.9976383560959152,59854,8,19986,181
,,shrimp,Single-stranded,125,0.2,59804,90,59804,102,0,19911,20,63,0.9996656860123028,0.9967997866524435,0.998999699909973,0.998230679352362,0.9973496687085885,59804,20,19974,192
,,anc,Single-stranded,125,0.35,104423,5,104423,523,0,35010,8,141,0.9999233943943848,0.9949690808091395,0.9997724622429535,0.9974400855851984,0.9961744343729927,104423,8,35151,528
,,aln,Single-stranded,125,0.35,104421,3,104421,527,0,35010,6,143,0.9999425435950473,0.9949500242970529,0.9998293466822151,0.9974400366800716,0.9961744343729927,104421,6,35153,530
,,mem,Single-stranded,125,0.35,104704,244,104704,75,0,35010,14,135,0.9998663076070972,0.9969625701036916,0.9996018089251685,0.9984123275849739,0.997624516699719,104704,14,35145,319
,,shrimp,Single-stranded,125,0.35,104621,148,104621,182,0,35010,33,116,0.9996846752154719,0.9968556755057122,0.9990614067521829,0.998268171083705,0.9974091785026051,104621,33,35126,330
,,anc,Single-stranded,125,0.3,89353,5,89353,448,0,29885,7,125,0.9999216651745747,0.9949557935995368,0.9997667988140054,0.9974325485862273,0.9961610041477846,89353,7,30010,453
,,aln,Single-stranded,125,0.3,89352,3,89352,451,0,29885,5,127,0.9999440446747317,0.9949446584860699,0.9998334277242895,0.9974380871050386,0.9961693497909416,89352,5,30012,454
,,bowtie2,High,125,0.75,184773,41,184773,40766,0,75413,6,307,0.9999675287776209,0.819101870733221,0.9999207669756754,0.9005431829203209,0.8645463415929321,184773,6,75720,40807
,,bowtie2,High,125,0.7,172584,39,172584,38099,0,70489,5,287,0.9999710294398831,0.8190127276696311,0.999929359573897,0.9004907242421949,0.8645023321243468,172584,5,70776,38138
,,bowtie2,High,125,0.85,209218,46,209218,46395,0,85286,6,348,0.9999713226016136,0.8183478774461295,0.99992993928071,0.9000888395574801,0.8639111160595255,209218,6,85634,46441
,,mem,Single-stranded,125,0.3,89596,213,89596,57,0,29885,12,120,0.999866083385412,0.9969955266730466,0.999600226538295,0.9984287417676098,0.997647706513851,89596,12,30005,270
,,shrimp,Single-stranded,125,0.3,89523,131,89523,152,0,29885,31,101,0.9996538401411439,0.9968487628888938,0.9989672518905953,0.9982493309545049,0.9973794680487051,89523,31,29986,283
,,anc,Single-stranded,125,0.45,134667,8,134667,678,0,45255,11,184,0.9999183237054308,0.9949317709987957,0.9997579757975797,0.9974188148768104,0.9961449754705397,134667,11,45439,686
,,aln,Single-stranded,125,0.45,134665,4,134665,684,0,45255,9,186,0.9999331719559826,0.9949169948209496,0.9998019801980198,0.9974187766408544,0.9961449754705397,134665,9,45441,688
,,bb,High,125,0.8,238083,420,238083,1975,0,80297,47,285,0.9998026288161929,0.9900406690009065,0.99941708318347,0.9948977033396851,0.9923950583450376,238083,47,80582,2395
,,mem,Single-stranded,125,0.45,135021,320,135021,105,0,45255,17,178,0.9998741095099157,0.99686221815336,0.9996259625962596,0.9983658922524067,0.9975566071112684,135021,17,45433,425
,,shrimp,Single-stranded,125,0.45,134926,196,134926,231,0,45255,42,153,0.9996888151265485,0.9968452860298627,0.999075907590759,0.9982650256546846,0.9974060164930891,134926,42,45408,427
,,anc,Single-stranded,125,0.4,119338,6,119338,608,0,40042,9,162,0.9999245896419684,0.9948812858476724,0.999776191778778,0.9973965624595172,0.9961102612930416,119338,9,40204,614
,,aln,Single-stranded,125,0.4,119336,3,119336,613,0,40042,7,164,0.9999413455334624,0.9948646125116714,0.9998259269390496,0.997396518941056,0.9961102612930416,119336,7,40206,616
,,bb,High,125,0.9,267867,472,267867,2210,0,90235,51,317,0.9998096432490539,0.9900868234589668,0.9994371047316314,0.9949244800517024,0.9924325491759702,267867,51,90552,2682
,,bowtie2,High,125,0.5,123085,35,123085,27351,0,50381,4,209,0.9999675031887496,0.8179981524679174,0.9999209392418074,0.8998757128235122,0.8637753960162137,123085,4,50590,27386
,,bowtie2,High,125,0.65,160366,38,160366,35299,0,65461,4,269,0.9999750576791171,0.8194355732921825,0.9999391486901755,0.9007478803503777,0.8648202052502132,160366,4,65730,35337
,,bowtie2,High,125,0.6,147839,36,147839,32697,0,60357,4,253,0.9999729442719641,0.8187260483352901,0.9999340086448675,0.9003181949667343,0.8642665826374665,147839,4,60610,32733
,,mem,Single-stranded,125,0.4,119660,287,119660,89,0,40042,15,156,0.9998746605389597,0.9968676063847512,0.9996269862979633,0.9983688691799709,0.9975600471765814,119660,15,40198,376
,,shrimp,Single-stranded,125,0.4,119570,174,119570,208,0,40042,36,135,0.9996990117552631,0.9968153928237962,0.999104767115112,0.9982551198457158,0.9973901913651547,119570,36,40177,382
,,anc,Single-stranded,125,0.55,164604,11,164604,826,0,55339,13,220,0.9999210288123341,0.9949407946035143,0.999766069243504,0.9974246950535967,0.9961540723848823,164604,13,55559,837
,,aln,Single-stranded,125,0.55,164598,4,164598,839,0,55339,11,222,0.9999331749782818,0.9949045278981631,0.9998020585906572,0.9974125132555672,0.9961359739019877,164598,11,55561,843
,,bb,Mid,125,0.15,44831,83,44831,52,0,14956,12,48,0.9997323997056397,0.9969977316194458,0.999200852424081,0.9983631929984746,0.9975492647794338,44831,12,15004,135
,,mem,Single-stranded,125,0.55,165035,391,165035,126,0,55339,22,211,0.9998667127113664,0.9968771141393641,0.9996041171813144,0.9983696753566903,0.9975624536459181,165035,22,55550,517
,,shrimp,Single-stranded,125,0.55,164918,249,164918,274,0,55339,53,180,0.9996787314133999,0.9968387521835579,0.999046282300439,0.9982567219108264,0.9973938184631673,164918,53,55519,523
,,anc,Single-stranded,125,0.5,149702,10,149702,759,0,50381,12,208,0.9999198471752808,0.9948893806780044,0.9997628505365507,0.9973982710661757,0.9961158192090396,149702,12,50589,769
,,aln,Single-stranded,125,0.5,149698,4,149698,769,0,50381,10,210,0.9999332033024287,0.9948627974825713,0.9998023754471256,0.997391556371365,0.9961058725232752,149698,10,50591,773
,,bb,High,125,0.95,282749,498,282749,2342,0,95215,52,334,0.9998161251197839,0.990055639397876,0.9994560726352235,0.994911944263622,0.9924132322463863,282749,52,95549,2840
,,bowtie2,High,125,0.3,73544,20,73544,16242,0,29885,1,141,0.9999864028825889,0.8189207848027972,0.999966696639691,0.9004413808302366,0.8642861315330501,73544,1,30026,16262
,,mem,Single-stranded,125,0.5,150100,354,150100,118,0,50381,21,199,0.9998601128423072,0.9968652870387589,0.9995849884389637,0.9983604540178854,0.9975493729277786,150100,21,50580,472
,,shrimp,Single-stranded,125,0.5,149992,223,149992,256,0,50381,50,170,0.999666759973874,0.9968166623468974,0.9990118772356278,0.9982396768193057,0.9973691016153418,149992,50,50551,479
,,anc,Single-stranded,125,0.65,194723,14,194723,966,0,65463,16,253,0.9999178387482733,0.9949924119712013,0.9997565873547131,0.9974490449285681,0.996190257616616,194723,16,65716,980
,,aln,Single-stranded,125,0.65,194716,5,194716,982,0,65463,14,255,0.999928105582088,0.9949566434852812,0.999787013935374,0.9974361798311104,0.996171132403848,194716,14,65718,987
,,bowtie2,High,125,0.45,110765,29,110765,24559,0,45255,1,193,0.9999909719589044,0.8183416695603348,0.9999779973156725,0.900093044421601,0.8640003982256833,110765,1,45448,24588
,,mem,Single-stranded,125,0.65,195236,450,195236,151,0,65463,27,242,0.9998617249555728,0.9969311212896439,0.9995892411610783,0.9983942725645615,0.9975991038693424,195236,27,65705,601
,,shrimp,Single-stranded,125,0.65,195091,280,195091,332,0,65463,66,203,0.9996618107472445,0.9968728123738522,0.9989959228381915,0.9982653635572839,0.9974066211486603,195091,66,65666,612
,,anc,Single-stranded,125,0.6,179658,13,179658,901,0,60359,16,237,0.9999109498313612,0.9949383071572558,0.9997360258694648,0.997418430738995,0.996144022820751,179658,16,60596,914
,,aln,Single-stranded,125,0.6,179651,4,179651,917,0,60359,14,239,0.9999220771992319,0.9948995414571473,0.9997690226357817,0.997404486490838,0.9961232917606475,179651,14,60598,921
,,bowtie2,High,125,0.55,135470,31,135470,29940,0,55338,4,225,0.9999704740392991,0.8188417623201021,0.9999280148289452,0.9003871525181529,0.8643714254687613,135470,4,55563,29971
,,mem,Single-stranded,125,0.6,180134,422,180134,138,0,60359,25,228,0.99986123368802,0.9969008378806159,0.9995875404210387,0.9983788412456043,0.9975756922745393,180134,25,60587,560
,,shrimp,Single-stranded,125,0.6,180003,267,180003,302,0,60359,59,194,0.999672335084582,0.9968489023768912,0.9990265953936515,0.9982586223151451,0.9973961788510017,180003,59,60553,569
,,anc,Single-stranded,125,0.75,224466,15,224466,1099,0,75414,16,294,0.9999287247975339,0.9950616189378491,0.9997887063546563,0.9974892348165365,0.9962496349202135,224466,16,75708,1114
,,aln,Single-stranded,125,0.75,224459,6,224459,1115,0,75414,14,296,0.9999376316973534,0.995030587818069,0.9998151180603243,0.9974780748045231,0.9962330403844623,224459,14,75710,1121
,,bb,High,125,0.75,223356,392,223356,1823,0,75413,42,268,0.9998119947358526,0.9901804753270589,0.9994453468563053,0.99497292686132,0.992508977941811,223356,42,75681,2215
,,bb,High,125,0.7,208658,353,208658,1704,0,70489,39,250,0.9998131262068932,0.9902379991932231,0.9994489813218796,0.9950025273478107,0.992553988909138,208658,39,70739,2057
,,bb,High,125,0.85,253105,439,253105,2106,0,85287,47,307,0.9998143407913033,0.990044983375709,0.9994511974404783,0.9949056804021997,0.9924053080802013,253105,47,85594,2545
,,bowtie2,High,125,0.4,98165,27,98165,21760,0,40042,2,173,0.9999796265547486,0.8183690142723756,0.9999502697864088,0.9001049885612901,0.8639624396730953,98165,2,40215,21787
,,mem,Single-stranded,125,0.75,225053,512,225053,168,0,75414,31,279,0.9998622736400633,0.9969875915351322,0.9995906185621467,0.9984228633791538,0.9976414546684933,225053,31,75693,680
,,shrimp,Single-stranded,125,0.75,224891,320,224891,369,0,75414,74,236,0.9996710599426577,0.9969456512102137,0.9990227668902858,0.9983064954666016,0.9974676738443565,224891,74,75650,689
,,anc,Single-stranded,125,0.7,209680,14,209680,1028,0,70490,16,273,0.9999236990691286,0.9950550962880003,0.9997739442490005,0.9974834569404736,0.9962415764064781,209680,16,70763,1042
,,aln,Single-stranded,125,0.7,209673,5,209673,1044,0,70490,14,275,0.9999332338199316,0.995021877165175,0.9998022012178753,0.9974715098868008,0.9962238144802328,209673,14,70765,1049
,,bb,High,125,0.5,148975,265,148975,1226,0,50381,26,194,0.9998255045268153,0.9900907846290856,0.9994861761625264,0.9949343333322203,0.992455251234663,148975,26,50575,1491
,,bb,High,125,0.65,193806,327,193806,1564,0,65462,38,231,0.9998039660758136,0.9903371027660107,0.9994218861724301,0.9950480180520151,0.9926212953470936,193806,38,65693,1891
,,bb,High,125,0.6,178803,307,178803,1456,0,60358,33,220,0.9998154733946185,0.990236257102666,0.9994555443731336,0.9950028102236492,0.9925531870783698,178803,33,60578,1763
,,mem,Single-stranded,125,0.7,210228,475,210228,159,0,70490,28,261,0.9998668290084468,0.9969932941924102,0.9996044024357508,0.9984279940539231,0.9976494899535224,210228,28,70751,634
,,shrimp,Single-stranded,125,0.7,210079,293,210079,350,0,70490,69,220,0.9996716599729715,0.9969485862890444,0.9990251345738143,0.9983082662104689,0.9974707017026583,210079,69,70710,643
,,anc,Single-stranded,125,0.85,254368,16,254368,1275,0,85292,19,335,0.999925310648736,0.9949503048983216,0.9997781565980898,0.9974316042082478,0.9961617907736482,254368,19,85627,1291
,,aln,Single-stranded,125,0.85,254361,6,254361,1292,0,85292,17,337,0.9999331703213328,0.9949229246770112,0.9998015085351329,0.997421755676549,0.9961471411201125,254361,17,85629,1298
,,mem,Single-stranded,125,0.85,255055,577,255055,195,0,85292,34,320,0.9998667131863781,0.9969823357190601,0.999603017070266,0.9984224412623601,0.9976396376873135,255055,34,85612,772
,,shrimp,Single-stranded,125,0.85,254868,369,254868,422,0,85292,82,272,0.9996783683075112,0.9969060349919229,0.9990425705812297,0.9982902769046373,0.9974421704926678,254868,82,85564,791
,,anc,Single-stranded,125,0.8,239283,15,239283,1189,0,80300,19,313,0.9999206024187011,0.9949934923717291,0.999764361543804,0.9974509628190725,0.996191443047593,239283,19,80613,1204
,,aln,Single-stranded,125,0.8,239276,6,239276,1205,0,80300,17,315,0.9999289573869691,0.9949643847692391,0.9997891655918246,0.9974404935595482,0.996175872495866,239276,17,80615,1211
,,bowtie2,High,125,0.25,61408,15,61408,13584,0,24986,0,114,1.0,0.8186969216206488,1.0,0.9003115493164242,0.8641553537714646,61408,0,25100,13599
,,bowtie2,High,125,0.2,49067,13,49067,10916,0,19909,0,87,1.0,0.8178378558570571,1.0,0.8997918634183912,0.8633738373837384,49067,0,19996,10929
,,bowtie2,High,125,0.35,85765,23,85765,19163,0,35010,2,159,0.9999766810078469,0.8171908795533154,0.9999431349691508,0.8993907234765465,0.8630621886641641,85765,2,35169,19186
,,mem,Single-stranded,125,0.8,239919,549,239919,181,0,80300,34,298,0.9998583055848437,0.9969665363246887,0.9995783311836491,0.9984103270481604,0.9976220193537744,239919,34,80598,730
,,shrimp,Single-stranded,125,0.8,239743,348,239743,396,0,80300,80,252,0.9996664206518975,0.9969062776782113,0.9990078380791745,0.998284441298328,0.9974339730754019,239743,80,80552,744
,,anc,Single-stranded,125,0.95,284159,17,284159,1422,0,95219,23,363,0.9999190659506936,0.9949614493098691,0.9997594268082213,0.997434097370915,0.9961647730998969,284159,23,95582,1439
,,aln,Single-stranded,125,0.95,284152,7,284152,1439,0,95219,21,365,0.9999261013537528,0.994936939334309,0.999780346216202,0.9974252813849775,0.9961516567288295,284152,21,95584,1446
,,bowtie2,High,125,0.15,36853,13,36853,8100,0,14955,0,63,1.0,0.8195747898412133,1.0,0.9008421026900842,0.8647472659375833,36853,0,15018,8113
,,mem,Single-stranded,125,0.95,284924,652,284924,213,0,95219,39,347,0.9998631401269639,0.9969732914842768,0.9995920715443753,0.9984161246916349,0.9976297477149614,284924,39,95566,865
,,shrimp,Single-stranded,125,0.95,284709,410,284709,479,0,95219,93,293,0.9996734573493163,0.9968872331038733,0.9990272475288949,0.9982784011220196,0.9974239447223657,284709,93,95512,889
,,anc,Single-stranded,125,0.9,269207,16,269207,1335,0,90239,22,346,0.9999182851773026,0.9950066159566525,0.999757193152847,0.9974564041001358,0.9961984134675287,269207,22,90585,1351
,,aln,Single-stranded,125,0.9,269200,6,269200,1352,0,90239,20,348,0.9999257113141669,0.9949807435004694,0.9997792665025881,0.9974470986220262,0.9961845693796464,269200,20,90587,1358
,,bb,High,125,0.45,134020,236,134020,1091,0,45255,22,173,0.9998358723385208,0.9901955713831855,0.9995159515951595,0.9949923716261615,0.9925385930076274,134020,22,45428,1327
,,bb,High,125,0.4,118778,200,118778,968,0,40042,19,152,0.9998400633012618,0.9902622846947793,0.9995275159774203,0.995028126479101,0.9925886150637804,118778,19,40194,1168
,,bb,High,125,0.55,163812,283,163812,1341,0,55338,29,204,0.9998229991272026,0.9901835150753161,0.999478145075669,0.9949799105312548,0.9925205988950576,163812,29,55542,1624
,,bowtie2,High,125,0.1,24539,10,24539,5407,0,10013,0,40,1.0,0.8191681132327413,1.0,0.9005963849894485,0.8646054637706516,24539,0,10053,5417
,,mem,Single-stranded,125,0.9,269926,612,269926,202,0,90239,37,331,0.9998629441812397,0.9969934254266085,0.999591643029788,0.9984261230287238,0.9976449230241292,269926,37,90570,814
,,shrimp,Single-stranded,125,0.9,269725,386,269725,447,0,90239,87,281,0.9996775532593065,0.9969211777142054,0.9990398092862582,0.998297462849529,0.9974526878296623,269725,87,90520,833
,,bb,High,125,0.15,44505,79,44505,378,0,14956,9,51,0.9997978164173069,0.9898358613940661,0.9994006393180608,0.9947918995037776,0.9922304845109874,44505,9,15007,457
,,bb,High,125,0.1,29657,49,29657,248,0,10014,5,31,0.9998314341581822,0.9900847966882553,0.9995024875621891,0.994934245840043,0.9924507549245075,29657,5,10045,297
,,bb,High,125,0.25,74262,125,74262,613,0,24986,14,97,0.9998115138133449,0.99016,0.9994421644021197,0.9949623516171388,0.9924872873312887,74262,14,25083,738
,,bb,High,125,0.2,59387,101,59387,505,0,19910,9,74,0.9998484746447572,0.9898988215291784,0.9995498424448557,0.994848771662381,0.9923111544520291,59387,9,19984,606
,,bb,High,125,0.35,103918,174,103918,853,0,35010,18,131,0.9998268165024631,0.9902139215779694,0.9994880400466453,0.9949971514881679,0.992541255067664,103918,18,35141,1027
,,bb,High,125,0.3,88914,147,88914,739,0,29885,16,116,0.9998200832115147,0.9901336302895323,0.9994669687177267,0.9949532814860405,0.9924718529090196,88914,16,30001,886
,,bowtie2,Single-stranded,125,0.9,269277,131,269277,1137,0,90239,13,363,0.999951724906235,0.9953131641686226,0.9998565358936159,0.9976270527105505,0.996453095580906,269277,13,90602,1268
10,2,giraffe,High,125,0.15,44853,98,44853,28,4,14952,16,48,0.9995542976845765,0.9971986927232709,0.9986684420772304,0.9983751057294217,0.9975666261104352,44853,20,15000,126
10,2,safari,High,125,0.15,44853,98,44853,28,4,14952,16,48,0.9995542976845765,0.9971986927232709,0.9986684420772304,0.9983751057294217,0.9975666261104352,44853,20,15000,126
10,2,giraffe,High,125,0.1,29889,63,29889,17,4,10010,10,35,0.9995318195498779,0.997330574927425,0.9986082115518441,0.9984299839657937,0.9976516438493055,29889,14,10045,80
10,2,safari,High,125,0.1,29889,63,29889,17,4,10010,10,35,0.9995318195498779,0.997330574927425,0.9986082115518441,0.9984299839657937,0.9976516438493055,29889,14,10045,80
10,2,giraffe,High,125,0.25,74803,170,74803,48,8,24978,27,87,0.9995323231513402,0.9970941469721811,0.9986055776892431,0.9983117463749257,0.9974730576003036,74803,35,25065,218
10,2,safari,High,125,0.25,74803,170,74803,48,8,24978,27,87,0.9995323231513402,0.9970941469721811,0.9986055776892431,0.9983117463749257,0.9974730576003036,74803,35,25065,218
10,2,giraffe,High,125,0.2,59832,143,59832,38,7,19903,20,69,0.9995489400090212,0.9969839868028594,0.9986499324966248,0.9982648158035237,0.9974003899415088,59832,27,19972,181
10,2,safari,High,125,0.2,59832,143,59832,38,7,19903,20,69,0.9995489400090212,0.9969839868028594,0.9986499324966248,0.9982648158035237,0.9974003899415088,59832,27,19972,181
10,2,giraffe,High,125,0.35,104679,225,104679,67,15,34995,35,117,0.9995225773186033,0.9972182793342923,0.9985780103520846,0.9983690987124463,0.9975594613688424,104679,50,35112,292
10,2,safari,High,125,0.35,104679,225,104679,67,15,34995,35,117,0.9995225773186033,0.9972182793342923,0.9985780103520846,0.9983690987124463,0.9975594613688424,104679,50,35112,292
10,2,giraffe,High,125,0.3,89573,192,89573,58,10,29875,30,107,0.9995536361911777,0.9972167484942609,0.9986676437279328,0.9983838248734925,0.9975802077683674,89573,40,29982,250
10,2,safari,High,125,0.3,89573,192,89573,58,10,29875,30,107,0.9995536361911777,0.9972167484942609,0.9986676437279328,0.9983838248734925,0.9975802077683674,89573,40,29982,250
10,2,giraffe,High,125,0.45,135001,288,135001,85,20,45235,46,153,0.9995113536244975,0.997244670320741,0.9985479825757909,0.9983767254225505,0.9975722786294158,135001,66,45388,373
10,2,safari,High,125,0.45,135001,288,135001,85,20,45235,46,153,0.9995113536244975,0.997244670320741,0.9985479825757909,0.9983767254225505,0.9975722786294158,135001,66,45388,373
10,2,giraffe,High,125,0.4,119655,246,119655,72,16,40026,40,134,0.999532206731211,0.9973494036158136,0.9986075193952656,0.9984396121560054,0.997665257914089,119655,56,40160,318
10,2,safari,High,125,0.4,119655,246,119655,72,16,40026,40,134,0.999532206731211,0.9973494036158136,0.9986075193952656,0.9984396121560054,0.997665257914089,119655,56,40160,318
10,2,giraffe,High,125,0.55,164989,361,164989,114,25,55313,55,174,0.9995153541852195,0.9971292849199825,0.9985602965789048,0.998320893829058,0.9974890399989141,164989,80,55487,475
10,2,safari,High,125,0.55,164989,361,164989,114,25,55313,55,174,0.9995153541852195,0.9971292849199825,0.9985602965789048,0.998320893829058,0.9974890399989141,164989,80,55487,475
10,2,giraffe,High,125,0.5,150056,329,150056,106,23,50358,51,163,0.999507093851995,0.9971094616953837,0.9985374048819053,0.9983068381783042,0.9974687447161911,150056,74,50521,435
10,2,safari,High,125,0.5,150056,329,150056,106,23,50358,51,163,0.999507093851995,0.9971094616953837,0.9985374048819053,0.9983068381783042,0.9974687447161911,150056,74,50521,435
10,2,giraffe,High,125,0.65,195172,427,195172,133,28,65434,64,200,0.9995288430022943,0.9971389450881818,0.9986002495207376,0.9983324637592201,0.9975062916414873,195172,92,65634,560
10,2,safari,High,125,0.65,195172,427,195172,133,28,65434,64,200,0.9995288430022943,0.9971389450881818,0.9986002495207376,0.9983324637592201,0.9975062916414873,195172,92,65634,560
10,2,giraffe,High,125,0.6,180085,391,180085,124,26,60332,61,187,0.9995171280776147,0.9971483942414175,0.9985644985644986,0.9983313560919362,0.9975042080213593,180085,87,60519,515
10,2,safari,High,125,0.6,180085,391,180085,124,26,60332,61,187,0.9995171280776147,0.9971483942414175,0.9985644985644986,0.9983313560919362,0.9975042080213593,180085,87,60519,515
10,2,giraffe,High,125,0.75,224970,495,224970,153,29,75384,72,236,0.9995512527158097,0.997127888732282,0.9986661560201265,0.9983381001089442,0.9975144272729385,224970,101,75620,648
10,2,safari,High,125,0.75,224970,495,224970,153,29,75384,72,236,0.9995512527158097,0.997127888732282,0.9986661560201265,0.9983381001089442,0.9975144272729385,224970,101,75620,648
10,2,giraffe,High,125,0.7,210153,456,210153,143,29,70460,67,214,0.9995433985417291,0.9971577968417856,0.9986434930055108,0.9983491725672861,0.9975312764188944,210153,96,70674,599
10,2,safari,High,125,0.7,210153,456,210153,143,29,70460,67,214,0.9995433985417291,0.9971577968417856,0.9986434930055108,0.9983491725672861,0.9975312764188944,210153,96,70674,599
10,2,giraffe,High,125,0.85,254962,563,254962,170,34,85253,82,259,0.9995452371431484,0.997133303349694,0.9986453029382912,0.9983378134709548,0.9975126200109574,254962,116,85512,733
10,2,safari,High,125,0.85,254962,563,254962,170,34,85253,82,259,0.9995452371431484,0.997133303349694,0.9986453029382912,0.9983378134709548,0.9975126200109574,254962,116,85512,733
10,2,giraffe,High,125,0.8,239836,526,239836,162,32,80265,77,248,0.9995457292296152,0.9971395785867523,0.9986480117089628,0.9983412041151459,0.9975182627216281,239836,109,80513,688
10,2,safari,High,125,0.8,239836,526,239836,162,32,80265,77,248,0.9995457292296152,0.9971395785867523,0.9986480117089628,0.9983412041151459,0.9975182627216281,239836,109,80513,688
10,2,giraffe,High,125,0.95,284829,620,284829,183,38,95177,90,292,0.9995508094203687,0.9971886903428188,0.9986610458487191,0.9983683527022077,0.9975578982711178,284829,128,95469,803
10,2,safari,High,125,0.95,284829,620,284829,183,38,95177,90,292,0.9995508094203687,0.9971886903428188,0.9986610458487191,0.9983683527022077,0.9975578982711178,284829,128,95469,803
10,2,giraffe,High,125,0.9,269831,590,269831,174,36,90199,87,277,0.9995443668180505,0.9971765923243223,0.998642369121072,0.9983590756804654,0.9975442559953931,269831,123,90476,764
10,2,safari,High,125,0.9,269831,590,269831,174,36,90199,87,277,0.9995443668180505,0.9971765923243223,0.998642369121072,0.9983590756804654,0.9975442559953931,269831,123,90476,764
10,2,giraffe,Mid,125,0.15,44883,92,44883,0,8,14948,19,36,0.9993987975951903,0.9979544191217343,0.9982013190327094,0.9986760861100293,0.9980162037808822,44883,27,14984,92
10,2,safari,Mid,125,0.15,44883,92,44883,0,8,14948,19,36,0.9993987975951903,0.9979544191217343,0.9982013190327094,0.9986760861100293,0.9980162037808822,44883,27,14984,92
10,2,giraffe,Mid,125,0.1,29901,62,29901,0,4,10010,11,25,0.9994985960689932,0.9979307812969329,0.9985074626865672,0.998714073381319,0.9980756254217379,29901,15,10035,62
10,2,safari,Mid,125,0.1,29901,62,29901,0,4,10010,11,25,0.9994985960689932,0.9979307812969329,0.9985074626865672,0.998714073381319,0.9980756254217379,29901,15,10035,62
10,2,giraffe,Mid,125,0.25,74857,157,74857,0,13,24973,35,71,0.9993591883051866,0.9979070573492947,0.9980870396939263,0.9986325949345979,0.997952170699059,74857,48,25044,157
10,2,safari,Mid,125,0.25,74857,157,74857,0,13,24973,35,71,0.9993591883051866,0.9979070573492947,0.9980870396939263,0.9986325949345979,0.997952170699059,74857,48,25044,157
10,2,giraffe,Mid,125,0.2,59888,118,59888,0,10,19900,27,54,0.9993825615352524,0.9980335299803353,0.9981491671252063,0.998707590197697,0.9980624273410252,59888,37,19954,118
10,2,safari,Mid,125,0.2,59888,118,59888,0,10,19900,27,54,0.9993825615352524,0.9980335299803353,0.9981491671252063,0.998707590197697,0.9980624273410252,59888,37,19954,118
10,2,giraffe,Mid,125,0.35,104734,230,104734,0,18,34992,45,103,0.9993988377529891,0.9978087725315347,0.9982080891973377,0.9986031721816734,0.9979089650447467,104734,63,35095,230
10,2,safari,Mid,125,0.35,104734,230,104734,0,18,34992,45,103,0.9993988377529891,0.9978087725315347,0.9982080891973377,0.9986031721816734,0.9979089650447467,104734,63,35095,230
10,2,giraffe,Mid,125,0.3,89628,189,89628,0,14,29871,41,88,0.9993867288114804,0.9978957212999766,0.9981675218231492,0.9986406685236769,0.9979637990169489,89628,55,29959,189
10,2,safari,Mid,125,0.3,89628,189,89628,0,14,29871,41,88,0.9993867288114804,0.9978957212999766,0.9981675218231492,0.9986406685236769,0.9979637990169489,89628,55,29959,189
10,2,giraffe,Mid,125,0.45,135073,292,135073,0,24,45233,56,129,0.9994080782520551,0.9978428692793558,0.9982395141058932,0.9986248604529089,0.9979425575337239,135073,80,45362,292
10,2,safari,Mid,125,0.45,135073,292,135073,0,24,45233,56,129,0.9994080782520551,0.9978428692793558,0.9982395141058932,0.9986248604529089,0.9979425575337239,135073,80,45362,292
10,2,giraffe,Mid,125,0.4,119706,258,119706,0,22,40020,50,119,0.9993988879426939,0.9978493548064419,0.998209445176693,0.9986235202843056,0.9979397533947245,119706,72,40139,258
10,2,safari,Mid,125,0.4,119706,258,119706,0,22,40020,50,119,0.9993988879426939,0.9978493548064419,0.998209445176693,0.9986235202843056,0.9979397533947245,119706,72,40139,258
10,2,giraffe,Mid,125,0.55,165104,349,165104,0,25,55315,65,156,0.9994551860237054,0.9978906396378427,0.9983801587444431,0.9986723000662336,0.9980137004895617,165104,90,55471,349
10,2,safari,Mid,125,0.55,165104,349,165104,0,25,55315,65,156,0.9994551860237054,0.9978906396378427,0.9983801587444431,0.9986723000662336,0.9980137004895617,165104,90,55471,349
10,2,giraffe,Mid,125,0.5,150155,327,150155,0,25,50358,63,144,0.9994142821961756,0.9978269826291517,0.9982605257956118,0.9986200016626486,0.9979360627039071,150155,88,50502,327
10,2,safari,Mid,125,0.5,150155,327,150155,0,25,50358,63,144,0.9994142821961756,0.9978269826291517,0.9982605257956118,0.9986200016626486,0.9979360627039071,150155,88,50502,327
10,2,giraffe,Mid,125,0.65,195308,410,195308,0,33,65429,79,184,0.9994268754477535,0.9979051492453428,0.9982959300114111,0.9986654326605955,0.9980033888840015,195308,112,65613,410
10,2,safari,Mid,125,0.65,195308,410,195308,0,33,65429,79,184,0.9994268754477535,0.9979051492453428,0.9982959300114111,0.9986654326605955,0.9980033888840015,195308,112,65613,410
10,2,giraffe,Mid,125,0.6,180208,380,180208,0,29,60331,71,172,0.9994453934378952,0.9978957627306355,0.9983499166707919,0.9986699769462671,0.9980098759903977,180208,100,60503,380
10,2,safari,Mid,125,0.6,180208,380,180208,0,29,60331,71,172,0.9994453934378952,0.9978957627306355,0.9983499166707919,0.9986699769462671,0.9980098759903977,180208,100,60503,380
10,2,giraffe,Mid,125,0.75,225134,466,225134,0,36,75377,90,218,0.9994406463642014,0.9979343971631206,0.9983359966191677,0.9986869538215853,0.9980353178172116,225134,126,75595,466
10,2,safari,Mid,125,0.75,225134,466,225134,0,36,75377,90,218,0.9994406463642014,0.9979343971631206,0.9983359966191677,0.9986869538215853,0.9980353178172116,225134,126,75595,466
10,2,giraffe,Mid,125,0.7,210305,432,210305,0,34,70455,85,201,0.9994344751549253,0.9979500514859754,0.998318615330272,0.9986917117206958,0.9980427122112023,210305,119,70656,432
10,2,safari,Mid,125,0.7,210305,432,210305,0,34,70455,85,201,0.9994344751549253,0.9979500514859754,0.998318615330272,0.9986917117206958,0.9980427122112023,210305,119,70656,432
10,2,giraffe,Mid,125,0.85,255144,533,255144,0,40,85247,99,241,0.9994555062420921,0.9979153384934898,0.998376680252724,0.9986848285580083,0.9980310807960059,255144,139,85488,533
10,2,safari,Mid,125,0.85,255144,533,255144,0,40,85247,99,241,0.9994555062420921,0.9979153384934898,0.998376680252724,0.9986848285580083,0.9980310807960059,255144,139,85488,533
10,2,giraffe,Mid,125,0.8,240009,497,240009,0,38,80259,95,229,0.9994461610213957,0.9979335234879795,0.9983503057516032,0.9986892694861936,0.9980381593575127,240009,133,80488,497
10,2,safari,Mid,125,0.8,240009,497,240009,0,38,80259,95,229,0.9994461610213957,0.9979335234879795,0.9983503057516032,0.9986892694861936,0.9980381593575127,240009,133,80488,497
10,2,giraffe,Mid,125,0.95,285026,588,285026,0,41,95172,111,275,0.9994669995581706,0.9979412773883634,0.9984100252094688,0.9987035557611179,0.9980588280042916,285026,152,95447,588
10,2,safari,Mid,125,0.95,285026,588,285026,0,41,95172,111,275,0.9994669995581706,0.9979412773883634,0.9984100252094688,0.9987035557611179,0.9980588280042916,285026,152,95447,588
10,2,giraffe,Mid,125,0.9,270011,565,270011,0,40,90195,105,256,0.9994632730718548,0.9979118621015907,0.9983994878361075,0.9986869650769696,0.9980341776217425,270011,145,90451,565
10,2,safari,Mid,125,0.9,270011,565,270011,0,40,90195,105,256,0.9994632730718548,0.9979118621015907,0.9983994878361075,0.9986869650769696,0.9980341776217425,270011,145,90451,565
10,2,giraffe,None,125,0.15,44890,87,44890,0,4,14954,19,39,0.9994878988266204,0.9980656780132068,0.9984683004794885,0.9987762821225944,0.9981664527528211,44890,23,14993,87
10,2,safari,None,125,0.15,44890,87,44890,0,4,14954,19,39,0.9994878988266204,0.9980656780132068,0.9984683004794885,0.9987762821225944,0.9981664527528211,44890,23,14993,87
10,2,giraffe,None,125,0.1,29910,55,29910,0,3,10011,12,23,0.9994987468671679,0.9981645252794927,0.998507314160613,0.9988311905159459,0.9982506122857,29910,15,10034,55
10,2,safari,None,125,0.1,29910,55,29910,0,3,10011,12,23,0.9994987468671679,0.9981645252794927,0.998507314160613,0.9988311905159459,0.9982506122857,29910,15,10034,55
10,2,giraffe,None,125,0.25,74851,165,74851,0,9,24979,36,75,0.9993991668446913,0.9978004692332303,0.9982070998844575,0.998599178184535,0.9979024122259401,74851,45,25054,165
10,2,safari,None,125,0.25,74851,165,74851,0,9,24979,36,75,0.9993991668446913,0.9978004692332303,0.9982070998844575,0.998599178184535,0.9979024122259401,74851,45,25054,165
10,2,giraffe,None,125,0.2,59877,131,59877,0,5,19907,28,57,0.9994491737606409,0.9978169577389682,0.9983497524628694,0.9986323988058506,0.9979501281169927,59877,33,19964,131
10,2,safari,None,125,0.2,59877,131,59877,0,5,19907,28,57,0.9994491737606409,0.9978169577389682,0.9983497524628694,0.9986323988058506,0.9979501281169927,59877,33,19964,131
10,2,giraffe,None,125,0.35,104745,221,104745,0,14,34998,46,105,0.9994275082295692,0.9978945563325268,0.9982936609504308,0.9986604440079896,0.9979947048790757,104745,60,35103,221
10,2,safari,None,125,0.35,104745,221,104745,0,14,34998,46,105,0.9994275082295692,0.9978945563325268,0.9982936609504308,0.9986604440079896,0.9979947048790757,104745,60,35103,221
10,2,giraffe,None,125,0.3,89625,194,89625,0,11,29876,41,92,0.999420141173322,0.9978401006468565,0.9982678214523651,0.9986294959219147,0.9979472458882334,89625,52,29968,194
10,2,safari,None,125,0.3,89625,194,89625,0,11,29876,41,92,0.999420141173322,0.9978401006468565,0.9982678214523651,0.9986294959219147,0.9979472458882334,89625,52,29968,194
10,2,giraffe,None,125,0.45,135082,285,135082,0,19,45238,58,128,0.9994303006089125,0.9978946124240029,0.9983055696146821,0.9986618661422562,0.9979978983463303,135082,77,45366,285
10,2,safari,None,125,0.45,135082,285,135082,0,19,45238,58,128,0.9994303006089125,0.9978946124240029,0.9983055696146821,0.9986618661422562,0.9979978983463303,135082,77,45366,285
10,2,giraffe,None,125,0.4,119718,248,119718,0,17,40027,52,118,0.9994239775601693,0.9979327476118234,0.9982841796389317,0.998677805908581,0.9980209764015483,119718,69,40145,248
10,2,safari,None,125,0.4,119718,248,119718,0,17,40027,52,118,0.9994239775601693,0.9979327476118234,0.9982841796389317,0.998677805908581,0.9980209764015483,119718,69,40145,248
10,2,giraffe,None,125,0.55,165113,342,165113,0,25,55315,67,158,0.9994431161284465,0.9979329727116134,0.9983442814721497,0.998687473537773,0.9980363767984798,165113,92,55473,342
10,2,safari,None,125,0.55,165113,342,165113,0,25,55315,67,158,0.9994431161284465,0.9979329727116134,0.9983442814721497,0.998687473537773,0.9980363767984798,165113,92,55473,342
10,2,giraffe,None,125,0.5,150157,327,150157,0,23,50360,64,145,0.9994209419344533,0.9978270115095292,0.9982803605313093,0.998623340693251,0.9979410770057093,150157,87,50505,327
10,2,safari,None,125,0.5,150157,327,150157,0,23,50360,64,145,0.9994209419344533,0.9978270115095292,0.9982803605313093,0.998623340693251,0.9979410770057093,150157,87,50505,327
10,2,giraffe,None,125,0.65,195316,404,195316,0,29,65435,79,184,0.9994473554936958,0.9979358266911915,0.9983568396549364,0.9986910191642975,0.9980416681009918,195316,108,65619,404
10,2,safari,None,125,0.65,195316,404,195316,0,29,65435,79,184,0.9994473554936958,0.9979358266911915,0.9983568396549364,0.9986910191642975,0.9980416681009918,195316,108,65619,404
10,2,giraffe,None,125,0.6,180213,377,180213,0,26,60334,74,173,0.9994454088168906,0.99791239825018,0.9983500255746036,0.9986783152259748,0.9980223634622322,180213,100,60507,377
10,2,safari,None,125,0.6,180213,377,180213,0,26,60334,74,173,0.9994454088168906,0.99791239825018,0.9983500255746036,0.9986783152259748,0.9980223634622322,180213,100,60507,377
10,2,giraffe,None,125,0.75,225137,465,225137,0,34,75381,87,221,0.9994628381677898,0.9979388480598577,0.9984020707050698,0.9987002617220423,0.9980552559528748,225137,121,75602,465
10,2,safari,None,125,0.75,225137,465,225137,0,34,75381,87,221,0.9994628381677898,0.9979388480598577,0.9984020707050698,0.9987002617220423,0.9980552559528748,225137,121,75602,465
10,2,giraffe,None,125,0.7,210307,432,210307,0,32,70459,83,201,0.9994534791989431,0.997950070940832,0.9983751324620276,0.9987012092762626,0.9980569350014564,210307,115,70660,432
10,2,safari,None,125,0.7,210307,432,210307,0,32,70459,83,201,0.9994534791989431,0.997950070940832,0.9983751324620276,0.9987012092762626,0.9980569350014564,210307,115,70660,432
10,2,giraffe,None,125,0.85,255160,519,255160,0,37,85254,98,245,0.9994711999843319,0.9979701109594452,0.998423523366887,0.9987200914332236,0.9980838702305509,255160,135,85499,519
10,2,safari,None,125,0.85,255160,519,255160,0,37,85254,98,245,0.9994711999843319,0.9979701109594452,0.998423523366887,0.9987200914332236,0.9980838702305509,255160,135,85499,519
10,2,giraffe,None,125,0.8,240019,489,240019,0,35,80264,94,232,0.99946283125406,0.9979668035990487,0.9984,0.9987142571818514,0.998075563707249,240019,129,80496,489
10,2,safari,None,125,0.8,240019,489,240019,0,35,80264,94,232,0.99946283125406,0.9979668035990487,0.9984,0.9987142571818514,0.998075563707249,240019,129,80496,489
10,2,giraffe,None,125,0.95,285029,586,285029,0,39,95179,108,280,0.9994845288523578,0.9979482870297428,0.9984624395958412,0.9987158171730107,0.9980772307926373,285029,147,95459,586
10,2,safari,None,125,0.95,285029,586,285029,0,39,95179,108,280,0.9994845288523578,0.9979482870297428,0.9984624395958412,0.9987158171730107,0.9980772307926373,285029,147,95459,586
10,2,giraffe,None,125,0.9,270026,551,270026,0,37,90201,103,261,0.9994818000784703,0.9979636110977651,0.9984547802476766,0.9987221286267228,0.998086821216073,270026,140,90462,551
10,2,safari,None,125,0.9,270026,551,270026,0,37,90201,103,261,0.9994818000784703,0.9979636110977651,0.9984547802476766,0.9987221286267228,0.998086821216073,270026,140,90462,551
10,2,giraffe,Single-stranded,125,0.15,44889,91,44889,0,2,14956,20,38,0.999510142281401,0.9979768786127168,0.9985348961108151,0.9987429219832908,0.9981165411027402,44889,22,14994,91
10,2,safari,Single-stranded,125,0.15,44889,91,44889,0,2,14956,20,38,0.999510142281401,0.9979768786127168,0.9985348961108151,0.9987429219832908,0.9981165411027402,44889,22,14994,91
10,2,giraffe,Single-stranded,125,0.1,29912,57,29912,0,2,10012,13,22,0.9994987803655562,0.9980980346357903,0.998507314160613,0.9987979163884065,0.9982008096356639,29912,15,10034,57
10,2,safari,Single-stranded,125,0.1,29912,57,29912,0,2,10012,13,22,0.9994987803655562,0.9980980346357903,0.998507314160613,0.9987979163884065,0.9982008096356639,29912,15,10034,57
10,2,giraffe,Single-stranded,125,0.25,74857,161,74857,0,6,24981,37,74,0.9994259012016021,0.997853848409715,0.9982867160729939,0.9986392561266825,0.9979623636581565,74857,43,25055,161
10,2,safari,Single-stranded,125,0.25,74857,161,74857,0,6,24981,37,74,0.9994259012016021,0.997853848409715,0.9982867160729939,0.9986392561266825,0.9979623636581565,74857,43,25055,161
10,2,giraffe,Single-stranded,125,0.2,59886,124,59886,0,5,19906,29,56,0.9994325767690254,0.9979336777203799,0.9982996599319864,0.9986825648294838,0.9980251481138914,59886,34,19962,124
10,2,safari,Single-stranded,125,0.2,59886,124,59886,0,5,19906,29,56,0.9994325767690254,0.9979336777203799,0.9982996599319864,0.9986825648294838,0.9980251481138914,59886,34,19962,124
10,2,giraffe,Single-stranded,125,0.35,104743,225,104743,0,14,34996,47,104,0.9994179611465211,0.9978564895968295,0.9982651232900088,0.9986366149915146,0.9979590234712301,104743,61,35100,225
10,2,safari,Single-stranded,125,0.35,104743,225,104743,0,14,34996,47,104,0.9994179611465211,0.9978564895968295,0.9982651232900088,0.9986366149915146,0.9979590234712301,104743,61,35100,225
10,2,giraffe,Single-stranded,125,0.3,89631,191,89631,0,11,29874,42,91,0.9994090361714464,0.9978735721760816,0.9982343926977147,0.9986407139594219,0.9979639519359146,89631,53,29965,191
10,2,safari,Single-stranded,125,0.3,89631,191,89631,0,11,29874,42,91,0.9994090361714464,0.9978735721760816,0.9982343926977147,0.9986407139594219,0.9979639519359146,89631,53,29965,191
10,2,giraffe,Single-stranded,125,0.45,135082,287,135082,0,16,45239,59,127,0.9994450897844729,0.9978798690985381,0.9983495081534297,0.9986618661422562,0.9979978983463303,135082,75,45366,287
10,2,safari,Single-stranded,125,0.45,135082,287,135082,0,16,45239,59,127,0.9994450897844729,0.9978798690985381,0.9983495081534297,0.9986618661422562,0.9979978983463303,135082,75,45366,287
10,2,giraffe,Single-stranded,125,0.4,119716,252,119716,0,16,40026,53,117,0.9994239679425637,0.9978994398506268,0.9982840943002089,0.9986611220714652,0.9979960044949432,119716,69,40143,252
10,2,safari,Single-stranded,125,0.4,119716,252,119716,0,16,40026,53,117,0.9994239679425637,0.9978994398506268,0.9982840943002089,0.9986611220714652,0.9979960044949432,119716,69,40143,252
10,2,giraffe,Single-stranded,125,0.55,165120,339,165120,0,16,55323,67,158,0.9994975878162019,0.9979511540623357,0.9985062270534879,0.9987237723113027,0.9980906964433566,165120,83,55481,339
10,2,safari,Single-stranded,125,0.55,165120,339,165120,0,16,55323,67,158,0.9994975878162019,0.9979511540623357,0.9985062270534879,0.9987237723113027,0.9980906964433566,165120,83,55481,339
10,2,giraffe,Single-stranded,125,0.5,150172,314,150172,0,16,50365,64,145,0.9994675611639113,0.9979134271626596,0.9984186598141925,0.9986898895384022,0.9980405418846605,150172,80,50510,314
10,2,safari,Single-stranded,125,0.5,150172,314,150172,0,16,50365,64,145,0.9994675611639113,0.9979134271626596,0.9984186598141925,0.9986898895384022,0.9980405418846605,150172,80,50510,314
10,2,giraffe,Single-stranded,125,0.65,195325,401,195325,0,22,65441,80,183,0.9994780659786007,0.9979512175183675,0.9984481027295135,0.9987140581818368,0.9980761286966633,195325,102,65624,401
10,2,safari,Single-stranded,125,0.65,195325,401,195325,0,22,65441,80,183,0.9994780659786007,0.9979512175183675,0.9984481027295135,0.9987140581818368,0.9980761286966633,195325,102,65624,401
10,2,giraffe,Single-stranded,125,0.6,180226,370,180226,0,20,60339,75,172,0.999473161750434,0.9979512281556624,0.9984324984324985,0.99871161513589,0.9980721552889279,180226,95,60511,370
10,2,safari,Single-stranded,125,0.6,180226,370,180226,0,20,60339,75,172,0.999473161750434,0.9979512281556624,0.9984324984324985,0.99871161513589,0.9980721552889279,180226,95,60511,370
10,2,giraffe,Single-stranded,125,0.75,225156,455,225156,0,27,75387,88,220,0.9994895037532572,0.9979832543625976,0.9984812868122871,0.9987358111434921,0.9981084049871737,225156,115,75607,455
10,2,safari,Single-stranded,125,0.75,225156,455,225156,0,27,75387,88,220,0.9994895037532572,0.9979832543625976,0.9984812868122871,0.9987358111434921,0.9981084049871737,225156,115,75607,455
10,2,giraffe,Single-stranded,125,0.7,210315,432,210315,0,24,70466,84,200,0.9994867481216407,0.997950148756566,0.9984740158815384,0.9987178573972505,0.9980818482457792,210315,108,70666,432
10,2,safari,Single-stranded,125,0.7,210315,432,210315,0,24,70466,84,200,0.9994867481216407,0.997950148756566,0.9984740158815384,0.9987178573972505,0.9980818482457792,210315,108,70666,432
10,2,giraffe,Single-stranded,125,0.85,255168,520,255168,0,32,85260,99,244,0.9994868761726446,0.9979662713932606,0.9984702516494424,0.9987259949861739,0.9980927156974478,255168,131,85504,520
10,2,safari,Single-stranded,125,0.85,255168,520,255168,0,32,85260,99,244,0.9994868761726446,0.9979662713932606,0.9984702516494424,0.9987259949861739,0.9980927156974478,255168,131,85504,520
10,2,giraffe,Single-stranded,125,0.8,240032,485,240032,0,28,80272,95,231,0.9994878307759572,0.9979835105210858,0.9984744375263562,0.9987351041874707,0.9981067624080239,240032,123,80503,485
10,2,safari,Single-stranded,125,0.8,240032,485,240032,0,28,80272,95,231,0.9994878307759572,0.9979835105210858,0.9984744375263562,0.9987351041874707,0.9981067624080239,240032,123,80503,485
10,2,giraffe,Single-stranded,125,0.95,285032,591,285032,0,37,95182,109,279,0.9994880390492955,0.9979308389030295,0.9984729151631156,0.9987088319747163,0.998066783831283,285032,146,95461,591
10,2,safari,Single-stranded,125,0.95,285032,591,285032,0,37,95182,109,279,0.9994880390492955,0.9979308389030295,0.9984729151631156,0.9987088319747163,0.998066783831283,285032,146,95461,591
10,2,giraffe,Single-stranded,125,0.9,270030,556,270030,0,33,90206,104,260,0.9994929062394741,0.997945200416873,0.9984879087888922,0.9987184537117685,0.998081336917791,270030,137,90466,556
10,2,safari,Single-stranded,125,0.9,270030,556,270030,0,33,90206,104,260,0.9994929062394741,0.997945200416873,0.9984879087888922,0.9987184537117685,0.998081336917791,270030,137,90466,556
