k,w,tool,damage_level,read_length,subsampling_rate,mito_correct,mito_incorrect,mito_mapped,mito_unmapped,bacteria_mapped,bacteria_unmapped,numt_mapped,numt_unmapped,precision,sensitivity,specificity,f1,accuracy,TP,FP,TN,FN
10,2,vg giraffe,High,125,0.15,44778,72,44778,46,4,14952,19,39,0.9994866186022633,0.997371703492516,0.9984680964433196,0.9984280410716078,0.9976464697045568,44778,23,14991,118
10,2,SAFARI,High,125,0.15,44790,73,44790,33,7,14949,19,39,0.9994198500535523,0.9976389878831077,0.9982682829359265,0.9985286249331192,0.9977966950425639,44790,26,14988,106
10,2,vg giraffe,High,125,0.1,29850,45,29850,28,4,10010,12,25,0.9994642737561106,0.9975604050396016,0.9984081185951647,0.9985114318687384,0.9977735528093261,29850,16,10035,73
10,2,SAFARI,High,125,0.1,29858,46,29858,19,6,10008,12,25,0.9993975097067881,0.9978277579119741,0.9982091334195602,0.99861201692336,0.9979236503727423,29858,18,10033,65
10,2,vg giraffe,High,125,0.25,74682,127,74682,71,8,24978,39,75,0.9993710607662353,0.9973557692307692,0.9981274900398407,0.9983623979840784,0.9975495099019804,74682,47,25053,198
10,2,SAFARI,High,125,0.25,74699,128,74699,53,14,24972,39,75,0.999290988869863,0.9975827991452991,0.9978884462151394,0.9984361633875106,0.9976595319063812,74699,53,25047,181
10,2,vg giraffe,High,125,0.2,59747,93,59747,60,7,19903,28,54,0.999414539493493,0.9974457429048414,0.998249299719888,0.9984291706355176,0.9976468232113354,59747,35,19957,153
10,2,SAFARI,High,125,0.2,59761,94,59761,45,11,19899,28,54,0.9993478260869565,0.9976794657762939,0.9980492196878752,0.9985129490392648,0.9977719921894558,59761,39,19953,139
10,2,vg giraffe,High,125,0.35,104503,179,104503,104,15,34995,44,105,0.9994357414739581,0.9972992575344034,0.9983219090417816,0.9983663564973155,0.9975561827860946,104503,59,35100,283
10,2,SAFARI,High,125,0.35,104535,180,104535,71,21,34989,44,105,0.999378585086042,0.9976046418414674,0.9981512557239967,0.9984908255566275,0.9977419700596662,104535,65,35094,251
10,2,vg giraffe,High,125,0.3,89420,147,89420,89,10,29875,42,93,0.9994188125894135,0.9973677166056929,0.9982678214523651,0.9983922111562681,0.9975935024566329,89420,52,29968,236
10,2,SAFARI,High,125,0.3,89449,148,89449,59,16,29869,42,93,0.9993520059883585,0.9976911751583831,0.9980679546968687,0.9985208999626038,0.9977856880243323,89449,58,29962,207
10,2,vg giraffe,High,125,0.45,134780,226,134780,139,20,45235,53,142,0.9994586698108311,0.9972991971586074,0.9983938393839384,0.9983777657612278,0.9975746836844874,134780,73,45377,365
10,2,SAFARI,High,125,0.45,134822,227,134822,96,29,45226,53,142,0.9993921603510645,0.9976099744718635,0.9981958195819582,0.9985002721728278,0.9977574129959301,134822,82,45368,323
10,2,vg giraffe,High,125,0.4,119455,197,119455,121,16,40026,48,119,0.9994645202854776,0.9973449775825938,0.9984083165460469,0.9984036240242047,0.9976122313760298,119455,64,40145,318
10,2,SAFARI,High,125,0.4,119491,198,119491,84,22,40020,48,119,0.9994145248032386,0.9976455461581492,0.9982590962222389,0.9985292520076546,0.9977997524721531,119491,70,40139,282
10,2,vg giraffe,High,125,0.55,164763,271,164763,170,25,55313,59,167,0.999490436586653,0.9973305731096099,0.998488229789072,0.9984093367388676,0.9976219379620235,164763,84,55480,441
10,2,SAFARI,High,125,0.55,164815,272,164815,117,36,55302,59,167,0.9994239282032624,0.9976453354640323,0.9982902598804981,0.9985338398250302,0.9978076532830845,164815,95,55469,389
10,2,vg giraffe,High,125,0.5,149867,244,149867,151,23,50358,57,151,0.999466478155615,0.99737125820234,0.9984186285556148,0.9984177689542952,0.997635062807753,149867,80,50509,395
10,2,SAFARI,High,125,0.5,149914,245,149914,103,33,50348,57,151,0.9994000159995734,0.9976840452010488,0.9982209571250668,0.9985412933865306,0.9978192789679912,149914,90,50499,348
10,2,vg giraffe,High,125,0.65,194895,320,194895,206,28,65434,70,201,0.9994974178560256,0.9973083752513804,0.9985091202288044,0.9984016966604682,0.9976106052367568,194895,98,65635,526
10,2,SAFARI,High,125,0.65,194959,321,194959,141,40,65422,70,201,0.9994360969708155,0.9976358733196534,0.9983265635221273,0.99853517375605,0.9978097214670271,194959,110,65623,462
10,2,vg giraffe,High,125,0.6,179824,297,179824,185,26,60332,64,185,0.9994997609969207,0.9973267667188003,0.9985150230171432,0.9984120815057466,0.9976256989037536,179824,90,60517,482
10,2,SAFARI,High,125,0.6,179879,298,179879,129,37,60321,64,185,0.9994388265362818,0.9976318037114683,0.9983335258303496,0.9985344975935785,0.9978083374496187,179879,101,60506,427
10,2,vg giraffe,High,125,0.75,224655,369,224655,236,29,75384,75,232,0.9995372821555533,0.9973142146852526,0.9986265187533017,0.9984245109650927,0.9976443617516114,224655,104,75616,605
10,2,SAFARI,High,125,0.75,224733,370,224733,157,41,75372,75,232,0.9994840982170257,0.9976604812216994,0.9984680401479133,0.9985714571359381,0.9978636454249452,224733,116,75604,527
10,2,vg giraffe,High,125,0.7,209844,347,209844,226,29,70460,73,222,0.9995141607842016,0.9972768359970915,0.9985589963833634,0.9983942449739868,0.9975995817938058,209844,102,70682,573
10,2,SAFARI,High,125,0.7,209919,348,209919,150,41,70448,73,222,0.9994572281498622,0.9976332710760062,0.9983894665461122,0.9985444166963967,0.997823620826384,209919,114,70670,498
10,2,vg giraffe,High,125,0.85,254591,424,254591,268,34,85253,86,258,0.9995288778262423,0.9972892828743003,0.9985986383435905,0.9984078244057774,0.9976181676317194,254591,120,85511,692
10,2,SAFARI,High,125,0.85,254684,425,254684,174,48,85239,86,258,0.9994741344802958,0.9976535844533322,0.9984351461503428,0.9985630296745154,0.9978498976281408,254684,134,85497,599
10,2,vg giraffe,High,125,0.8,239491,393,239491,251,32,80265,83,247,0.999520045407878,0.9973181751931205,0.9985736787924641,0.9984178963232243,0.9976337596099288,239491,115,80512,644
10,2,SAFARI,High,125,0.8,239574,394,239574,167,45,80252,83,247,0.9994660036211629,0.9976638141045662,0.998412442482047,0.9985640957241729,0.9978519899489341,239574,128,80499,561
10,2,vg giraffe,High,125,0.95,284395,466,284395,303,38,95177,93,286,0.9995395851345747,0.9973033061676789,0.9986296211059271,0.9984201934385367,0.9976362939189721,284395,131,95463,769
10,2,SAFARI,High,125,0.95,284502,467,284502,195,55,95160,94,285,0.9994765519882242,0.9976785288465585,0.998441324769337,0.9985767310442862,0.9978700381869849,284502,149,95445,662
10,2,vg giraffe,High,125,0.9,269425,450,269425,288,36,90199,88,272,0.9995399723241415,0.9972683157945389,0.9986312710414482,0.9984028518913791,0.9976105865982182,269425,124,90471,738
10,2,SAFARI,High,125,0.9,269527,451,269527,185,51,90184,89,271,0.9994808411856104,0.9976458656440741,0.998454660853248,0.998562510419947,0.9978489735501361,269527,140,90455,636
10,2,vg giraffe,Mid,125,0.15,44837,61,44837,0,8,14948,24,36,0.9992868127214781,0.9986413648714865,0.9978689397975493,0.9989639845377476,0.9984477751443736,44837,32,14984,61
10,2,SAFARI,Mid,125,0.15,44837,61,44837,0,8,14948,24,36,0.9992868127214781,0.9986413648714865,0.9978689397975493,0.9989639845377476,0.9984477751443736,44837,32,14984,61
10,2,vg giraffe,Mid,125,0.1,29881,44,29881,0,4,10010,17,19,0.9992977058390743,0.9985296574770259,0.997910447761194,0.9989135340230999,0.9983739837398374,29881,21,10029,44
10,2,SAFARI,Mid,125,0.1,29881,44,29881,0,4,10010,17,19,0.9992977058390743,0.9985296574770259,0.997910447761194,0.9989135340230999,0.9983739837398374,29881,21,10029,44
10,2,vg giraffe,Mid,125,0.25,74776,105,74776,0,13,24973,46,65,0.9992115988508051,0.99859777513655,0.9976491214089334,0.9989045926955036,0.9983596391206065,74776,59,25038,105
10,2,SAFARI,Mid,125,0.25,74776,105,74776,0,13,24973,46,65,0.9992115988508051,0.99859777513655,0.9976491214089334,0.9989045926955036,0.9983596391206065,74776,59,25038,105
10,2,vg giraffe,Mid,125,0.2,59819,82,59819,0,10,19900,33,47,0.9992816812000935,0.998631074606434,0.9978489244622312,0.998956271970475,0.9984353681891577,59819,43,19947,82
10,2,SAFARI,Mid,125,0.2,59819,82,59819,0,10,19900,33,47,0.9992816812000935,0.998631074606434,0.9978489244622312,0.998956271970475,0.9984353681891577,59819,43,19947,82
10,2,vg giraffe,Mid,125,0.35,104627,160,104627,0,18,34992,53,86,0.9993218590613001,0.9984730930363499,0.9979800278813054,0.998897295749099,0.9983492453693117,104627,71,35078,160
10,2,SAFARI,Mid,125,0.35,104627,160,104627,0,18,34992,53,86,0.9993218590613001,0.9984730930363499,0.9979800278813054,0.998897295749099,0.9983492453693117,104627,71,35078,160
10,2,vg giraffe,Mid,125,0.3,89522,135,89522,0,14,29871,49,80,0.9992967572696322,0.9984942614631317,0.99790097954288,0.9988953481884827,0.9983454638132881,89522,63,29951,135
10,2,SAFARI,Mid,125,0.3,89522,135,89522,0,14,29871,49,80,0.9992967572696322,0.9984942614631317,0.99790097954288,0.9988953481884827,0.9983454638132881,89522,63,29951,135
10,2,vg giraffe,Mid,125,0.45,134934,210,134934,0,24,45233,64,120,0.999348254358549,0.998446101935713,0.9980634229000243,0.998896974452744,0.9983498075698425,134934,88,45353,210
10,2,SAFARI,Mid,125,0.45,134934,210,134934,0,24,45233,64,120,0.999348254358549,0.998446101935713,0.9980634229000243,0.998896974452744,0.9983498075698425,134934,88,45353,210
10,2,vg giraffe,Mid,125,0.4,119593,180,119593,0,22,40020,58,100,0.9993315117027233,0.9984971571222229,0.9980099502487563,0.9989141601864303,0.9983747257349678,119593,80,40120,180
10,2,SAFARI,Mid,125,0.4,119593,180,119593,0,22,40020,58,100,0.9993315117027233,0.9984971571222229,0.9980099502487563,0.9989141601864303,0.9983747257349678,119593,80,40120,180
10,2,vg giraffe,Mid,125,0.55,164950,254,164950,0,25,55315,72,147,0.9994122886208171,0.9984625069610905,0.9982541082452888,0.9989371720297592,0.9984100596567359,164950,97,55462,254
10,2,SAFARI,Mid,125,0.55,164950,254,164950,0,26,55314,72,147,0.9994062333381805,0.9984625069610905,0.9982361093612196,0.9989341472572459,0.9984055299121682,164950,98,55461,254
10,2,vg giraffe,Mid,125,0.5,150026,234,150026,0,25,50358,69,130,0.9993738342659206,0.9984426993211766,0.9981416314103831,0.9989080498035822,0.9983668754543372,150026,94,50488,234
10,2,SAFARI,Mid,125,0.5,150026,234,150026,0,25,50358,69,130,0.9993738342659206,0.9984426993211766,0.9981416314103831,0.9989080498035822,0.9983668754543372,150026,94,50488,234
10,2,vg giraffe,Mid,125,0.65,195120,305,195120,0,33,65429,86,185,0.9993904906294336,0.9984392989637969,0.9981896459921197,0.9989146683595109,0.998376461758782,195120,119,65614,305
10,2,SAFARI,Mid,125,0.65,195120,305,195120,0,35,65427,86,185,0.9993802531230633,0.9984392989637969,0.9981592198743401,0.9989095544531646,0.9983688035595311,195120,121,65612,305
10,2,vg giraffe,Mid,125,0.6,180031,277,180031,0,29,60331,80,165,0.9993949150660597,0.9984637398229695,0.9982014685256992,0.9989291104403409,0.998397761847638,180031,109,60496,277
10,2,SAFARI,Mid,125,0.6,180031,277,180031,0,30,60330,80,165,0.9993893672179015,0.9984637398229695,0.9981849682369441,0.9989263390937414,0.9983936109715955,180031,110,60495,277
10,2,vg giraffe,Mid,125,0.75,224919,347,224919,0,36,75377,94,214,0.9994223480219864,0.9984595988742198,0.9982831711150143,0.9989407414809632,0.9984152139461173,224919,130,75591,347
10,2,SAFARI,Mid,125,0.75,224919,347,224919,0,38,75375,94,214,0.9994134662809763,0.9984595988742198,0.9982567583629376,0.9989363048696805,0.99840856914086,224919,132,75589,347
10,2,vg giraffe,Mid,125,0.7,210096,327,210096,0,34,70455,89,207,0.9994148958942817,0.998445987368301,0.9982623437168892,0.9989302066840686,0.9983997610309806,210096,123,70662,327
10,2,SAFARI,Mid,125,0.7,210096,327,210096,0,36,70453,89,207,0.9994053876634589,0.998445987368301,0.99823408914318,0.99892545715617,0.998392648857785,210096,125,70660,327
10,2,vg giraffe,Mid,125,0.85,254880,409,254880,0,40,85247,103,243,0.9994392662622587,0.9983978941513344,0.9983300830287389,0.9989183087993226,0.998380861311385,254880,143,85490,409
10,2,SAFARI,Mid,125,0.85,254880,409,254880,0,43,85244,103,243,0.9994275093519877,0.9983978941513344,0.9982950498055656,0.9989124364363188,0.998372061644599,254880,146,85487,409
10,2,vg giraffe,Mid,125,0.8,239758,383,239758,0,38,80259,101,227,0.9994205846675865,0.9984051036682615,0.998275968992248,0.9989125860869347,0.9983726454798826,239758,139,80486,383
10,2,SAFARI,Mid,125,0.8,239758,383,239758,0,41,80256,101,227,0.9994080867027928,0.9984051036682615,0.9982387596899225,0.9989063434164999,0.998363292867698,239758,142,80483,383
10,2,vg giraffe,Mid,125,0.95,284716,453,284716,0,41,95172,113,269,0.9994594025344894,0.9984114682872262,0.9983890370835294,0.9989351605767325,0.9984058366862414,284716,154,95441,453
10,2,SAFARI,Mid,125,0.95,284716,453,284716,0,44,95169,113,269,0.9994488772189712,0.9984114682872262,0.9983576546890528,0.9989299034106259,0.9983979577901272,284716,157,95438,453
10,2,vg giraffe,Mid,125,0.9,269741,427,269741,0,40,90195,105,257,0.9994627361182129,0.9984195019395339,0.9983995055023897,0.9989408466560752,0.9984144803403878,269741,145,90452,427
10,2,SAFARI,Mid,125,0.9,269741,427,269741,0,43,90192,105,257,0.9994516264093757,0.9984195019395339,0.9983663918231288,0.9989352975704415,0.9984061646778374,269741,148,90449,427
10,2,vg giraffe,None,125,0.15,44827,73,44827,0,4,14954,18,40,0.999509465093982,0.9983741648106904,0.9985348961108151,0.9989414923843163,0.998414446892316,44827,22,14994,73
10,2,SAFARI,None,125,0.15,44827,73,44827,0,4,14954,18,40,0.999509465093982,0.9983741648106904,0.9985348961108151,0.9989414923843163,0.998414446892316,44827,22,14994,73
10,2,vg giraffe,None,125,0.1,29878,47,29878,0,3,10011,11,26,0.9995316472634819,0.9984294068504594,0.9986071037707691,0.9989802230135245,0.9984740844506704,29878,14,10037,47
10,2,SAFARI,None,125,0.1,29878,47,29878,0,3,10011,11,26,0.9995316472634819,0.9984294068504594,0.9986071037707691,0.9989802230135245,0.9984740844506704,29878,14,10037,47
10,2,vg giraffe,None,125,0.25,74769,114,74769,0,9,24979,40,74,0.9993450773877944,0.9984776250951485,0.998047964305633,0.9989111629180835,0.9983697554633195,74769,49,25053,114
10,2,SAFARI,None,125,0.25,74769,114,74769,0,9,24979,40,74,0.9993450773877944,0.9984776250951485,0.998047964305633,0.9989111629180835,0.9983697554633195,74769,49,25053,114
10,2,vg giraffe,None,125,0.2,59811,92,59811,0,5,19907,27,55,0.999465267449827,0.9984641837637513,0.9983995198559568,0.9989644748050038,0.9984480018023205,59811,32,19962,92
10,2,SAFARI,None,125,0.2,59811,92,59811,0,5,19907,27,55,0.999465267449827,0.9984641837637513,0.9983995198559568,0.9989644748050038,0.9984480018023205,59811,32,19962,92
10,2,vg giraffe,None,125,0.35,104628,158,104628,0,14,34998,49,100,0.9993982290741324,0.9984921649838719,0.9982082420864026,0.998944991574254,0.998420830743067,104628,63,35098,158
10,2,SAFARI,None,125,0.35,104628,158,104628,0,14,34998,49,100,0.9993982290741324,0.9984921649838719,0.9982082420864026,0.998944991574254,0.998420830743067,104628,63,35098,158
10,2,vg giraffe,None,125,0.3,89521,136,89521,0,11,29876,45,90,0.9993748395235384,0.9984831078443401,0.998134701219106,0.998928774674448,0.9983957085202918,89521,56,29966,136
10,2,SAFARI,None,125,0.3,89521,136,89521,0,11,29876,45,90,0.9993748395235384,0.9984831078443401,0.998134701219106,0.998928774674448,0.9983957085202918,89521,56,29966,136
10,2,vg giraffe,None,125,0.45,134935,208,134935,0,19,45238,60,135,0.9994148754943932,0.9984608895762267,0.9982619026665494,0.9989376547711147,0.9984108087156345,134935,79,45373,208
10,2,SAFARI,None,125,0.45,134935,208,134935,0,19,45238,60,135,0.9994148754943932,0.9984608895762267,0.9982619026665494,0.9989376547711147,0.9984108087156345,134935,79,45373,208
10,2,vg giraffe,None,125,0.4,119590,182,119590,0,17,40027,54,113,0.9994066571397532,0.9984804461810773,0.9982343139936833,0.9989433369669176,0.9984185819743348,119590,71,40140,182
10,2,SAFARI,None,125,0.4,119590,182,119590,0,17,40027,54,113,0.9994066571397532,0.9984804461810773,0.9982343139936833,0.9989433369669176,0.9984185819743348,119590,71,40140,182
10,2,vg giraffe,None,125,0.55,164947,256,164947,0,25,55315,70,156,0.9994243889434204,0.9984503913367191,0.9982903214195731,0.9989371527199503,0.9984101028677034,164947,95,55471,256
10,2,SAFARI,None,125,0.55,164947,256,164947,0,25,55315,70,156,0.9994243889434204,0.9984503913367191,0.9982903214195731,0.9989371527199503,0.9984101028677034,164947,95,55471,256
10,2,vg giraffe,None,125,0.5,150025,234,150025,0,23,50360,66,142,0.9994071172575509,0.9984426889570674,0.9982407938170821,0.9989246703265606,0.9983918347025144,150025,89,50502,234
10,2,SAFARI,None,125,0.5,150025,234,150025,0,23,50360,66,142,0.9994071172575509,0.9984426889570674,0.9982407938170821,0.9989246703265606,0.9983918347025144,150025,89,50502,234
10,2,vg giraffe,None,125,0.65,195117,310,195117,0,29,65435,82,189,0.9994314340156125,0.9984137299349629,0.9983114018407241,0.9989223227656115,0.9983879737480951,195117,111,65624,310
10,2,SAFARI,None,125,0.65,195117,310,195117,0,29,65435,82,189,0.9994314340156125,0.9984137299349629,0.9983114018407241,0.9989223227656115,0.9983879737480951,195117,111,65624,310
10,2,vg giraffe,None,125,0.6,180021,286,180021,0,26,60334,76,173,0.9994337202911344,0.998413816435302,0.9983170816215413,0.9989235080320729,0.9983894801507579,180021,102,60507,286
10,2,SAFARI,None,125,0.6,180021,286,180021,0,26,60334,76,173,0.9994337202911344,0.998413816435302,0.9983170816215413,0.9989235080320729,0.9983894801507579,180021,102,60507,286
10,2,vg giraffe,None,125,0.75,224915,357,224915,0,34,75381,89,218,0.9994534256436691,0.9984152491210625,0.9983756371992287,0.9989340676422909,0.9984052838262557,224915,123,75599,357
10,2,SAFARI,None,125,0.75,224915,357,224915,0,34,75381,89,218,0.9994534256436691,0.9984152491210625,0.9983756371992287,0.9989340676422909,0.9984052838262557,224915,123,75599,357
10,2,vg giraffe,None,125,0.7,210099,330,210099,0,32,70459,86,209,0.9994386752736458,0.9984317750880345,0.9983330037012969,0.9989349714486767,0.9984069128602671,210099,118,70668,330
10,2,SAFARI,None,125,0.7,210099,330,210099,0,32,70459,86,209,0.9994386752736458,0.9984317750880345,0.9983330037012969,0.9989349714486767,0.9984069128602671,210099,118,70668,330
10,2,vg giraffe,None,125,0.85,254885,410,254885,0,37,85254,104,240,0.9994471151960976,0.9983940147672301,0.9983534769661937,0.9989202874269332,0.9983838324582759,254885,141,85494,410
10,2,SAFARI,None,125,0.85,254885,410,254885,0,37,85254,104,240,0.9994471151960976,0.9983940147672301,0.9983534769661937,0.9989202874269332,0.9983838324582759,254885,141,85494,410
10,2,vg giraffe,None,125,0.8,239763,384,239763,0,35,80264,99,231,0.9994414269457309,0.9984009794001174,0.9983380669486165,0.9989209322478773,0.9983851659725167,239763,134,80495,384
10,2,SAFARI,None,125,0.8,239763,384,239763,0,35,80264,99,231,0.9994414269457309,0.9984009794001174,0.9983380669486165,0.9989209322478773,0.9983851659725167,239763,134,80495,384
10,2,vg giraffe,None,125,0.95,284713,461,284713,0,39,95179,114,265,0.9994629053660318,0.9983834430908849,0.9983995313660471,0.9989228826047296,0.9983874822399815,284713,153,95444,461
10,2,SAFARI,None,125,0.95,284713,461,284713,0,39,95179,114,265,0.9994629053660318,0.9983834430908849,0.9983995313660471,0.9989228826047296,0.9983874822399815,284713,153,95444,461
10,2,vg giraffe,None,125,0.9,269733,440,269733,0,37,90201,107,253,0.9994664235929701,0.9983714138718525,0.9984105609395351,0.9989186186464217,0.9983812446122332,269733,144,90454,440
10,2,SAFARI,None,125,0.9,269733,440,269733,0,37,90201,107,253,0.9994664235929701,0.9983714138718525,0.9984105609395351,0.9989186186464217,0.9983812446122332,269733,144,90454,440
10,2,vg giraffe,Single-stranded,125,0.15,44833,67,44833,0,2,14956,21,36,0.9994872480827537,0.9985077951002227,0.9984681984681985,0.9989972815187843,0.9984978719853125,44833,23,14992,67
10,2,SAFARI,Single-stranded,125,0.15,44833,67,44833,0,2,14956,21,36,0.9994872480827537,0.9985077951002227,0.9984681984681985,0.9989972815187843,0.9984978719853125,44833,23,14992,67
10,2,vg giraffe,Single-stranded,125,0.1,29883,42,29883,0,2,10012,13,17,0.9994982942002809,0.9985964912280701,0.9985065710872163,0.999047189208164,0.9985738947684455,29883,15,10029,42
10,2,SAFARI,Single-stranded,125,0.1,29883,42,29883,0,2,10012,13,17,0.9994982942002809,0.9985964912280701,0.9985065710872163,0.999047189208164,0.9985738947684455,29883,15,10029,42
10,2,vg giraffe,Single-stranded,125,0.25,74761,121,74761,0,6,24981,39,71,0.9993984439750823,0.9983841243556529,0.9982069570068136,0.9988910266688045,0.9983396513267786,74761,45,25052,121
10,2,SAFARI,Single-stranded,125,0.25,74761,121,74761,0,6,24981,39,71,0.9993984439750823,0.9983841243556529,0.9982069570068136,0.9988910266688045,0.9983396513267786,74761,45,25052,121
10,2,vg giraffe,Single-stranded,125,0.2,59804,99,59804,0,5,19906,28,48,0.9994485017631232,0.9983473281805586,0.9983489268024216,0.9988976114915651,0.9983477281261735,59804,33,19954,99
10,2,SAFARI,Single-stranded,125,0.2,59804,99,59804,0,5,19906,28,48,0.9994485017631232,0.9983473281805586,0.9983489268024216,0.9988976114915651,0.9983477281261735,59804,33,19954,99
10,2,vg giraffe,Single-stranded,125,0.35,104621,164,104621,0,14,34996,48,90,0.9994077357355062,0.9984348904900511,0.9982360304996016,0.9989210762503103,0.998384941364796,104621,62,35086,164
10,2,SAFARI,Single-stranded,125,0.35,104621,164,104621,0,14,34996,48,90,0.9994077357355062,0.9984348904900511,0.9982360304996016,0.9989210762503103,0.998384941364796,104621,62,35086,164
10,2,vg giraffe,Single-stranded,125,0.3,89516,140,89516,0,11,29874,45,81,0.9993748046264458,0.9984384759525297,0.9981340175269068,0.9989064208717389,0.998362121553979,89516,56,29955,140
10,2,SAFARI,Single-stranded,125,0.3,89516,140,89516,0,11,29874,45,81,0.9993748046264458,0.9984384759525297,0.9981340175269068,0.9989064208717389,0.998362121553979,89516,56,29955,140
10,2,vg giraffe,Single-stranded,125,0.45,134929,217,134929,0,16,45239,56,125,0.9994666706172547,0.9983943290959407,0.9984153534642134,0.998930212069725,0.9983996190096466,134929,72,45364,217
10,2,SAFARI,Single-stranded,125,0.45,134929,217,134929,0,16,45239,56,125,0.9994666706172547,0.9983943290959407,0.9984153534642134,0.998930212069725,0.9983996190096466,134929,72,45364,217
10,2,vg giraffe,Single-stranded,125,0.4,119584,191,119584,0,16,40026,52,105,0.9994316852204727,0.9984053433521185,0.9983084156322296,0.9989182506567764,0.9983809869103729,119584,68,40131,191
10,2,SAFARI,Single-stranded,125,0.4,119584,191,119584,0,16,40026,52,105,0.9994316852204727,0.9984053433521185,0.9983084156322296,0.9989182506567764,0.9983809869103729,119584,68,40131,191
10,2,vg giraffe,Single-stranded,125,0.55,164947,258,164947,0,16,55323,67,147,0.9994970611403987,0.998438303925426,0.9985059312728386,0.9989674020016049,0.9984553221174317,164947,83,55470,258
10,2,SAFARI,Single-stranded,125,0.55,164947,258,164947,0,16,55323,67,147,0.9994970611403987,0.998438303925426,0.9985059312728386,0.9989674020016049,0.9984553221174317,164947,83,55470,258
10,2,vg giraffe,Single-stranded,125,0.5,150022,239,150022,0,16,50365,62,137,0.9994803464357095,0.9984094342510698,0.9984578884934757,0.9989446033273294,0.9984216370163462,150022,78,50502,239
10,2,SAFARI,Single-stranded,125,0.5,150022,239,150022,0,16,50365,62,137,0.9994803464357095,0.9984094342510698,0.9984578884934757,0.9989446033273294,0.9984216370163462,150022,78,50502,239
10,2,vg giraffe,Single-stranded,125,0.65,195131,300,195131,0,22,65441,84,183,0.9994570701250275,0.9984649313568472,0.9983873421573102,0.9989607544001557,0.998445403410157,195131,106,65624,300
10,2,SAFARI,Single-stranded,125,0.65,195131,300,195131,0,22,65441,84,183,0.9994570701250275,0.9984649313568472,0.9983873421573102,0.9989607544001557,0.998445403410157,195131,106,65624,300
10,2,vg giraffe,Single-stranded,125,0.6,180033,276,180033,0,20,60339,77,167,0.9994615000277577,0.9984692943779845,0.9983994191706681,0.9989651508299601,0.9984517168094574,180033,97,60506,276
10,2,SAFARI,Single-stranded,125,0.6,180033,276,180033,0,20,60339,77,167,0.9994615000277577,0.9984692943779845,0.9983994191706681,0.9989651508299601,0.9984517168094574,180033,97,60506,276
10,2,vg giraffe,Single-stranded,125,0.75,224919,357,224919,0,27,75387,95,214,0.9994578765647149,0.9984152772598945,0.9983888646778389,0.9989363048696808,0.9984086325868192,224919,122,75601,357
10,2,SAFARI,Single-stranded,125,0.75,224919,357,224919,0,27,75387,95,214,0.9994578765647149,0.9984152772598945,0.9983888646778389,0.9989363048696808,0.9984086325868192,224919,122,75601,357
10,2,vg giraffe,Single-stranded,125,0.7,210098,335,210098,0,24,70466,89,204,0.9994624448768142,0.9984080443656651,0.9984035714790275,0.9989349663848766,0.9984069185252618,210098,113,70670,335
10,2,SAFARI,Single-stranded,125,0.7,210098,335,210098,0,24,70466,89,204,0.9994624448768142,0.9984080443656651,0.9984035714790275,0.9989349663848766,0.9984069185252618,210098,113,70670,335
10,2,vg giraffe,Single-stranded,125,0.85,254891,407,254891,0,32,85260,107,240,0.9994549660824217,0.9984057846124921,0.9983769077172784,0.9989300998573467,0.99839853110692,254891,139,85500,407
10,2,SAFARI,Single-stranded,125,0.85,254891,407,254891,0,32,85260,107,240,0.9994549660824217,0.9984057846124921,0.9983769077172784,0.9989300998573467,0.99839853110692,254891,139,85500,407
10,2,vg giraffe,Single-stranded,125,0.8,239768,383,239768,0,28,80272,103,227,0.9994539368650974,0.998405170080491,0.9983752945553764,0.9989292782001875,0.9983976607093313,239768,131,80499,383
10,2,SAFARI,Single-stranded,125,0.8,239768,383,239768,0,28,80272,103,227,0.9994539368650974,0.998405170080491,0.9983752945553764,0.9989292782001875,0.9983976607093313,239768,131,80499,383
10,2,vg giraffe,Single-stranded,125,0.95,284720,457,284720,0,37,95182,115,272,0.9994664270268753,0.9983974864733131,0.9984101416229106,0.9989316707861956,0.9984006638951844,284720,152,95454,457
10,2,SAFARI,Single-stranded,125,0.95,284720,457,284720,0,37,95182,115,272,0.9994664270268753,0.9983974864733131,0.9984101416229106,0.9989316707861956,0.9984006638951844,284720,152,95454,457
10,2,vg giraffe,Single-stranded,125,0.9,269747,429,269747,0,33,90206,109,255,0.9994738577711578,0.9984121461565794,0.9984327229782678,0.9989427198577949,0.9984173136463043,269747,142,90461,429
10,2,SAFARI,Single-stranded,125,0.9,269747,429,269747,0,33,90206,109,255,0.9994738577711578,0.9984121461565794,0.9984327229782678,0.9989427198577949,0.9984173136463043,269747,142,90461,429
10,7,vg giraffe,High,125,0.15,44565,74,44565,257,0,14956,18,40,0.9995962586636161,0.9926274055595153,0.9988011189556414,0.996099643491769,0.9941745952261726,44565,18,14996,331
10,7,SAFARI,High,125,0.15,44592,74,44592,230,0,14956,18,40,0.9995965030262273,0.9932287954383464,0.9988011189556414,0.9964024758116774,0.9946252712401936,44592,18,14996,304
10,7,vg giraffe,High,125,0.1,29709,48,29709,166,0,10014,11,26,0.9996298788694482,0.9928483106640377,0.9989055815341757,0.9962275539459785,0.9943713413718918,29709,11,10040,214
10,7,SAFARI,High,125,0.1,29724,48,29724,151,0,10014,11,26,0.9996300655792837,0.993349597299736,0.9989055815341757,0.9964799356331088,0.9947465852804322,29724,11,10040,199
10,7,vg giraffe,High,125,0.25,74314,130,74314,436,1,24985,36,78,0.9995023604255491,0.9924412393162393,0.9985258964143426,0.9959592845990445,0.9939687937587518,74314,37,25063,566
10,7,SAFARI,High,125,0.25,74366,129,74366,385,1,24985,36,78,0.9995027082241308,0.9931356837606837,0.9985258964143426,0.9963090238004327,0.994488897779556,74366,37,25063,514
10,7,vg giraffe,High,125,0.2,59440,95,59440,365,0,19910,27,55,0.9995459666705904,0.9923205342237061,0.9986494597839136,0.9959201454338301,0.9939042707655334,59440,27,19965,460
10,7,SAFARI,High,125,0.2,59483,95,59483,322,0,19910,27,55,0.9995462947403798,0.9930383973288814,0.9986494597839136,0.9962817184490411,0.9944424973714514,59483,27,19965,417
10,7,vg giraffe,High,125,0.35,104005,182,104005,599,3,35007,40,109,0.9995867292019068,0.9925467142557212,0.9987769845558747,0.9960542823486598,0.9941119725606489,104005,43,35116,781
10,7,SAFARI,High,125,0.35,104072,182,104072,532,4,35006,40,109,0.9995773944446579,0.9931861126486363,0.9987485423362439,0.9963715043417488,0.9945835864089464,104072,44,35115,714
10,7,vg giraffe,High,125,0.3,88980,150,88980,526,1,29884,39,96,0.9995506627724107,0.9924600695993575,0.9986675549633578,0.9959927466475631,0.9940171797185735,88980,40,29980,676
10,7,SAFARI,High,125,0.3,89038,150,89038,468,1,29884,39,96,0.9995509553425088,0.9931069867047381,0.9986675549633578,0.9963185515906319,0.994501821584946,89038,40,29980,618
10,7,vg giraffe,High,125,0.45,134106,229,134106,810,4,45251,46,149,0.9996272995617043,0.9923119612268304,0.9988998899889989,0.995956197711854,0.9939699327223899,134106,50,45400,1039
10,7,SAFARI,High,125,0.45,134195,229,134195,721,5,45250,46,149,0.9996201004126752,0.9929705131525398,0.9988778877887788,0.9962842114250291,0.9944572108862372,134195,51,45399,950
10,7,vg giraffe,High,125,0.4,118862,200,118862,711,4,40038,43,124,0.9996047397589753,0.9923939452130279,0.9988311074635032,0.9959862913835145,0.9940118263304621,118862,47,40162,911
10,7,SAFARI,High,125,0.4,118940,200,118940,633,5,40037,43,124,0.9995965979762665,0.9930451771267313,0.9988062374095352,0.9963101176490298,0.9944931304771787,118940,48,40161,833
10,7,vg giraffe,High,125,0.55,163943,275,163943,986,5,55333,52,174,0.9996524390243903,0.9923670129052565,0.9989741559282989,0.9959964034458877,0.9940299318741846,163943,57,55507,1261
10,7,SAFARI,High,125,0.55,164058,275,164058,871,6,55332,52,174,0.9996465914353262,0.9930631219583061,0.9989561586638831,0.9963439815377141,0.9945463110595738,164058,58,55506,1146
10,7,vg giraffe,High,125,0.5,149114,248,149114,900,5,50376,50,158,0.9996312906837211,0.9923600111804715,0.9989128071319852,0.9959823799139034,0.9940104853846882,149114,55,50534,1148
10,7,SAFARI,High,125,0.5,149222,248,149222,792,6,50375,50,158,0.9996248609976018,0.9930787557732494,0.9988930399889304,0.9963410562863056,0.9945432186048364,149222,56,50533,1040
10,7,vg giraffe,High,125,0.65,193948,324,193948,1149,5,65457,63,208,0.9996495134421903,0.9924624272724016,0.9989655119954969,0.996043005672291,0.9940992670991062,193948,68,65665,1473
10,7,SAFARI,High,125,0.65,194081,324,194081,1016,6,65456,63,208,0.9996446046870976,0.9931430091955317,0.9989502989366071,0.9963832010082886,0.9946047159913308,194081,69,65664,1340
10,7,vg giraffe,High,125,0.6,178934,301,178934,1071,5,60353,57,192,0.9996536235446603,0.9923907135647178,0.9989770158562542,0.9960089284223299,0.9940476437552145,178934,62,60545,1372
10,7,SAFARI,High,125,0.6,179057,301,179057,948,6,60352,57,192,0.9996482804823582,0.9930728872028662,0.9989605161120003,0.9963497354114617,0.994554050632386,179057,63,60544,1249
10,7,vg giraffe,High,125,0.75,223566,373,223566,1321,6,75407,68,239,0.9996691110713647,0.9924798011187073,0.9990227152667723,0.9960614836266429,0.994125855538574,223566,74,75646,1694
10,7,SAFARI,High,125,0.75,223716,373,223716,1171,7,75406,68,239,0.9996648658793249,0.9931456983041819,0.9990095087163233,0.9963946188740255,0.9946209050435245,223716,75,75645,1544
10,7,vg giraffe,High,125,0.7,208818,351,208818,1248,6,70483,66,229,0.9996553209823352,0.9924008041175381,0.9989828209764918,0.9960148530790089,0.9940576313739994,208818,72,70712,1599
10,7,SAFARI,High,125,0.7,208962,351,208962,1104,7,70482,66,229,0.9996507761858062,0.9930851594690543,0.9989686934900542,0.996357151712234,0.9945661644162005,208962,73,70711,1455
10,7,vg giraffe,High,125,0.85,253368,428,253368,1487,7,85280,79,265,0.9996606879354833,0.9924985212489669,0.9989956908129065,0.9960667299606674,0.9941304845210229,253368,86,85545,1915
10,7,SAFARI,High,125,0.85,253543,428,253543,1312,8,85279,79,265,0.9996569806410913,0.9931840349729516,0.9989840127991031,0.9964099954216143,0.9946408771713687,253543,87,85544,1740
10,7,vg giraffe,High,125,0.8,238334,397,238334,1404,7,80290,76,254,0.9996518704622573,0.9925000520540529,0.9989705681719523,0.996063123756666,0.9941264863044874,238334,83,80544,1801
10,7,SAFARI,High,125,0.8,238494,397,238494,1244,8,80289,76,254,0.999647913889797,0.9931663439315385,0.9989581653788433,0.9963965883525201,0.9946221809316564,238494,84,80543,1641
10,7,vg giraffe,High,125,0.95,283035,470,283035,1659,7,95208,85,294,0.9996750574830376,0.9925341207164999,0.9990375965018725,0.9960917910014411,0.9941668986600413,283035,92,95502,2129
10,7,SAFARI,High,125,0.95,283229,470,283229,1465,9,95206,85,294,0.9996682231940224,0.9932144309940947,0.9990166746866959,0.9964308770473204,0.9946711559573272,283229,94,95500,1935
10,7,vg giraffe,High,125,0.9,268130,454,268130,1579,7,90228,81,279,0.9996719086713047,0.992474913293086,0.9990286439648988,0.996060410750008,0.9941207124997921,268130,88,90507,2033
10,7,SAFARI,High,125,0.9,268319,454,268319,1390,8,90227,81,279,0.9996684152484278,0.9931744909554602,0.9990176058281363,0.9964108724754953,0.9946418374644499,268319,89,90506,1844
10,7,vg giraffe,Mid,125,0.15,44836,61,44836,1,3,14953,23,37,0.9994204449199768,0.9986190921644617,0.9982685135855088,0.9990196078431371,0.9985312280936008,44836,26,14990,62
10,7,SAFARI,Mid,125,0.15,44836,61,44836,1,3,14953,23,37,0.9994204449199768,0.9986190921644617,0.9982685135855088,0.9990196078431371,0.9985312280936008,44836,26,14990,62
10,7,vg giraffe,Mid,125,0.1,29880,44,29880,1,1,10013,17,19,0.9993979530403372,0.9984962406015038,0.9982089552238806,0.9989468933353394,0.9984240150093808,29880,18,10032,45
10,7,SAFARI,Mid,125,0.1,29880,44,29880,1,1,10013,17,19,0.9993979530403372,0.9984962406015038,0.9982089552238806,0.9989468933353394,0.9984240150093808,29880,18,10032,45
10,7,vg giraffe,Mid,125,0.25,74774,105,74774,2,5,24981,44,67,0.9993451211525868,0.9985710660915319,0.9980475754074192,0.9989579436755197,0.9984396567244794,74774,49,25048,107
10,7,SAFARI,Mid,125,0.25,74774,105,74774,2,5,24981,44,67,0.9993451211525868,0.9985710660915319,0.9980475754074192,0.9989579436755197,0.9984396567244794,74774,49,25048,107
10,7,vg giraffe,Mid,125,0.2,59817,82,59817,2,3,19907,32,48,0.999415224219742,0.9985976861822007,0.9982491245622811,0.9990062879426821,0.9985104705160781,59817,35,19955,84
10,7,SAFARI,Mid,125,0.2,59817,82,59817,2,3,19907,32,48,0.999415224219742,0.9985976861822007,0.9982491245622811,0.9990062879426821,0.9985104705160781,59817,35,19955,84
10,7,vg giraffe,Mid,125,0.35,104625,160,104625,2,7,35003,48,91,0.9994745892243027,0.9984540066993043,0.9984352328657998,0.9989640372946574,0.9984492911045049,104625,55,35094,162
10,7,SAFARI,Mid,125,0.35,104625,160,104625,2,7,35003,48,91,0.9994745892243027,0.9984540066993043,0.9984352328657998,0.9989640372946574,0.9984492911045049,104625,55,35094,162
10,7,vg giraffe,Mid,125,0.3,89520,135,89520,2,5,29880,47,82,0.9994194614388425,0.9984719542255485,0.9982674751782501,0.998945483152838,0.9984206700035931,89520,52,29962,137
10,7,SAFARI,Mid,125,0.3,89520,135,89520,2,5,29880,47,82,0.9994194614388425,0.9984719542255485,0.9982674751782501,0.998945483152838,0.9984206700035931,89520,52,29962,137
10,7,vg giraffe,Mid,125,0.45,134932,210,134932,2,8,45249,57,127,0.9995185078186922,0.9984313029065294,0.9985695737329724,0.9989746095557506,0.9984660962981422,134932,65,45376,212
10,7,SAFARI,Mid,125,0.45,134932,210,134932,2,8,45249,57,127,0.9995185078186922,0.9984313029065294,0.9985695737329724,0.9989746095557506,0.9984660962981422,134932,65,45376,212
10,7,vg giraffe,Mid,125,0.4,119591,180,119591,2,8,40034,52,106,0.9994985415917962,0.9984804588680254,0.9985074626865672,0.998989240844694,0.9984872447225469,119591,60,40140,182
10,7,SAFARI,Mid,125,0.4,119591,180,119591,2,8,40034,52,106,0.9994985415917962,0.9984804588680254,0.9985074626865672,0.998989240844694,0.9984872447225469,119591,60,40140,182
10,7,vg giraffe,Mid,125,0.55,164946,255,164946,3,8,55332,65,154,0.9995576266975318,0.9984382944722888,0.9986860814629493,0.9989976470445728,0.99850065454809,164946,73,55486,258
10,7,SAFARI,Mid,125,0.55,164946,255,164946,3,8,55332,65,154,0.9995576266975318,0.9984382944722888,0.9986860814629493,0.9989976470445728,0.99850065454809,164946,73,55486,258
10,7,vg giraffe,Mid,125,0.5,150023,235,150023,2,8,50375,62,137,0.9995336224873912,0.9984227339278584,0.9986161084970938,0.9989778693737036,0.9984714352575657,150023,70,50512,237
10,7,SAFARI,Mid,125,0.5,150023,235,150023,2,8,50375,62,137,0.9995336224873912,0.9984227339278584,0.9986161084970938,0.9989778693737036,0.9984714352575657,150023,70,50512,237
10,7,vg giraffe,Mid,125,0.65,195116,306,195116,3,10,65452,79,192,0.9995440690556082,0.998418830753486,0.9986460377588121,0.9989811330414972,0.9984760183490454,195116,89,65644,309
10,7,SAFARI,Mid,125,0.65,195116,306,195116,3,10,65452,79,192,0.9995440690556082,0.998418830753486,0.9986460377588121,0.9989811330414972,0.9984760183490454,195116,89,65644,309
10,7,vg giraffe,Mid,125,0.6,180027,278,180027,3,9,60351,73,172,0.9995447201416919,0.9984415555604854,0.9986469763220857,0.9989928333014259,0.9984932319966129,180027,82,60523,281
10,7,SAFARI,Mid,125,0.6,180027,278,180027,3,9,60351,73,172,0.9995447201416919,0.9984415555604854,0.9986469763220857,0.9989928333014259,0.9984932319966129,180027,82,60523,281
10,7,vg giraffe,Mid,125,0.75,224913,348,224913,5,10,75403,86,222,0.9995733503993174,0.9984329636962525,0.9987321879003183,0.9990028316029094,0.9985082412197205,224913,96,75625,353
10,7,SAFARI,Mid,125,0.75,224913,348,224913,5,10,75403,86,222,0.9995733503993174,0.9984329636962525,0.9987321879003183,0.9990028316029094,0.9985082412197205,224913,96,75625,353
10,7,vg giraffe,Mid,125,0.7,210091,328,210091,4,10,70479,82,214,0.9995622861982177,0.9984222257072658,0.9987002896093805,0.9989919306904799,0.998492219282524,210091,92,70693,332
10,7,SAFARI,Mid,125,0.7,210091,328,210091,4,10,70479,82,214,0.9995622861982177,0.9984222257072658,0.9987002896093805,0.9989919306904799,0.998492219282524,210091,92,70693,332
10,7,vg giraffe,Mid,125,0.85,254873,410,254873,6,12,85275,95,251,0.9995803592438622,0.998370474246834,0.9987504817068187,0.9989750504145851,0.9984659247569825,254873,107,85526,416
10,7,SAFARI,Mid,125,0.85,254873,410,254873,6,12,85275,95,251,0.9995803592438622,0.998370474246834,0.9987504817068187,0.9989750504145851,0.9984659247569825,254873,107,85526,416
10,7,vg giraffe,Mid,125,0.8,239752,384,239752,5,11,80286,93,235,0.999566406510573,0.9983801183471377,0.9987100775193798,0.9989729102473556,0.9984630540643336,239752,104,80521,389
10,7,SAFARI,Mid,125,0.8,239752,384,239752,5,11,80286,93,235,0.999566406510573,0.9983801183471377,0.9987100775193798,0.9989729102473556,0.9984630540643336,239752,104,80521,389
10,7,vg giraffe,Mid,125,0.95,284709,454,284709,6,12,95201,102,280,0.9995997514245689,0.9983869214395674,0.9988074690098855,0.9989929683223624,0.9984925045434968,284709,114,95481,460
10,7,SAFARI,Mid,125,0.95,284709,454,284709,6,12,95201,102,280,0.9995997514245689,0.9983869214395674,0.9988074690098855,0.9989929683223624,0.9984925045434968,284709,114,95481,460
10,7,vg giraffe,Mid,125,0.9,269734,428,269734,6,12,90223,97,265,0.9995960614134886,0.998393592135264,0.9987968696535205,0.9989944649275663,0.9984948650783751,269734,109,90488,434
10,7,SAFARI,Mid,125,0.9,269734,428,269734,6,12,90223,97,265,0.9995960614134886,0.998393592135264,0.9987968696535205,0.9989944649275663,0.9984948650783751,269734,109,90488,434
10,7,vg giraffe,None,125,0.15,44827,73,44827,0,1,14957,18,40,0.9995763278776256,0.9983741648106904,0.9987346830047948,0.9989748846745259,0.9984645169904534,44827,19,14997,73
10,7,SAFARI,None,125,0.15,44827,73,44827,0,1,14957,18,40,0.9995763278776256,0.9983741648106904,0.9987346830047948,0.9989748846745259,0.9984645169904534,44827,19,14997,73
10,7,vg giraffe,None,125,0.1,29878,47,29878,0,0,10014,11,26,0.9996319716283583,0.9984294068504594,0.9989055815341757,0.9990303273481125,0.9985491294776866,29878,11,10040,47
10,7,SAFARI,None,125,0.1,29878,47,29878,0,0,10014,11,26,0.9996319716283583,0.9984294068504594,0.9989055815341757,0.9990303273481125,0.9985491294776866,29878,11,10040,47
10,7,vg giraffe,None,125,0.25,74769,114,74769,0,2,24986,39,75,0.9994519449271487,0.9984776250951485,0.9983666640108357,0.9989645474404281,0.9984497674651198,74769,41,25061,114
10,7,SAFARI,None,125,0.25,74769,114,74769,0,2,24986,39,75,0.9994519449271487,0.9984776250951485,0.9983666640108357,0.9989645474404281,0.9984497674651198,74769,41,25061,114
10,7,vg giraffe,None,125,0.2,59811,92,59811,0,1,19911,27,55,0.9995320777419409,0.9984641837637513,0.9985995798739622,0.9989978453675401,0.9984980662603101,59811,28,19966,92
10,7,SAFARI,None,125,0.2,59811,92,59811,0,1,19911,27,55,0.9995320777419409,0.9984641837637513,0.9985995798739622,0.9989978453675401,0.9984980662603101,59811,28,19966,92
10,7,vg giraffe,None,125,0.35,104628,158,104628,0,3,35009,45,104,0.999541442164393,0.9984921649838719,0.9986348511134495,0.9990165280575952,0.9985280141767955,104628,48,35113,158
10,7,SAFARI,None,125,0.35,104628,158,104628,0,3,35009,45,104,0.999541442164393,0.9984921649838719,0.9986348511134495,0.9990165280575952,0.9985280141767955,104628,48,35113,158
10,7,vg giraffe,None,125,0.3,89521,136,89521,0,2,29885,44,91,0.9994864179887681,0.9984831078443401,0.9984677902871227,0.9989845110029907,0.9984792653681932,89521,46,29976,136
10,7,SAFARI,None,125,0.3,89521,136,89521,0,2,29885,44,91,0.9994864179887681,0.9984831078443401,0.9984677902871227,0.9989845110029907,0.9984792653681932,89521,46,29976,136
10,7,vg giraffe,None,125,0.45,134935,208,134935,0,6,45251,53,142,0.9995629435382313,0.9984608895762267,0.9987019273079293,0.999011612626186,0.9985215537528724,134935,59,45393,208
10,7,SAFARI,None,125,0.45,134935,208,134935,0,6,45251,53,142,0.9995629435382313,0.9984608895762267,0.9987019273079293,0.999011612626186,0.9985215537528724,134935,59,45393,208
10,7,vg giraffe,None,125,0.4,119590,182,119590,0,5,40039,49,118,0.9995486610277156,0.9984804461810773,0.9986570838825197,0.9990142680522605,0.9985248432645969,119590,54,40157,182
10,7,SAFARI,None,125,0.4,119590,182,119590,0,5,40039,49,118,0.9995486610277156,0.9984804461810773,0.9986570838825197,0.9990142680522605,0.9985248432645969,119590,54,40157,182
10,7,vg giraffe,None,125,0.55,164947,256,164947,0,8,55332,63,163,0.9995697439067254,0.9984503913367191,0.9987222402188388,0.999009754073787,0.9985188137827322,164947,71,55495,256
10,7,SAFARI,None,125,0.55,164947,256,164947,0,8,55332,63,163,0.9995697439067254,0.9984503913367191,0.9987222402188388,0.999009754073787,0.9985188137827322,164947,71,55495,256
10,7,vg giraffe,None,125,0.5,150025,234,150025,0,7,50376,59,149,0.999560266771492,0.9984426889570674,0.9986954201340159,0.9990011653071417,0.9985063480209111,150025,66,50525,234
10,7,SAFARI,None,125,0.5,150025,234,150025,0,7,50376,59,149,0.999560266771492,0.9984426889570674,0.9986954201340159,0.9990011653071417,0.9985063480209111,150025,66,50525,234
10,7,vg giraffe,None,125,0.65,195117,310,195117,0,8,65456,75,196,0.9995747950819672,0.9984137299349629,0.9987373545295505,0.9989939251511032,0.9984951868954901,195117,83,65652,310
10,7,SAFARI,None,125,0.65,195117,310,195117,0,8,65456,75,196,0.9995747950819672,0.9984137299349629,0.9987373545295505,0.9989939251511032,0.9984951868954901,195117,83,65652,310
10,7,vg giraffe,None,125,0.6,180021,286,180021,0,8,60352,69,180,0.999572454996724,0.998413816435302,0.9987295616162616,0.9989927997669289,0.9984932507596008,180021,77,60532,286
10,7,SAFARI,None,125,0.6,180021,286,180021,0,8,60352,69,180,0.999572454996724,0.998413816435302,0.9987295616162616,0.9989927997669289,0.9984932507596008,180021,77,60532,286
10,7,vg giraffe,None,125,0.75,224915,357,224915,0,8,75407,82,225,0.9996000088886914,0.9984152491210625,0.9988114418530942,0.9990072777423675,0.9985149205632006,224915,90,75632,357
10,7,SAFARI,None,125,0.75,224915,357,224915,0,8,75407,82,225,0.9996000088886914,0.9984152491210625,0.9988114418530942,0.9990072777423675,0.9985149205632006,224915,90,75632,357
10,7,vg giraffe,None,125,0.7,210099,330,210099,0,8,70483,79,216,0.9995860808997745,0.9984317750880345,0.9987709434068883,0.9990085945579688,0.9985171488007396,210099,87,70699,330
10,7,SAFARI,None,125,0.7,210099,330,210099,0,8,70483,79,216,0.9995860808997745,0.9984317750880345,0.9987709434068883,0.9990085945579688,0.9985171488007396,210099,87,70699,330
10,7,vg giraffe,None,125,0.85,254885,410,254885,0,9,85282,97,247,0.9995842990536921,0.9983940147672301,0.998762188357564,0.9989888023578934,0.9984864928284398,254885,106,85529,410
10,7,SAFARI,None,125,0.85,254885,410,254885,0,9,85282,97,247,0.9995842990536921,0.9983940147672301,0.998762188357564,0.9989888023578934,0.9984864928284398,254885,106,85529,410
10,7,vg giraffe,None,125,0.8,239763,384,239763,0,8,80291,92,238,0.9995830953502625,0.9984009794001174,0.9987597514541914,0.9989916876731735,0.9984911589395715,239763,100,80529,384
10,7,SAFARI,None,125,0.8,239763,384,239763,0,8,80291,92,238,0.9995830953502625,0.9984009794001174,0.9987597514541914,0.9989916876731735,0.9984911589395715,239763,100,80529,384
10,7,vg giraffe,None,125,0.95,284713,461,284713,0,9,95209,105,274,0.9995997570455049,0.9983834430908849,0.9988074939590155,0.9989912298399477,0.9984899060064973,284713,114,95483,461
10,7,SAFARI,None,125,0.95,284713,461,284713,0,9,95209,105,274,0.9995997570455049,0.9983834430908849,0.9988074939590155,0.9989912298399477,0.9984899060064973,284713,114,95483,461
10,7,vg giraffe,None,125,0.9,269733,440,269733,0,9,90229,100,260,0.9995960599165438,0.9983714138718525,0.9987968829333981,0.9989833615732897,0.9984782590618425,269733,109,90489,440
10,7,SAFARI,None,125,0.9,269733,440,269733,0,9,90229,100,260,0.9995960599165438,0.9983714138718525,0.9987968829333981,0.9989833615732897,0.9984782590618425,269733,109,90489,440
10,7,vg giraffe,Single-stranded,125,0.15,44833,67,44833,0,1,14957,20,37,0.9995318143309404,0.9985077951002227,0.9986013986013986,0.9990195423045212,0.9985312526078611,44833,21,14994,67
10,7,SAFARI,Single-stranded,125,0.15,44833,67,44833,0,1,14957,20,37,0.9995318143309404,0.9985077951002227,0.9986013986013986,0.9990195423045212,0.9985312526078611,44833,21,14994,67
10,7,vg giraffe,Single-stranded,125,0.1,29883,42,29883,0,1,10013,12,18,0.9995651592186245,0.9985964912280701,0.998705694942254,0.9990805904281105,0.9986239335485001,29883,13,10031,42
10,7,SAFARI,Single-stranded,125,0.1,29883,42,29883,0,1,10013,12,18,0.9995651592186245,0.9985964912280701,0.998705694942254,0.9990805904281105,0.9986239335485001,29883,13,10031,42
10,7,vg giraffe,Single-stranded,125,0.25,74761,121,74761,0,1,24986,38,72,0.9994786096256685,0.9983841243556529,0.9984460294059051,0.9989310671957884,0.9983996639294251,74761,39,25058,121
10,7,SAFARI,Single-stranded,125,0.25,74761,121,74761,0,1,24986,38,72,0.9994786096256685,0.9983841243556529,0.9984460294059051,0.9989310671957884,0.9983996639294251,74761,39,25058,121
10,7,vg giraffe,Single-stranded,125,0.2,59804,99,59804,0,1,19910,27,49,0.9995320229977269,0.9983473281805586,0.9985990894081153,0.9989393243412535,0.9984103141820002,59804,28,19959,99
10,7,SAFARI,Single-stranded,125,0.2,59804,99,59804,0,1,19910,27,49,0.9995320229977269,0.9983473281805586,0.9985990894081153,0.9989393243412535,0.9984103141820002,59804,28,19959,99
10,7,vg giraffe,Single-stranded,125,0.35,104621,164,104621,0,4,35006,44,94,0.9995414114971959,0.9984348904900511,0.99863434619324,0.9989878445864008,0.9984849892448528,104621,48,35100,164
10,7,SAFARI,Single-stranded,125,0.35,104621,164,104621,0,4,35006,44,94,0.9995414114971959,0.9984348904900511,0.99863434619324,0.9989878445864008,0.9984849892448528,104621,48,35100,164
10,7,vg giraffe,Single-stranded,125,0.3,89516,140,89516,0,2,29883,43,83,0.9994975491564408,0.9984384759525297,0.9985005497984073,0.9989677318557949,0.9984540433035005,89516,45,29966,140
10,7,SAFARI,Single-stranded,125,0.3,89516,140,89516,0,2,29883,43,83,0.9994975491564408,0.9984384759525297,0.9985005497984073,0.9989677318557949,0.9984540433035005,89516,45,29966,140
10,7,vg giraffe,Single-stranded,125,0.45,134929,217,134929,0,6,45249,51,130,0.9995777339872283,0.9983943290959407,0.998745488159169,0.9989856810744377,0.9984826837669314,134929,57,45379,217
10,7,SAFARI,Single-stranded,125,0.45,134929,217,134929,0,6,45249,51,130,0.9995777339872283,0.9983943290959407,0.998745488159169,0.9989856810744377,0.9984826837669314,134929,57,45379,217
10,7,vg giraffe,Single-stranded,125,0.4,119584,191,119584,0,6,40036,47,110,0.9995569932378779,0.9984053433521185,0.9986815592427672,0.9989808363824703,0.9984747521472239,119584,53,40146,191
10,7,SAFARI,Single-stranded,125,0.4,119584,191,119584,0,6,40036,47,110,0.9995569932378779,0.9984053433521185,0.9986815592427672,0.9989808363824703,0.9984747521472239,119584,53,40146,191
10,7,vg giraffe,Single-stranded,125,0.55,164947,258,164947,0,6,55333,62,152,0.9995879162500378,0.998438303925426,0.9987759436934099,0.9990127793592151,0.9985232698248762,164947,68,55485,258
10,7,SAFARI,Single-stranded,125,0.55,164947,258,164947,0,6,55333,62,152,0.9995879162500378,0.998438303925426,0.9987759436934099,0.9990127793592151,0.9985232698248762,164947,68,55485,258
10,7,vg giraffe,Single-stranded,125,0.5,150022,239,150022,0,6,50375,57,142,0.9995802378652097,0.9984094342510698,0.9987544483985765,0.9989944930180524,0.998496322961945,150022,63,50517,239
10,7,SAFARI,Single-stranded,125,0.5,150022,239,150022,0,6,50375,57,142,0.9995802378652097,0.9984094342510698,0.9987544483985765,0.9989944930180524,0.998496322961945,150022,63,50517,239
10,7,vg giraffe,Single-stranded,125,0.65,195131,300,195131,0,6,65457,78,189,0.9995697051968343,0.9984649313568472,0.9987220447284345,0.9990170128453895,0.9985296426342372,195131,84,65646,300
10,7,SAFARI,Single-stranded,125,0.65,195131,300,195131,0,6,65457,78,189,0.9995697051968343,0.9984649313568472,0.9987220447284345,0.9990170128453895,0.9985296426342372,195131,84,65646,300
10,7,vg giraffe,Single-stranded,125,0.6,180033,276,180033,0,6,60353,72,172,0.9995669337242034,0.9984692943779845,0.9987129350032177,0.9990178125520227,0.9985305837816298,180033,78,60525,276
10,7,SAFARI,Single-stranded,125,0.6,180033,276,180033,0,6,60353,72,172,0.9995669337242034,0.9984692943779845,0.9987129350032177,0.9990178125520227,0.9985305837816298,180033,78,60525,276
10,7,vg giraffe,Single-stranded,125,0.75,224919,357,224919,0,8,75406,89,220,0.9995689195434991,0.9984152772598945,0.9987190153586096,0.9989917653433772,0.9984916893411606,224919,97,75626,357
10,7,SAFARI,Single-stranded,125,0.75,224919,357,224919,0,8,75406,89,220,0.9995689195434991,0.9984152772598945,0.9987190153586096,0.9989917653433772,0.9984916893411606,224919,97,75626,357
10,7,vg giraffe,Single-stranded,125,0.7,210098,335,210098,0,6,70484,83,210,0.9995765675327208,0.9984080443656651,0.9987426359436588,0.99899196424326,0.9984922621756941,210098,89,70694,335
10,7,SAFARI,Single-stranded,125,0.7,210098,335,210098,0,6,70484,83,210,0.9995765675327208,0.9984080443656651,0.9987426359436588,0.99899196424326,0.9984922621756941,210098,89,70694,335
10,7,vg giraffe,Single-stranded,125,0.85,254891,407,254891,0,8,85284,101,246,0.9995725490196078,0.9984057846124921,0.9987272154041967,0.9989888261368847,0.9984865239032431,254891,109,85530,407
10,7,SAFARI,Single-stranded,125,0.85,254891,407,254891,0,8,85284,101,246,0.9995725490196078,0.9984057846124921,0.9987272154041967,0.9989888261368847,0.9984865239032431,254891,109,85530,407
10,7,vg giraffe,Single-stranded,125,0.8,239768,383,239768,0,8,80292,97,233,0.9995622683670109,0.998405170080491,0.9986977551779734,0.9989833841641251,0.9984787128913496,239768,105,80525,383
10,7,SAFARI,Single-stranded,125,0.8,239768,383,239768,0,8,80292,97,233,0.9995622683670109,0.998405170080491,0.9986977551779734,0.9989833841641251,0.9984787128913496,239768,105,80525,383
10,7,vg giraffe,Single-stranded,125,0.95,284720,457,284720,0,9,95210,106,281,0.9995962574824021,0.9983974864733131,0.9987971466225969,0.9989965123541259,0.9984978320985969,284720,115,95491,457
10,7,SAFARI,Single-stranded,125,0.95,284720,457,284720,0,9,95210,106,281,0.9995962574824021,0.9983974864733131,0.9987971466225969,0.9989965123541259,0.9984978320985969,284720,115,95491,457
10,7,vg giraffe,Single-stranded,125,0.9,269747,429,269747,0,8,90231,103,261,0.9995886725611247,0.9984121461565794,0.998774875004139,0.9990000629589988,0.9985032388248761,269747,111,90492,429
10,7,SAFARI,Single-stranded,125,0.9,269747,429,269747,0,8,90231,103,261,0.9995886725611247,0.9984121461565794,0.998774875004139,0.9990000629589988,0.9985032388248761,269747,111,90492,429
11,6,vg giraffe,High,125,0.15,44495,72,44495,329,0,14956,15,43,0.9996629970793081,0.9910682466143977,0.9990009324630345,0.9953470684294119,0.9930562510432315,44495,15,14999,401
11,6,SAFARI,High,125,0.15,44541,72,44541,283,0,14956,15,43,0.9996633450040399,0.9920928367783322,0.9990009324630345,0.9958637034387158,0.9938240694374896,44541,15,14999,355
11,6,vg giraffe,High,125,0.1,29655,46,29655,222,0,10014,10,27,0.9996629024102478,0.9910436787755238,0.9990050741219779,0.9953346311337853,0.9930454795617151,29655,10,10041,268
11,6,SAFARI,High,125,0.1,29689,45,29689,189,0,10014,10,27,0.9996632883262063,0.9921799284831067,0.9990050741219779,0.9959075509040287,0.9938960324210737,29689,10,10041,234
11,6,vg giraffe,High,125,0.25,74187,128,74187,565,2,24984,30,84,0.9995688435575796,0.9907451923076923,0.9987250996015936,0.9951374590037493,0.992748549709942,74187,32,25068,693
11,6,SAFARI,High,125,0.25,74273,128,74273,479,2,24984,32,82,0.9995424388011896,0.9918936965811965,0.9986454183266932,0.9957033789807422,0.9935887177435487,74273,34,25066,607
11,6,vg giraffe,High,125,0.2,59351,93,59351,456,1,19909,21,61,0.9996294612029036,0.9908347245409015,0.9988995598239295,0.9952126633856783,0.9928528513493216,59351,22,19970,549
11,6,SAFARI,High,125,0.2,59420,93,59420,387,1,19909,23,59,0.9995962586636161,0.9919866444073456,0.9987995198079231,0.995776913795415,0.9936914835027287,59420,24,19968,480
11,6,vg giraffe,High,125,0.35,103828,180,103828,778,4,35006,34,115,0.999634143993222,0.9908575573072739,0.9989191956540289,0.9952265015432396,0.992882918289328,103828,38,35121,958
11,6,SAFARI,High,125,0.35,103933,180,103933,673,4,35006,36,113,0.9996152847373837,0.9918595995648274,0.9988623112147672,0.9957223401146776,0.9936189217192468,103933,40,35119,853
11,6,vg giraffe,High,125,0.3,88836,148,88836,672,2,29883,33,102,0.9996061707418618,0.9908539305791023,0.998834110592938,0.9952108084491421,0.9928557104181289,88836,35,29985,820
11,6,SAFARI,High,125,0.3,88930,148,88930,578,2,29883,35,100,0.9995841154585408,0.9919023824395468,0.998767488341106,0.9957284336283682,0.9936244526889267,88930,37,29983,726
11,6,vg giraffe,High,125,0.45,133889,227,133889,1029,4,45251,41,154,0.999664013618648,0.9907062784416738,0.999009900990099,0.9951649887207847,0.9927960353276669,133889,45,45405,1256
11,6,SAFARI,High,125,0.45,134017,227,134017,901,4,45251,43,152,0.9996494211719775,0.991653409301121,0.998965896589659,0.9956353613735054,0.9934937290622664,134017,47,45403,1128
11,6,vg giraffe,High,125,0.4,118672,198,118672,903,4,40038,37,130,0.9996546292318449,0.9908076110642632,0.9989803277873113,0.9952114589535654,0.9928616969409059,118672,41,40168,1101
11,6,SAFARI,High,125,0.4,118793,198,118793,782,4,40038,39,128,0.9996381567875054,0.9918178554432134,0.9989305876793753,0.9957126512411517,0.993605530622195,118793,43,40166,980
11,6,vg giraffe,High,125,0.55,163673,272,163673,1259,4,55334,47,179,0.9996885001588038,0.9907326699111402,0.9990821395147937,0.9951904368129196,0.9928341063922308,163673,51,55513,1531
11,6,SAFARI,High,125,0.55,163835,272,163835,1097,4,55334,49,177,0.9996766084155033,0.99171327570761,0.9990461449859621,0.995679019848553,0.9935588491085665,163835,53,55511,1369
11,6,vg giraffe,High,125,0.5,148866,246,148866,1150,4,50377,45,163,0.9996709532283518,0.9907095606340924,0.9990314099903141,0.995170083261748,0.9928056121204276,148866,49,50540,1396
11,6,SAFARI,High,125,0.5,149010,246,149010,1006,4,50377,47,161,0.9996578581922837,0.9916678867577964,0.9989918757042044,0.9956468430424658,0.9935126038705309,149010,51,50538,1252
11,6,vg giraffe,High,125,0.65,193600,321,193600,1500,4,65458,58,213,0.9996798545920211,0.9906816565261666,0.9990567903488354,0.9951604156439628,0.9927896949692518,193600,62,65671,1821
11,6,SAFARI,High,125,0.65,193792,321,193792,1308,4,65458,60,211,0.9996698580389568,0.9916641507309859,0.999026364231056,0.9956509118185766,0.9935172350413932,193792,64,65669,1629
11,6,vg giraffe,High,125,0.6,178642,298,178642,1366,4,60354,52,197,0.9996866221222398,0.9907712444400075,0.9990760143217781,0.995208967031008,0.9928604932070914,178642,56,60551,1664
11,6,SAFARI,High,125,0.6,178806,298,178806,1202,4,60354,54,195,0.9996757312818678,0.9916808092908722,0.9990430148332701,0.9956622212322856,0.9935329351259583,178806,58,60549,1500
11,6,vg giraffe,High,125,0.75,223165,370,223165,1725,4,75409,61,246,0.9997088204990369,0.9906996359762053,0.9991415742208135,0.9951838391045509,0.9928234434181673,223165,65,75655,2095
11,6,SAFARI,High,125,0.75,223377,370,223377,1513,4,75409,63,244,0.9997001485830902,0.9916407706650093,0.9991151611199155,0.9956541506204536,0.9935211641969566,223377,67,75653,1883
11,6,vg giraffe,High,125,0.7,208450,348,208450,1619,4,70485,60,235,0.9996930661730148,0.9906518959969964,0.9990958408679927,0.9951519462632271,0.9927774083306958,208450,64,70720,1967
11,6,SAFARI,High,125,0.7,208657,348,208657,1412,4,70485,62,233,0.9996837914364972,0.991635656814801,0.9990675858951176,0.9956434604189531,0.9935064242303548,208657,66,70718,1760
11,6,vg giraffe,High,125,0.85,252911,425,252911,1947,5,85282,71,273,0.9996995893069605,0.9907083511240466,0.9991124709509407,0.9951836622267692,0.9928193034020311,252911,76,85555,2372
11,6,SAFARI,High,125,0.85,253149,425,253149,1709,5,85282,73,271,0.999691975974126,0.991640649788666,0.9990891149233339,0.9956500363807987,0.9935115601002013,253149,78,85553,2134
11,6,vg giraffe,High,125,0.8,237897,394,237897,1844,5,80292,68,262,0.9996932386435265,0.9906802423636705,0.9990945961030424,0.9951663337551375,0.9927952812365555,237897,73,80554,2238
11,6,SAFARI,High,125,0.8,238124,394,238124,1617,5,80292,70,260,0.9996851372172008,0.9916255439648531,0.9990697905168244,0.9956390304682502,0.9934967358976438,238124,75,80552,2011
11,6,vg giraffe,High,125,0.95,282521,467,282521,2176,6,95209,77,302,0.999706302812416,0.990731649156275,0.9991317446701676,0.99519874314861,0.9928405969145757,282521,83,95511,2643
11,6,SAFARI,High,125,0.95,282785,467,282785,1912,6,95209,79,300,0.9996995086081946,0.991657432214445,0.9991108228549909,0.9956622314861434,0.9935286980181638,282785,85,95509,2379
11,6,vg giraffe,High,125,0.9,267640,451,267640,2072,5,90230,73,287,0.9997086486526868,0.9906611934276714,0.9991390253325239,0.9951643579155984,0.992790180675134,267640,78,90517,2523
11,6,SAFARI,High,125,0.9,267889,451,267889,1823,5,90230,75,285,0.9997014580044706,0.9915828592368311,0.9991169490589988,0.9956256085867408,0.9934748501765727,267889,80,90515,2274
11,6,vg giraffe,Mid,125,0.15,44835,61,44835,2,3,14953,22,38,0.9994427106553723,0.9985968194574368,0.9983351092168353,0.9990195859979054,0.9985312280936008,44835,25,14991,63
11,6,SAFARI,Mid,125,0.15,44835,61,44835,2,3,14953,22,38,0.9994427106553723,0.9985968194574368,0.9983351092168353,0.9990195859979054,0.9985312280936008,44835,25,14991,63
11,6,vg giraffe,Mid,125,0.1,29879,44,29879,2,0,10014,15,21,0.9994982270689771,0.9984628237259816,0.9985074626865672,0.9989802571089454,0.9984740462789243,29879,15,10035,46
11,6,SAFARI,Mid,125,0.1,29879,44,29879,2,0,10014,15,21,0.9994982270689771,0.9984628237259816,0.9985074626865672,0.9989802571089454,0.9984740462789243,29879,15,10035,46
11,6,vg giraffe,Mid,125,0.25,74773,105,74773,3,4,24982,42,69,0.9993851829080849,0.9985577115690228,0.998167111606965,0.9989712758851036,0.9984596611254476,74773,46,25051,108
11,6,SAFARI,Mid,125,0.25,74773,105,74773,3,4,24982,42,69,0.9993851829080849,0.9985577115690228,0.998167111606965,0.9989712758851036,0.9984596611254476,74773,46,25051,108
11,6,vg giraffe,Mid,125,0.2,59816,82,59816,3,3,19907,30,50,0.9994486123410583,0.998580991970084,0.9983491745872937,0.9990146137787056,0.9985229875705649,59816,33,19957,85
11,6,SAFARI,Mid,125,0.2,59816,82,59816,3,3,19907,30,50,0.9994486123410583,0.998580991970084,0.9983491745872937,0.9990146137787056,0.9985229875705649,59816,33,19957,85
11,6,vg giraffe,Mid,125,0.35,104624,160,104624,3,6,35004,45,94,0.9995127776450919,0.9984444635307815,0.9985490341119235,0.9989783349724533,0.9984707294763321,104624,51,35098,163
11,6,SAFARI,Mid,125,0.35,104624,160,104624,3,6,35004,45,94,0.9995127776450919,0.9984444635307815,0.9985490341119235,0.9989783349724533,0.9984707294763321,104624,51,35098,163
11,6,vg giraffe,Mid,125,0.3,89519,135,89519,3,4,29881,44,85,0.9994640883361059,0.9984608006067569,0.9984007463183847,0.998962192563496,0.9984457387336949,89519,48,29966,138
11,6,SAFARI,Mid,125,0.3,89519,135,89519,3,4,29881,44,85,0.9994640883361059,0.9984608006067569,0.9984007463183847,0.998962192563496,0.9984457387336949,89519,48,29966,138
11,6,vg giraffe,Mid,125,0.45,134931,210,134931,3,7,45250,55,129,0.9995407169260628,0.9984239033919375,0.9986355934068353,0.9989819980232253,0.998477171415123,134931,62,45379,213
11,6,SAFARI,Mid,125,0.45,134931,210,134931,3,7,45250,55,129,0.9995407169260628,0.9984239033919375,0.9986355934068353,0.9989819980232253,0.998477171415123,134931,62,45379,213
11,6,vg giraffe,Mid,125,0.4,119590,180,119590,3,7,40035,49,109,0.9995319525934842,0.9984721097409266,0.9986069651741294,0.999001750069961,0.9985059978871434,119590,56,40144,183
11,6,SAFARI,Mid,125,0.4,119590,180,119590,3,7,40035,49,109,0.9995319525934842,0.9984721097409266,0.9986069651741294,0.999001750069961,0.9985059978871434,119590,56,40144,183
11,6,vg giraffe,Mid,125,0.55,164944,254,164944,6,7,55333,63,156,0.9995757935690305,0.998426188227888,0.9987400781151569,0.9990006601699484,0.9985051842926578,164944,70,55489,260
11,6,SAFARI,Mid,125,0.55,164944,254,164944,6,7,55333,63,156,0.9995757935690305,0.998426188227888,0.9987400781151569,0.9990006601699484,0.9985051842926578,164944,70,55489,260
11,6,vg giraffe,Mid,125,0.5,150021,234,150021,5,7,50376,60,139,0.9995535952241352,0.9984094236656462,0.9986754181329327,0.9989811818290782,0.9984764142958146,150021,67,50515,239
11,6,SAFARI,Mid,125,0.5,150021,234,150021,5,7,50376,60,139,0.9995535952241352,0.9984094236656462,0.9986754181329327,0.9989811818290782,0.9984764142958146,150021,67,50515,239
11,6,vg giraffe,Mid,125,0.65,195113,305,195113,7,7,65455,75,196,0.999579907272215,0.9984034795957528,0.9987525291710404,0.9989913470892426,0.9984913347475475,195113,82,65651,312
11,6,SAFARI,Mid,125,0.65,195113,305,195113,7,7,65455,75,196,0.999579907272215,0.9984034795957528,0.9987525291710404,0.9989913470892426,0.9984913347475475,195113,82,65651,312
11,6,vg giraffe,Mid,125,0.6,180025,277,180025,6,7,60353,70,175,0.9995724644923433,0.9984304634292432,0.9987294777658609,0.9990011375932966,0.9985056846247401,180025,77,60528,283
11,6,SAFARI,Mid,125,0.6,180025,277,180025,6,7,60353,70,175,0.9995724644923433,0.9984304634292432,0.9987294777658609,0.9990011375932966,0.9985056846247401,180025,77,60528,283
11,6,vg giraffe,Mid,125,0.75,224910,347,224910,9,7,75406,82,226,0.9996044426864119,0.9984196461072687,0.9988246325325867,0.999011693114055,0.9985215308302352,224910,89,75632,356
11,6,SAFARI,Mid,125,0.75,224910,347,224910,9,7,75406,82,226,0.9996044426864119,0.9984196461072687,0.9988246325325867,0.999011693114055,0.9985215308302352,224910,89,75632,356
11,6,vg giraffe,Mid,125,0.7,210088,327,210088,8,7,70482,78,218,0.9995955712674797,0.9984079687106447,0.9987991806173624,0.9990014170367765,0.9985064436289153,210088,85,70700,335
11,6,SAFARI,Mid,125,0.7,210088,327,210088,8,7,70482,78,218,0.9995955712674797,0.9984079687106447,0.9987991806173624,0.9990014170367765,0.9985064436289153,210088,85,70700,335
11,6,vg giraffe,Mid,125,0.85,254871,409,254871,9,8,85279,90,256,0.9996156395483372,0.9983626399884052,0.9988555813763386,0.9989887468692309,0.9984864573128164,254871,98,85535,418
11,6,SAFARI,Mid,125,0.85,254871,409,254871,9,8,85279,90,256,0.9996156395483372,0.9983626399884052,0.9988555813763386,0.9989887468692309,0.9984864573128164,254871,98,85535,418
11,6,vg giraffe,Mid,125,0.8,239749,383,239749,9,8,80289,88,240,0.9995997414997185,0.9983676256865758,0.9988093023255814,0.9989833036796907,0.9984786417513078,239749,96,80529,392
11,6,SAFARI,Mid,125,0.8,239749,383,239749,9,8,80289,88,240,0.9995997414997185,0.9983676256865758,0.9988093023255814,0.9989833036796907,0.9984786417513078,239749,96,80529,392
11,6,vg giraffe,Mid,125,0.95,284707,453,284707,9,8,95205,97,285,0.9996313357583247,0.998379908054522,0.9989016161933155,0.9990052299988946,0.9985108886344297,284707,105,95490,462
11,6,SAFARI,Mid,125,0.95,284707,453,284707,9,8,95205,97,285,0.9996313357583247,0.998379908054522,0.9989016161933155,0.9990052299988946,0.9985108886344297,284707,105,95490,462
11,6,vg giraffe,Mid,125,0.9,269732,427,269732,9,8,90227,92,270,0.9996293990334727,0.998386189334044,0.9988962106913033,0.9990074074074075,0.9985142682909928,269732,100,90497,436
11,6,SAFARI,Mid,125,0.9,269732,427,269732,9,8,90227,92,270,0.9996293990334727,0.998386189334044,0.9988962106913033,0.9990074074074075,0.9985142682909928,269732,100,90497,436
11,6,vg giraffe,None,125,0.15,44827,73,44827,0,0,14958,16,42,0.9996431996075196,0.9983741648106904,0.9989344698987747,0.9990082791972633,0.9985145870885906,44827,16,15000,73
11,6,SAFARI,None,125,0.15,44827,73,44827,0,0,14958,16,42,0.9996431996075196,0.9983741648106904,0.9989344698987747,0.9990082791972633,0.9985145870885906,44827,16,15000,73
11,6,vg giraffe,None,125,0.1,29878,47,29878,0,0,10014,9,28,0.9996988657275738,0.9984294068504594,0.9991045667097801,0.9990637330301612,0.9985991594956974,29878,9,10042,47
11,6,SAFARI,None,125,0.1,29878,47,29878,0,0,10014,9,28,0.9996988657275738,0.9984294068504594,0.9991045667097801,0.9990637330301612,0.9985991594956974,29878,9,10042,47
11,6,vg giraffe,None,125,0.25,74769,114,74769,0,0,24988,36,78,0.9995187487467415,0.9984776250951485,0.9985658513265875,0.9989979156645824,0.998499774966245,74769,36,25066,114
11,6,SAFARI,None,125,0.25,74769,114,74769,0,0,24988,36,78,0.9995187487467415,0.9984776250951485,0.9985658513265875,0.9989979156645824,0.998499774966245,74769,36,25066,114
11,6,vg giraffe,None,125,0.2,59811,92,59811,0,0,19912,24,58,0.9995988969666583,0.9984641837637513,0.9987996398919676,0.9990312181596486,0.9985481307182998,59811,24,19970,92
11,6,SAFARI,None,125,0.2,59811,92,59811,0,0,19912,24,58,0.9995988969666583,0.9984641837637513,0.9987996398919676,0.9990312181596486,0.9985481307182998,59811,24,19970,92
11,6,vg giraffe,None,125,0.35,104628,158,104628,0,1,35011,41,108,0.9995987388936658,0.9984921649838719,0.9988054947242684,0.9990451455198229,0.9985708875502869,104628,42,35119,158
11,6,SAFARI,None,125,0.35,104628,158,104628,0,1,35011,41,108,0.9995987388936658,0.9984921649838719,0.9988054947242684,0.9990451455198229,0.9985708875502869,104628,42,35119,158
11,6,vg giraffe,None,125,0.3,89521,136,89521,0,0,29887,40,95,0.9995533770279474,0.9984831078443401,0.9986676437279328,0.9990179557856912,0.9985293994769341,89521,40,29982,136
11,6,SAFARI,None,125,0.3,89521,136,89521,0,0,29887,40,95,0.9995533770279474,0.9984831078443401,0.9986676437279328,0.9990179557856912,0.9985293994769341,89521,40,29982,136
11,6,vg giraffe,None,125,0.45,134935,208,134935,0,3,45254,50,145,0.9996073725071858,0.9984608895762267,0.9988339347003432,0.9990338021182315,0.9985547772640438,134935,53,45399,208
11,6,SAFARI,None,125,0.45,134935,208,134935,0,3,45254,50,145,0.9996073725071858,0.9984608895762267,0.9988339347003432,0.9990338021182315,0.9985547772640438,134935,53,45399,208
11,6,vg giraffe,None,125,0.4,119590,182,119590,0,2,40042,45,122,0.9996071449467974,0.9984804461810773,0.9988311656014524,0.9990434778976564,0.9985685979135284,119590,47,40164,182
11,6,SAFARI,None,125,0.4,119590,182,119590,0,2,40042,45,122,0.9996071449467974,0.9984804461810773,0.9988311656014524,0.9990434778976564,0.9985685979135284,119590,47,40164,182
11,6,vg giraffe,None,125,0.55,164947,256,164947,0,3,55337,60,166,0.9996182049572753,0.9984503913367191,0.9988662131519275,0.9990339568702625,0.9985550507544084,164947,63,55503,256
11,6,SAFARI,None,125,0.55,164947,256,164947,0,3,55337,60,166,0.9996182049572753,0.9984503913367191,0.9988662131519275,0.9990339568702625,0.9985550507544084,164947,63,55503,256
11,6,vg giraffe,None,125,0.5,150025,234,150025,0,3,50380,56,152,0.999606886810053,0.9984426889570674,0.9988337846652566,0.9990244487136374,0.9985411999004232,150025,59,50532,234
11,6,SAFARI,None,125,0.5,150025,234,150025,0,3,50380,56,152,0.999606886810053,0.9984426889570674,0.9988337846652566,0.9990244487136374,0.9985411999004232,150025,59,50532,234
11,6,vg giraffe,None,125,0.65,195117,310,195117,0,3,65461,71,200,0.999620884159618,0.9984137299349629,0.9988742678938161,0.9990169423836075,0.9985296482642957,195117,74,65661,310
11,6,SAFARI,None,125,0.65,195117,310,195117,0,3,65461,71,200,0.999620884159618,0.9984137299349629,0.9988742678938161,0.9990169423836075,0.9985296482642957,195117,74,65661,310
11,6,vg giraffe,None,125,0.6,180021,286,180021,0,3,60357,65,184,0.999622408920034,0.998413816435302,0.998878054414361,0.9990177471448074,0.9985306081787843,180021,68,60541,286
11,6,SAFARI,None,125,0.6,180021,286,180021,0,3,60357,65,184,0.999622408920034,0.998413816435302,0.998878054414361,0.9990177471448074,0.9985306081787843,180021,68,60541,286
11,6,vg giraffe,None,125,0.75,224915,357,224915,0,3,75412,77,230,0.9996444365430343,0.9984152491210625,0.9989435038694171,0.9990294647398099,0.9985481438168202,224915,80,75642,357
11,6,SAFARI,None,125,0.75,224915,357,224915,0,3,75412,77,230,0.9996444365430343,0.9984152491210625,0.9989435038694171,0.9990294647398099,0.9985481438168202,224915,80,75642,357
11,6,vg giraffe,None,125,0.7,210099,330,210099,0,3,70488,74,221,0.9996336403775883,0.9984317750880345,0.9989122142796598,0.999032346263121,0.9985527087815372,210099,77,70709,330
11,6,SAFARI,None,125,0.7,210099,330,210099,0,3,70488,74,221,0.9996336403775883,0.9984317750880345,0.9989122142796598,0.999032346263121,0.9985527087815372,210099,77,70709,330
11,6,vg giraffe,None,125,0.85,254885,410,254885,0,4,85287,91,253,0.9996274217585693,0.9983940147672301,0.9988906405091377,0.9990103375630787,0.9985187575162057,254885,95,85540,410
11,6,SAFARI,None,125,0.85,254885,410,254885,0,4,85287,91,253,0.9996274217585693,0.9983940147672301,0.9988906405091377,0.9990103375630787,0.9985187575162057,254885,95,85540,410
11,6,vg giraffe,None,125,0.8,239763,384,239763,0,3,80296,86,244,0.9996289378450044,0.9984009794001174,0.9988961787942303,0.9990145812803776,0.998525450781854,239763,89,80540,384
11,6,SAFARI,None,125,0.8,239763,384,239763,0,3,80296,86,244,0.9996289378450044,0.9984009794001174,0.9988961787942303,0.9990145812803776,0.998525450781854,239763,89,80540,384
11,6,vg giraffe,None,125,0.95,284713,461,284713,0,5,95213,99,280,0.9996348532566525,0.9983834430908849,0.9989120997520843,0.999008756278608,0.9985161685107322,284713,104,95493,461
11,6,SAFARI,None,125,0.95,284713,461,284713,0,5,95213,99,280,0.9996348532566525,0.9983834430908849,0.9989120997520843,0.999008756278608,0.9985161685107322,284713,104,95493,461
11,6,vg giraffe,None,125,0.9,269733,440,269733,0,4,90234,94,266,0.9996368097068165,0.9983714138718525,0.9989182984171836,0.9990037110836215,0.998508749317434,269733,98,90500,440
11,6,SAFARI,None,125,0.9,269733,440,269733,0,4,90234,94,266,0.9996368097068165,0.9983714138718525,0.9989182984171836,0.9990037110836215,0.998508749317434,269733,98,90500,440
11,6,vg giraffe,Single-stranded,125,0.15,44833,67,44833,0,0,14958,20,37,0.999554098945444,0.9985077951002227,0.9986679986679987,0.9990306730694238,0.9985479429191354,44833,20,14995,67
11,6,SAFARI,Single-stranded,125,0.15,44833,67,44833,0,0,14958,20,37,0.999554098945444,0.9985077951002227,0.9986679986679987,0.9990306730694238,0.9985479429191354,44833,20,14995,67
11,6,vg giraffe,Single-stranded,125,0.1,29883,42,29883,0,0,10014,12,18,0.9995985950827898,0.9985964912280701,0.998805256869773,0.9990972918756269,0.9986489529385274,29883,12,10032,42
11,6,SAFARI,Single-stranded,125,0.1,29883,42,29883,0,0,10014,12,18,0.9995985950827898,0.9985964912280701,0.998805256869773,0.9990972918756269,0.9986489529385274,29883,12,10032,42
11,6,vg giraffe,Single-stranded,125,0.25,74761,121,74761,0,0,24987,37,73,0.9995053343672291,0.9983841243556529,0.9985257202056023,0.9989444147514698,0.9984196681303074,74761,37,25060,121
11,6,SAFARI,Single-stranded,125,0.25,74761,121,74761,0,0,24987,37,73,0.9995053343672291,0.9983841243556529,0.9985257202056023,0.9989444147514698,0.9984196681303074,74761,37,25060,121
11,6,vg giraffe,Single-stranded,125,0.2,59804,99,59804,0,0,19911,26,50,0.9995654354003009,0.9983473281805586,0.9986991544503927,0.9989560104565993,0.9984353486043309,59804,26,19961,99
11,6,SAFARI,Single-stranded,125,0.2,59804,99,59804,0,0,19911,26,50,0.9995654354003009,0.9983473281805586,0.9986991544503927,0.9989560104565993,0.9984353486043309,59804,26,19961,99
11,6,vg giraffe,Single-stranded,125,0.35,104621,164,104621,0,2,35008,41,97,0.9995891615072996,0.9984348904900511,0.9987766017981109,0.9990116925838749,0.9985207206305875,104621,43,35105,164
11,6,SAFARI,Single-stranded,125,0.35,104621,164,104621,0,2,35008,41,97,0.9995891615072996,0.9984348904900511,0.9987766017981109,0.9990116925838749,0.9985207206305875,104621,43,35105,164
11,6,vg giraffe,Single-stranded,125,0.3,89516,140,89516,0,0,29885,40,86,0.9995533520925455,0.9984384759525297,0.998667155376362,0.9989956029730153,0.9984958259169194,89516,40,29971,140
11,6,SAFARI,Single-stranded,125,0.3,89516,140,89516,0,0,29885,40,86,0.9995533520925455,0.9984384759525297,0.998667155376362,0.9989956029730153,0.9984958259169194,89516,40,29971,140
11,6,vg giraffe,Single-stranded,125,0.45,134929,217,134929,0,3,45252,48,133,0.9996221662468514,0.9983943290959407,0.9988775420371512,0.9990078704012202,0.9985159096698453,134929,51,45385,217
11,6,SAFARI,Single-stranded,125,0.45,134929,217,134929,0,3,45252,48,133,0.9996221662468514,0.9983943290959407,0.9988775420371512,0.9990078704012202,0.9985159096698453,134929,51,45385,217
11,6,vg giraffe,Single-stranded,125,0.4,119584,191,119584,0,3,40039,44,113,0.999607125243457,0.9984053433521185,0.9988308166869823,0.9990058728686834,0.9985122582419643,119584,47,40152,191
11,6,SAFARI,Single-stranded,125,0.4,119584,191,119584,0,3,40039,44,113,0.999607125243457,0.9984053433521185,0.9988308166869823,0.9990058728686834,0.9985122582419643,119584,47,40152,191
11,6,vg giraffe,Single-stranded,125,0.55,164947,258,164947,0,3,55336,59,155,0.9996242629189923,0.998438303925426,0.9988839486616384,0.9990309314565705,0.9985504489078538,164947,62,55491,258
11,6,SAFARI,Single-stranded,125,0.55,164947,258,164947,0,3,55336,59,155,0.9996242629189923,0.998438303925426,0.9988839486616384,0.9990309314565705,0.9985504489078538,164947,62,55491,258
11,6,vg giraffe,Single-stranded,125,0.5,150022,239,150022,0,3,50378,54,145,0.9996202000279852,0.9984094342510698,0.9988730723606168,0.9990144502896717,0.9985261973401846,150022,57,50523,239
11,6,SAFARI,Single-stranded,125,0.5,150022,239,150022,0,3,50378,54,145,0.9996202000279852,0.9984094342510698,0.9988730723606168,0.9990144502896717,0.9985261973401846,150022,57,50523,239
11,6,vg giraffe,Single-stranded,125,0.65,195131,300,195131,0,4,65459,73,194,0.9996055489529118,0.9984649313568472,0.998828541001065,0.9990349145886611,0.9985564460237172,195131,77,65653,300
11,6,SAFARI,Single-stranded,125,0.65,195131,300,195131,0,4,65459,73,194,0.9996055489529118,0.9984649313568472,0.998828541001065,0.9990349145886611,0.9985564460237172,195131,77,65653,300
11,6,vg giraffe,Single-stranded,125,0.6,180033,276,180033,0,3,60356,68,176,0.9996057833251899,0.9984692943779845,0.9988284408362622,0.9990372156387256,0.9985596400345355,180033,71,60532,276
11,6,SAFARI,Single-stranded,125,0.6,180033,276,180033,0,3,60356,68,176,0.9996057833251899,0.9984692943779845,0.9988284408362622,0.9990372156387256,0.9985596400345355,180033,71,60532,276
11,6,vg giraffe,Single-stranded,125,0.75,224919,357,224919,0,4,75410,84,225,0.9996089010564115,0.9984152772598945,0.9988378696036871,0.9990117326214846,0.9985215897727235,224919,88,75635,357
11,6,SAFARI,Single-stranded,125,0.75,224919,357,224919,0,4,75410,84,225,0.9996089010564115,0.9984152772598945,0.9988378696036871,0.9990117326214846,0.9985215897727235,224919,88,75635,357
11,6,vg giraffe,Single-stranded,125,0.7,210098,335,210098,0,4,70486,78,215,0.9996098582167666,0.9984080443656651,0.998841529745843,0.9990085898438708,0.9985171540737369,210098,82,70701,335
11,6,SAFARI,Single-stranded,125,0.7,210098,335,210098,0,4,70486,78,215,0.9996098582167666,0.9984080443656651,0.998841529745843,0.9990085898438708,0.9985171540737369,210098,82,70701,335
11,6,vg giraffe,Single-stranded,125,0.85,254891,407,254891,0,4,85288,95,252,0.9996117494803718,0.9984057846124921,0.9988439846331695,0.9990084030978585,0.9985158548353508,254891,99,85540,407
11,6,SAFARI,Single-stranded,125,0.85,254891,407,254891,0,4,85288,95,252,0.9996117494803718,0.9984057846124921,0.9988439846331695,0.9990084030978585,0.9985158548353508,254891,99,85540,407
11,6,vg giraffe,Single-stranded,125,0.8,239768,383,239768,0,4,80296,91,239,0.9996039405827494,0.998405170080491,0.9988217784943569,0.9990041957109583,0.9985098868075104,239768,95,80535,383
11,6,SAFARI,Single-stranded,125,0.8,239768,383,239768,0,4,80296,91,239,0.9996039405827494,0.998405170080491,0.9988217784943569,0.9990041957109583,0.9985098868075104,239768,95,80535,383
11,6,vg giraffe,Single-stranded,125,0.95,284720,457,284720,0,5,95214,100,287,0.9996313525849205,0.9983974864733131,0.9989017425684581,0.9990140385472331,0.9985240937751948,284720,105,95501,457
11,6,SAFARI,Single-stranded,125,0.95,284720,457,284720,0,5,95214,100,287,0.9996313525849205,0.9983974864733131,0.9989017425684581,0.9990140385472331,0.9985240937751948,284720,105,95501,457
11,6,vg giraffe,Single-stranded,125,0.9,269747,429,269747,0,4,90235,97,267,0.9996257152174558,0.9984121461565794,0.9988852466253877,0.999018562137979,0.9985309566244155,269747,101,90502,429
11,6,SAFARI,Single-stranded,125,0.9,269747,429,269747,0,4,90235,97,267,0.9996257152174558,0.9984121461565794,0.9988852466253877,0.999018562137979,0.9985309566244155,269747,101,90502,429
12,3,vg giraffe,High,125,0.15,44586,73,44586,237,0,14956,16,42,0.9996412716918524,0.9930951532430506,0.9989343279605701,0.9963574605019107,0.9945585044233016,44586,16,14998,310
12,3,SAFARI,High,125,0.15,44646,74,44646,176,0,14956,18,40,0.9995969908651263,0.9944315751960086,0.9988011189556414,0.9970075926753015,0.9955266232682357,44646,18,14996,250
12,3,vg giraffe,High,125,0.1,29722,47,29722,154,0,10014,11,26,0.9996300406955235,0.9932827590816429,0.9989055815341757,0.9964462920745609,0.9946965527592936,29722,11,10040,201
12,3,SAFARI,High,125,0.1,29752,47,29752,124,0,10014,11,26,0.9996304136007795,0.9942853323530395,0.9989055815341757,0.99695070870891,0.9954470405763747,29752,11,10040,171
12,3,vg giraffe,High,125,0.25,74343,129,74343,408,1,24985,33,81,0.9995428694354438,0.9928285256410256,0.9986454183266932,0.9961743837809952,0.9942888577715543,74343,34,25066,537
12,3,SAFARI,High,125,0.25,74458,130,74458,292,1,24985,36,78,0.9995033223706289,0.9943643162393162,0.9985258964143426,0.9969271966527196,0.9954090818163632,74458,37,25063,422
12,3,vg giraffe,High,125,0.2,59475,94,59475,331,0,19910,24,58,0.999596631876166,0.9929048414023373,0.9987995198079231,0.9962394994932956,0.9943799128823912,59475,24,19968,425
12,3,SAFARI,High,125,0.2,59565,95,59565,240,0,19910,27,55,0.9995469190495369,0.9944073455759599,0.9986494597839136,0.9969705084859237,0.9954688829920393,59565,27,19965,335
12,3,vg giraffe,High,125,0.35,104031,181,104031,574,2,35008,37,112,0.9996252522340732,0.9927948390052106,0.998890753434398,0.9961983376106025,0.9943263424916932,104031,39,35120,755
12,3,SAFARI,High,125,0.35,104169,182,104169,435,2,35008,40,109,0.9995969715289172,0.9941118088294237,0.9988054267755055,0.9968468446915506,0.9952910071813927,104169,42,35117,617
12,3,vg giraffe,High,125,0.3,89021,149,89021,486,1,29884,36,99,0.9995845404118664,0.9929173730704024,0.998767488341106,0.9962398021419698,0.9943848390654768,89021,37,29983,635
12,3,SAFARI,High,125,0.3,89144,150,89144,362,1,29884,39,96,0.999551489056333,0.9942892834835371,0.9986675549633578,0.9969134421829569,0.9953875463752131,89144,40,29980,512
12,3,vg giraffe,High,125,0.45,134154,228,134154,763,2,45253,43,152,0.999664677084032,0.9926671352991232,0.999009900990099,0.9961536176785079,0.9942634070710706,134154,45,45405,991
12,3,SAFARI,High,125,0.45,134335,229,134335,581,2,45253,46,149,0.9996428119628227,0.9940064375300603,0.998943894389439,0.9968166572675196,0.995249037902489,134335,48,45402,810
12,3,vg giraffe,High,125,0.4,118904,199,118904,670,2,40040,40,127,0.9996468985926387,0.992744608551176,0.9989554577333433,0.9961837976868201,0.9943056093810554,118904,42,40167,869
12,3,SAFARI,High,125,0.4,119069,200,119069,504,2,40040,43,124,0.9996222106553386,0.9941222145224716,0.9988808475714392,0.9968646263714643,0.9953182233001213,119069,45,40164,704
12,3,vg giraffe,High,125,0.55,164015,273,164015,916,2,55336,49,177,0.9996891494886204,0.9928028377036876,0.9990821395147937,0.9962340936009961,0.9943832439483983,164015,51,55513,1189
12,3,SAFARI,High,125,0.55,164227,274,164227,703,2,55336,52,174,0.9996712949154193,0.9940860996101789,0.9990281477215464,0.996870874243137,0.9953299391216118,164227,54,55510,977
12,3,vg giraffe,High,125,0.5,149168,247,149168,847,2,50379,47,161,0.9996716191854815,0.9927193834768604,0.9990314099903141,0.9961833717890068,0.9943092142931825,149168,49,50540,1094
12,3,SAFARI,High,125,0.5,149373,248,149373,641,2,50379,50,158,0.999651999330768,0.9940836671946334,0.9989721085611497,0.9968600573264773,0.9953149349517801,149373,52,50537,889
12,3,vg giraffe,High,125,0.65,194012,322,194012,1087,2,65460,60,211,0.9996805342292115,0.9927899253406748,0.9990567903488354,0.9962233148050682,0.9943673081783162,194012,62,65671,1409
12,3,SAFARI,High,125,0.65,194256,323,194256,842,2,65460,63,208,0.9996655019272235,0.994038511725966,0.9990111511721662,0.9968440660744801,0.9952901353224535,194256,65,65668,1165
12,3,vg giraffe,High,125,0.6,179009,299,179009,998,2,60356,54,195,0.999687264401195,0.9928066731001741,0.9990760143217781,0.996235088529681,0.994383864714648,179009,56,60551,1297
12,3,SAFARI,High,125,0.6,179237,300,179237,769,2,60356,57,192,0.9996709352132787,0.9940711900879616,0.9990265150890161,0.9968631987586276,0.9953178118241854,179237,59,60548,1069
12,3,vg giraffe,High,125,0.75,223637,372,223637,1251,2,75411,64,243,0.99970496595933,0.9927949924531653,0.9991283676703645,0.9962379973405382,0.9943883314505947,223637,66,75654,1623
12,3,SAFARI,High,125,0.75,223928,373,223928,959,2,75411,67,240,0.9996919601601807,0.9940868329929858,0.9990887480190175,0.996881517705901,0.9953452056615057,223928,69,75651,1332
12,3,vg giraffe,High,125,0.7,208889,350,208889,1178,2,70487,63,232,0.9996889267494281,0.9927382293255773,0.9990817133815552,0.9962014540824234,0.9943350130333818,208889,65,70719,1528
12,3,SAFARI,High,125,0.7,209157,351,209157,909,2,70487,66,229,0.9996749910383559,0.9940118906742326,0.9990393309222423,0.9968353977914507,0.9952773994402581,209157,68,70716,1260
12,3,vg giraffe,High,125,0.85,253448,427,253448,1408,3,85284,75,269,0.9996923392472566,0.9928118989513599,0.9990891149233339,0.996240239461173,0.9943886141372897,253448,78,85553,1835
12,3,SAFARI,High,125,0.85,253739,428,253739,1116,3,85284,78,266,0.9996808762114885,0.9939518103438145,0.9990540808819236,0.9968081115216371,0.9952334019723449,253739,81,85550,1544
12,3,vg giraffe,High,125,0.8,238412,396,238412,1327,3,80294,72,258,0.9996855174495884,0.9928248693443271,0.9990697905168244,0.996243382042614,0.9943945978638368,238412,75,80552,1723
12,3,SAFARI,High,125,0.8,238708,397,238708,1030,3,80294,75,255,0.9996733476837001,0.9940575093176754,0.9990325821374973,0.99685751929859,0.9953080477113873,238708,78,80549,1427
12,3,vg giraffe,High,125,0.95,283112,469,283112,1583,4,95211,81,298,0.9996998555775661,0.9928041407751329,0.9991108228549909,0.9962400657328705,0.9943875112276039,283112,85,95509,2052
12,3,SAFARI,High,125,0.95,283449,470,283449,1245,4,95211,85,294,0.9996861090929611,0.993985916875903,0.9990689792246376,0.9968278641538099,0.9952620824775842,283449,89,95505,1715
12,3,vg giraffe,High,125,0.9,268211,453,268211,1499,3,90232,77,283,0.9997018163113932,0.9927747322912464,0.9991169490589988,0.996226232881546,0.9943674152756141,268211,80,90515,1952
12,3,SAFARI,High,125,0.9,268526,454,268526,1183,3,90232,80,280,0.9996910006738419,0.9939406950618701,0.9990838346487113,0.9968075549583127,0.9952322609616419,268526,83,90512,1637
12,3,vg giraffe,Mid,125,0.15,44836,61,44836,1,3,14953,22,38,0.9994427230779519,0.9986190921644617,0.9983351092168353,0.9990307378647267,0.9985479186834463,44836,25,14991,62
12,3,SAFARI,Mid,125,0.15,44836,61,44836,1,3,14953,22,38,0.9994427230779519,0.9986190921644617,0.9983351092168353,0.9990307378647267,0.9985479186834463,44836,25,14991,62
12,3,vg giraffe,Mid,125,0.1,29880,44,29880,1,0,10014,17,19,0.9994313810750243,0.9984962406015038,0.9983084577114428,0.9989635919895691,0.9984490306441526,29880,17,10033,45
12,3,SAFARI,Mid,125,0.1,29880,44,29880,1,0,10014,17,19,0.9994313810750243,0.9984962406015038,0.9983084577114428,0.9989635919895691,0.9984490306441526,29880,17,10033,45
12,3,vg giraffe,Mid,125,0.25,74775,105,74775,1,5,24981,42,69,0.9993718425062148,0.998584420614041,0.9981272662071163,0.9989779763932587,0.9984696633259317,74775,47,25050,106
12,3,SAFARI,Mid,125,0.25,74775,105,74775,1,5,24981,42,69,0.9993718425062148,0.998584420614041,0.9981272662071163,0.9989779763932587,0.9984696633259317,74775,47,25050,106
12,3,vg giraffe,Mid,125,0.2,59818,82,59818,1,3,19907,30,50,0.9994486307664032,0.9986143803943173,0.9983491745872937,0.9990313314182644,0.9985480216795384,59818,33,19957,83
12,3,SAFARI,Mid,125,0.2,59818,82,59818,1,3,19907,30,50,0.9994486307664032,0.9986143803943173,0.9983491745872937,0.9990313314182644,0.9985480216795384,59818,33,19957,83
12,3,vg giraffe,Mid,125,0.35,104625,160,104625,2,7,35003,45,94,0.9995032337571769,0.9984540066993043,0.9985205838003927,0.9989783447274949,0.9984707294763321,104625,52,35097,162
12,3,SAFARI,Mid,125,0.35,104625,160,104625,2,7,35003,45,94,0.9995032337571769,0.9984540066993043,0.9985205838003927,0.9989783447274949,0.9984707294763321,104625,52,35097,162
12,3,vg giraffe,Mid,125,0.3,89521,135,89521,1,5,29880,44,85,0.9994529418332031,0.9984831078443401,0.9983674285333511,0.9989677894513662,0.9984540949770621,89521,49,29965,136
12,3,SAFARI,Mid,125,0.3,89521,135,89521,1,5,29880,44,85,0.9994529418332031,0.9984831078443401,0.9983674285333511,0.9989677894513662,0.9984540949770621,89521,49,29965,136
12,3,vg giraffe,Mid,125,0.45,134932,210,134932,2,8,45249,53,131,0.9995481247175779,0.9984313029065294,0.9986575999647895,0.9989894016739654,0.998488246532104,134932,61,45380,212
12,3,SAFARI,Mid,125,0.45,134932,210,134932,2,8,45249,53,131,0.9995481247175779,0.9984313029065294,0.9986575999647895,0.9989894016739654,0.998488246532104,134932,61,45380,212
12,3,vg giraffe,Mid,125,0.4,119591,180,119591,2,8,40034,49,109,0.9995236025675315,0.9984804588680254,0.9985820895522388,0.9990017584088279,0.9985059978871434,119591,57,40143,182
12,3,SAFARI,Mid,125,0.4,119591,180,119591,2,8,40034,49,109,0.9995236025675315,0.9984804588680254,0.9985820895522388,0.9990017584088279,0.9985059978871434,119591,57,40143,182
12,3,vg giraffe,Mid,125,0.55,164947,254,164947,3,8,55332,61,158,0.9995818587288505,0.9984443475944892,0.998758076999226,0.9990127793592151,0.9985233032709285,164947,69,55490,257
12,3,SAFARI,Mid,125,0.55,164947,254,164947,3,8,55332,61,158,0.9995818587288505,0.9984443475944892,0.998758076999226,0.9990127793592151,0.9985233032709285,164947,69,55490,257
12,3,vg giraffe,Mid,125,0.5,150024,234,150024,2,8,50375,58,141,0.9995602638416949,0.9984293890589645,0.9986951880115456,0.9989945064091894,0.9984963304488105,150024,66,50516,236
12,3,SAFARI,Mid,125,0.5,150024,234,150024,2,8,50375,58,141,0.9995602638416949,0.9984293890589645,0.9986951880115456,0.9989945064091894,0.9984963304488105,150024,66,50516,236
12,3,vg giraffe,Mid,125,0.65,195117,305,195117,3,9,65453,72,199,0.9995850367319338,0.9984239478060637,0.9987677422299301,0.9990041549012731,0.998510480245675,195117,81,65652,308
12,3,SAFARI,Mid,125,0.65,195117,305,195117,3,9,65453,73,198,0.9995799158807166,0.9984239478060637,0.9987525291710404,0.9990015974440893,0.9985066511460495,195117,82,65651,308
12,3,vg giraffe,Mid,125,0.6,180028,277,180028,3,9,60351,67,178,0.9995780215875272,0.9984471016261064,0.998745978054616,0.9990122415457864,0.9985222881289096,180028,76,60529,280
12,3,SAFARI,Mid,125,0.6,180028,277,180028,3,9,60351,68,177,0.9995724716137808,0.9984471016261064,0.9987294777658609,0.9990094696917148,0.9985181372528672,180028,77,60528,280
12,3,vg giraffe,Mid,125,0.75,224916,347,224916,3,10,75403,79,229,0.9996044532343725,0.9984462812852362,0.9988246325325867,0.9990250315920856,0.9985414652460073,224916,89,75632,350
12,3,SAFARI,Mid,125,0.75,224916,347,224916,3,10,75403,80,228,0.9996000106663823,0.9984462812852362,0.9988114261565484,0.9990228128775497,0.9985381428433786,224916,90,75631,350
12,3,vg giraffe,Mid,125,0.7,210093,327,210093,3,9,70480,75,221,0.9996003368589332,0.9984317303716799,0.998813307904217,0.9990156918687589,0.9985277801485022,210093,84,70701,330
12,3,SAFARI,Mid,125,0.7,210093,327,210093,3,9,70480,76,220,0.9995955808885801,0.9984317303716799,0.9987991806173624,0.999013316658781,0.9985242240619043,210093,85,70700,330
12,3,vg giraffe,Mid,125,0.85,254876,409,254876,4,12,85275,88,258,0.9996078062248996,0.998382225634477,0.998832225894223,0.9989946400399793,0.9984952569796024,254876,100,85533,413
12,3,SAFARI,Mid,125,0.85,254877,409,254877,3,12,85275,89,257,0.9996038873942066,0.9983861427636913,0.9988205481531652,0.9989946439805043,0.9984952569796024,254877,101,85532,412
12,3,vg giraffe,Mid,125,0.8,239754,383,239754,4,12,80285,86,242,0.9995914147057352,0.9983884467875124,0.998784496124031,0.9989895685978754,0.9984879943634923,239754,98,80527,387
12,3,SAFARI,Mid,125,0.8,239755,383,239755,3,12,80285,87,241,0.9995872489097535,0.9983926110076996,0.9987720930232559,0.99898957280805,0.9984879943634923,239755,99,80526,386
12,3,vg giraffe,Mid,125,0.95,284712,453,284712,4,12,95201,96,286,0.9996208131451443,0.9983974415171355,0.9988702337988389,0.9990087528004926,0.9985161412318392,284712,108,95487,457
12,3,SAFARI,Mid,125,0.95,284713,453,284713,3,12,95201,97,285,0.9996173048430248,0.9984009482096581,0.99885977300068,0.999008756278608,0.9985161412318392,284713,109,95486,456
12,3,vg giraffe,Mid,125,0.9,269737,427,269737,4,12,90223,90,272,0.9996219968203262,0.9984046963370939,0.9988741349051293,0.9990129757577216,0.9985225839535432,269737,102,90495,431
12,3,SAFARI,Mid,125,0.9,269738,427,269738,3,12,90223,91,271,0.9996182937359408,0.998408397737704,0.9988630970120423,0.999012979413306,0.9985225839535432,269738,103,90494,430
12,3,vg giraffe,None,125,0.15,44827,73,44827,0,0,14958,17,41,0.9996209080367496,0.9983741648106904,0.998867874267448,0.9989971474416117,0.9984978970558782,44827,17,14999,73
12,3,SAFARI,None,125,0.15,44827,73,44827,0,0,14958,17,41,0.9996209080367496,0.9983741648106904,0.998867874267448,0.9989971474416117,0.9984978970558782,44827,17,14999,73
12,3,vg giraffe,None,125,0.1,29878,47,29878,0,0,10014,11,26,0.9996319716283583,0.9984294068504594,0.9989055815341757,0.9990303273481125,0.9985491294776866,29878,11,10040,47
12,3,SAFARI,None,125,0.1,29878,47,29878,0,0,10014,11,26,0.9996319716283583,0.9984294068504594,0.9989055815341757,0.9990303273481125,0.9985491294776866,29878,11,10040,47
12,3,vg giraffe,None,125,0.25,74769,114,74769,0,0,24988,37,77,0.9995053872684009,0.9984776250951485,0.9985260138634372,0.9989912418414179,0.9984897734660199,74769,37,25065,114
12,3,SAFARI,None,125,0.25,74769,114,74769,0,0,24988,37,77,0.9995053872684009,0.9984776250951485,0.9985260138634372,0.9989912418414179,0.9984897734660199,74769,37,25065,114
12,3,vg giraffe,None,125,0.2,59811,92,59811,0,0,19912,25,57,0.9995821913229493,0.9984641837637513,0.9987496248874662,0.9990228747525867,0.9985356146038024,59811,25,19969,92
12,3,SAFARI,None,125,0.2,59811,92,59811,0,0,19912,25,57,0.9995821913229493,0.9984641837637513,0.9987496248874662,0.9990228747525867,0.9985356146038024,59811,25,19969,92
12,3,vg giraffe,None,125,0.35,104628,158,104628,0,2,35010,42,107,0.9995796392540508,0.9984921649838719,0.9987486135206621,0.9990356061835786,0.9985565964257898,104628,44,35117,158
12,3,SAFARI,None,125,0.35,104628,158,104628,0,2,35010,42,107,0.9995796392540508,0.9984921649838719,0.9987486135206621,0.9990356061835786,0.9985565964257898,104628,44,35117,158
12,3,vg giraffe,None,125,0.3,89521,136,89521,0,1,29886,41,94,0.999531056351395,0.9984831078443401,0.9986010259143295,0.9990068072759737,0.9985126881073538,89521,42,29980,136
12,3,SAFARI,None,125,0.3,89521,136,89521,0,1,29886,41,94,0.999531056351395,0.9984831078443401,0.9986010259143295,0.9990068072759737,0.9985126881073538,89521,42,29980,136
12,3,vg giraffe,None,125,0.45,134935,208,134935,0,6,45251,49,146,0.9995925624120305,0.9984608895762267,0.9987899322362053,0.9990264055113592,0.99854370276032,134935,55,45397,208
12,3,SAFARI,None,125,0.45,134935,208,134935,0,6,45251,49,146,0.9995925624120305,0.9984608895762267,0.9987899322362053,0.9990264055113592,0.99854370276032,134935,55,45397,208
12,3,vg giraffe,None,125,0.4,119590,182,119590,0,4,40040,46,121,0.9995820795720495,0.9984804461810773,0.9987565591504812,0.9990309591833325,0.9985498459211292,119590,50,40161,182
12,3,SAFARI,None,125,0.4,119590,182,119590,0,4,40040,46,121,0.9995820795720495,0.9984804461810773,0.9987565591504812,0.9990309591833325,0.9985498459211292,119590,50,40161,182
12,3,vg giraffe,None,125,0.55,164947,256,164947,0,6,55334,59,167,0.9996060892541149,0.9984503913367191,0.9988302199186553,0.9990279060612026,0.9985459915114894,164947,65,55501,256
12,3,SAFARI,None,125,0.55,164947,256,164947,0,6,55334,59,167,0.9996060892541149,0.9984503913367191,0.9988302199186553,0.9990279060612026,0.9985459915114894,164947,65,55501,256
12,3,vg giraffe,None,125,0.5,150025,234,150025,0,6,50377,55,153,0.9995935663552896,0.9984426889570674,0.9987942519420451,0.9990177962010355,0.9985312422205626,150025,61,50530,234
12,3,SAFARI,None,125,0.5,150025,234,150025,0,6,50377,55,153,0.9995935663552896,0.9984426889570674,0.9987942519420451,0.9990177962010355,0.9985312422205626,150025,61,50530,234
12,3,vg giraffe,None,125,0.65,195117,310,195117,0,6,65458,69,202,0.9996157629411041,0.9984137299349629,0.9988590552977865,0.9990143848609514,0.9985258192233173,195117,75,65660,310
12,3,SAFARI,None,125,0.65,195117,310,195117,0,6,65458,69,202,0.9996157629411041,0.9984137299349629,0.9988590552977865,0.9990143848609514,0.9985258192233173,195117,75,65660,310
12,3,vg giraffe,None,125,0.6,180021,286,180021,0,6,60354,63,186,0.9996168582375479,0.998413816435302,0.9988615552145721,0.9990149751524013,0.9985264573544306,180021,69,60540,286
12,3,SAFARI,None,125,0.6,180021,286,180021,0,6,60354,63,186,0.9996168582375479,0.998413816435302,0.9988615552145721,0.9990149751524013,0.9985264573544306,180021,69,60540,286
12,3,vg giraffe,None,125,0.75,224915,357,224915,0,6,75409,75,232,0.9996399935998862,0.9984152491210625,0.9989302976677847,0.9990272459957181,0.9985448214914583,224915,81,75641,357
12,3,SAFARI,None,125,0.75,224915,357,224915,0,6,75409,75,232,0.9996399935998862,0.9984152491210625,0.9989302976677847,0.9990272459957181,0.9985448214914583,224915,81,75641,357
12,3,vg giraffe,None,125,0.7,210099,330,210099,0,6,70485,72,223,0.9996288842261523,0.9984317750880345,0.9988980871923827,0.9990299710417826,0.9985491527834575,210099,78,70708,330
12,3,SAFARI,None,125,0.7,210099,330,210099,0,6,70485,72,223,0.9996288842261523,0.9984317750880345,0.9988980871923827,0.9990299710417826,0.9985491527834575,210099,78,70708,330
12,3,vg giraffe,None,125,0.85,254885,410,254885,0,7,85284,90,254,0.9996195809900307,0.9983940147672301,0.9988672855724879,0.9990064220021676,0.9985128912093392,254885,97,85538,410
12,3,SAFARI,None,125,0.85,254885,410,254885,0,7,85284,90,254,0.9996195809900307,0.9983940147672301,0.9988672855724879,0.9990064220021676,0.9985128912093392,254885,97,85538,410
12,3,vg giraffe,None,125,0.8,239763,384,239763,0,6,80293,85,245,0.9996206025332077,0.9984009794001174,0.9988713738233141,0.9990104187282943,0.998519215901439,239763,91,80538,384
12,3,SAFARI,None,125,0.8,239763,384,239763,0,6,80293,85,245,0.9996206025332077,0.9984009794001174,0.9988713738233141,0.9990104187282943,0.998519215901439,239763,91,80538,384
12,3,vg giraffe,None,125,0.95,284713,461,284713,0,9,95209,99,280,0.9996208144764607,0.9983834430908849,0.9988702574348567,0.9990017456293476,0.9985056635090382,284713,108,95489,461
12,3,SAFARI,None,125,0.95,284713,461,284713,0,9,95209,99,280,0.9996208144764607,0.9983834430908849,0.9988702574348567,0.9990017456293476,0.9985056635090382,284713,108,95489,461
12,3,vg giraffe,None,125,0.9,269733,440,269733,0,7,90231,93,267,0.9996294004069184,0.9983714138718525,0.9988962228746772,0.9990000111109877,0.9985032056345993,269733,100,90498,440
12,3,SAFARI,None,125,0.9,269733,440,269733,0,7,90231,93,267,0.9996294004069184,0.9983714138718525,0.9988962228746772,0.9990000111109877,0.9985032056345993,269733,100,90498,440
12,3,vg giraffe,Single-stranded,125,0.15,44833,67,44833,0,0,14958,19,38,0.9995763845536431,0.9985077951002227,0.9987345987345987,0.9990418040823603,0.9985646332304098,44833,19,14996,67
12,3,SAFARI,Single-stranded,125,0.15,44833,67,44833,0,0,14958,19,38,0.9995763845536431,0.9985077951002227,0.9987345987345987,0.9990418040823603,0.9985646332304098,44833,19,14996,67
12,3,vg giraffe,Single-stranded,125,0.1,29883,42,29883,0,0,10014,12,18,0.9995985950827898,0.9985964912280701,0.998805256869773,0.9990972918756269,0.9986489529385274,29883,12,10032,42
12,3,SAFARI,Single-stranded,125,0.1,29883,42,29883,0,0,10014,12,18,0.9995985950827898,0.9985964912280701,0.998805256869773,0.9990972918756269,0.9986489529385274,29883,12,10032,42
12,3,vg giraffe,Single-stranded,125,0.25,74761,121,74761,0,0,24987,37,73,0.9995053343672291,0.9983841243556529,0.9985257202056023,0.9989444147514698,0.9984196681303074,74761,37,25060,121
12,3,SAFARI,Single-stranded,125,0.25,74761,121,74761,0,0,24987,37,73,0.9995053343672291,0.9983841243556529,0.9985257202056023,0.9989444147514698,0.9984196681303074,74761,37,25060,121
12,3,vg giraffe,Single-stranded,125,0.2,59804,99,59804,0,0,19911,26,50,0.9995654354003009,0.9983473281805586,0.9986991544503927,0.9989560104565993,0.9984353486043309,59804,26,19961,99
12,3,SAFARI,Single-stranded,125,0.2,59804,99,59804,0,0,19911,26,50,0.9995654354003009,0.9983473281805586,0.9986991544503927,0.9989560104565993,0.9984353486043309,59804,26,19961,99
12,3,vg giraffe,Single-stranded,125,0.35,104621,164,104621,0,3,35007,42,96,0.9995700609558023,0.9984348904900511,0.9987196995561625,0.9990021532482538,0.9985064280762936,104621,45,35103,164
12,3,SAFARI,Single-stranded,125,0.35,104621,164,104621,0,3,35007,42,96,0.9995700609558023,0.9984348904900511,0.9987196995561625,0.9990021532482538,0.9985064280762936,104621,45,35103,164
12,3,vg giraffe,Single-stranded,125,0.3,89516,140,89516,0,1,29884,41,85,0.9995310301703924,0.9984384759525297,0.9986005131451801,0.9989844543395047,0.9984791128715519,89516,42,29969,140
12,3,SAFARI,Single-stranded,125,0.3,89516,140,89516,0,1,29884,41,85,0.9995310301703924,0.9984384759525297,0.9986005131451801,0.9989844543395047,0.9984791128715519,89516,42,29969,140
12,3,vg giraffe,Single-stranded,125,0.45,134929,217,134929,0,5,45250,48,133,0.9996073550547481,0.9983943290959407,0.9988335240778238,0.9990004738494344,0.9985048343688739,134929,53,45383,217
12,3,SAFARI,Single-stranded,125,0.45,134929,217,134929,0,5,45250,48,133,0.9996073550547481,0.9983943290959407,0.9988335240778238,0.9990004738494344,0.9985048343688739,134929,53,45383,217
12,3,vg giraffe,Single-stranded,125,0.4,119584,191,119584,0,5,40037,45,112,0.9995820586121003,0.9984053433521185,0.9987561879648748,0.9989933544687125,0.9984935051945941,119584,50,40149,191
12,3,SAFARI,Single-stranded,125,0.4,119584,191,119584,0,5,40037,45,112,0.9995820586121003,0.9984053433521185,0.9987561879648748,0.9989933544687125,0.9984935051945941,119584,50,40149,191
12,3,vg giraffe,Single-stranded,125,0.55,164947,258,164947,0,5,55334,59,155,0.9996121470689833,0.998438303925426,0.9988479470055622,0.9990248806841583,0.998541389213528,164947,64,55489,258
12,3,SAFARI,Single-stranded,125,0.55,164947,258,164947,0,5,55334,59,155,0.9996121470689833,0.998438303925426,0.9988479470055622,0.9990248806841583,0.998541389213528,164947,64,55489,258
12,3,vg giraffe,Single-stranded,125,0.5,150022,239,150022,0,5,50376,54,145,0.9996068789520326,0.9984094342510698,0.9988335310399368,0.9990077977772007,0.9985162392141047,150022,59,50521,239
12,3,SAFARI,Single-stranded,125,0.5,150022,239,150022,0,5,50376,54,145,0.9996068789520326,0.9984094342510698,0.9988335310399368,0.9990077977772007,0.9985162392141047,150022,59,50521,239
12,3,vg giraffe,Single-stranded,125,0.65,195131,300,195131,0,6,65457,72,195,0.999600428258943,0.9984649313568472,0.998813327247832,0.9990323571574852,0.9985526169680772,195131,78,65652,300
12,3,SAFARI,Single-stranded,125,0.65,195131,300,195131,0,6,65457,72,195,0.999600428258943,0.9984649313568472,0.998813327247832,0.9990323571574852,0.9985526169680772,195131,78,65652,300
12,3,vg giraffe,Single-stranded,125,0.6,180033,276,180033,0,5,60354,67,177,0.9996002331973016,0.9984692943779845,0.9988119400029701,0.9990344437230518,0.9985554891412632,180033,72,60531,276
12,3,SAFARI,Single-stranded,125,0.6,180033,276,180033,0,5,60354,67,177,0.9996002331973016,0.9984692943779845,0.9988119400029701,0.9990344437230518,0.9985554891412632,180033,72,60531,276
12,3,vg giraffe,Single-stranded,125,0.75,224919,357,224919,0,7,75407,82,227,0.999604458508142,0.9984152772598945,0.9988246635764563,0.9990095139956117,0.9985182675025498,224919,89,75634,357
12,3,SAFARI,Single-stranded,125,0.75,224919,357,224919,0,7,75407,82,227,0.999604458508142,0.9984152772598945,0.9988246635764563,0.9990095139956117,0.9985182675025498,224919,89,75634,357
12,3,vg giraffe,Single-stranded,125,0.7,210098,335,210098,0,6,70484,77,216,0.9996051022689967,0.9984080443656651,0.9988274020598166,0.9990062147241889,0.9985135980883022,210098,83,70700,335
12,3,SAFARI,Single-stranded,125,0.7,210098,335,210098,0,6,70484,77,216,0.9996051022689967,0.9984080443656651,0.9988274020598166,0.9990062147241889,0.9985135980883022,210098,83,70700,335
12,3,vg giraffe,Single-stranded,125,0.85,254891,407,254891,0,8,85284,94,253,0.9995999890193065,0.9984057846124921,0.9988089538644777,0.9990025299290012,0.9985070555557185,254891,102,85537,407
12,3,SAFARI,Single-stranded,125,0.85,254891,407,254891,0,8,85284,94,253,0.9995999890193065,0.9984057846124921,0.9988089538644777,0.9990025299290012,0.9985070555557185,254891,102,85537,407
12,3,vg giraffe,Single-stranded,125,0.8,239768,383,239768,0,8,80292,90,240,0.9995914385531922,0.998405170080491,0.9987845714994419,0.9989979521558613,0.9985005346326622,239768,98,80532,383
12,3,SAFARI,Single-stranded,125,0.8,239768,383,239768,0,8,80292,90,240,0.9995914385531922,0.998405170080491,0.9987845714994419,0.9989979521558613,0.9985005346326622,239768,98,80532,383
12,3,vg giraffe,Single-stranded,125,0.95,284720,457,284720,0,9,95210,100,287,0.999617314248198,0.9983974864733131,0.9988599041901136,0.9990070279961965,0.9985135891045556,284720,109,95497,457
12,3,SAFARI,Single-stranded,125,0.95,284720,457,284720,0,9,95210,100,287,0.999617314248198,0.9983974864733131,0.9988599041901136,0.9990070279961965,0.9985135891045556,284720,109,95497,457
12,3,vg giraffe,Single-stranded,125,0.9,269747,429,269747,0,8,90231,96,268,0.9996146021322878,0.9984121461565794,0.998852135139013,0.9990130123123473,0.9985226412845537,269747,104,90499,429
12,3,SAFARI,Single-stranded,125,0.9,269747,429,269747,0,8,90231,96,268,0.9996146021322878,0.9984121461565794,0.998852135139013,0.9990130123123473,0.9985226412845537,269747,104,90499,429
12,5,vg giraffe,High,125,0.15,44400,73,44400,423,0,14956,16,42,0.9996397694524496,0.9889522451888809,0.9989343279605701,0.994267287710498,0.9914538474378234,44400,16,14998,496
12,5,SAFARI,High,125,0.15,44460,73,44460,363,0,14956,17,41,0.9996177799761674,0.9902886671418389,0.9988677234581058,0.9949313551072471,0.9924386579869805,44460,17,14997,436
12,5,vg giraffe,High,125,0.1,29610,48,29610,265,0,10014,11,26,0.9996286418419364,0.989539818868429,0.9989055815341757,0.9945586457073761,0.9918947315755241,29610,11,10040,313
12,5,SAFARI,High,125,0.1,29642,48,29642,233,0,10014,11,26,0.9996290425926551,0.9906092303579187,0.9989055815341757,0.9950986974620651,0.992695251913744,29642,11,10040,281
12,5,vg giraffe,High,125,0.25,74026,128,74026,726,1,24985,33,81,0.9995409127734269,0.9885950854700855,0.9986454183266932,0.9940378675976903,0.9911182236447289,74026,34,25066,854
12,5,SAFARI,High,125,0.25,74137,129,74137,614,1,24985,35,79,0.9995146481873458,0.9900774572649572,0.9985657370517929,0.9947736711102763,0.9922084416883377,74137,36,25064,743
12,5,vg giraffe,High,125,0.2,59231,93,59231,576,0,19910,24,58,0.9995949708885327,0.9888313856427379,0.9987995198079231,0.9941840459905166,0.991325789816252,59231,24,19968,669
12,5,SAFARI,High,125,0.2,59318,94,59318,488,0,19910,26,56,0.9995618765165812,0.9902838063439066,0.9986994797919168,0.9949012109623965,0.9923897261302759,59318,26,19966,582
12,5,vg giraffe,High,125,0.35,103581,180,103581,1025,2,35008,37,112,0.9996236247828605,0.9885003721871243,0.998890753434398,0.9940308820283487,0.991110793526028,103581,39,35120,1205
12,5,SAFARI,High,125,0.35,103716,181,103716,889,2,35008,39,110,0.9996048459381054,0.9897887122325502,0.9988338689951364,0.994672561534072,0.9920611668869913,103716,41,35118,1070
12,5,vg giraffe,High,125,0.3,88638,148,88638,870,1,29884,36,99,0.9995827459825204,0.9886454894262514,0.998767488341106,0.9940840347443798,0.9911845315685684,88638,37,29983,1018
12,5,SAFARI,High,125,0.3,88760,149,88760,747,1,29884,38,97,0.9995608058649309,0.9900062460961899,0.9987008660892738,0.9947605839007032,0.9921872388783047,88760,39,29981,896
12,5,vg giraffe,High,125,0.45,133563,227,133563,1355,2,45253,43,152,0.9996631938207293,0.988294054534019,0.999009900990099,0.9939461140898892,0.9909908912206872,133563,45,45405,1582
12,5,SAFARI,High,125,0.45,133747,228,133747,1170,2,45253,45,150,0.9996487136941866,0.9896555551444745,0.998965896589659,0.9946270343832617,0.9919986710595532,133747,47,45403,1398
12,5,vg giraffe,High,125,0.4,118387,198,118387,1188,2,40040,40,127,0.9996453571338101,0.9884281098411161,0.9989554577333433,0.9940050881184875,0.9910739958245303,118387,42,40167,1386
12,5,SAFARI,High,125,0.4,118555,199,118555,1019,2,40040,42,125,0.9996290019308763,0.9898307631937081,0.9989057176254073,0.9947057540315138,0.9921116125564126,118555,44,40165,1218
12,5,vg giraffe,High,125,0.55,163295,270,163295,1639,2,55336,49,177,0.9996877793150736,0.9884445897193772,0.9990821395147937,0.9940343935474052,0.9911219017248877,163295,51,55513,1909
12,5,SAFARI,High,125,0.55,163509,272,163509,1423,2,55336,51,175,0.999675963854685,0.9897399578702695,0.9990461449859621,0.9946831485007573,0.9920821858240325,163509,53,55511,1695
12,5,vg giraffe,High,125,0.5,148519,244,148519,1499,2,50379,47,161,0.9996701846965699,0.988400260877667,0.9990314099903141,0.9940032794565472,0.9910779632663019,148519,49,50540,1743
12,5,SAFARI,High,125,0.5,148729,246,148729,1287,2,50379,49,159,0.999657211990859,0.9897978198080686,0.9989918757042044,0.9947030851853587,0.992113556815749,148729,51,50538,1533
12,5,vg giraffe,High,125,0.65,193173,319,193173,1929,2,65460,60,211,0.999679147152431,0.9884966303519069,0.9990567903488354,0.9940564406570336,0.991154644386071,193173,62,65671,2248
12,5,SAFARI,High,125,0.65,193424,321,193424,1676,2,65460,62,209,0.9996692301331349,0.9897810368384156,0.999026364231056,0.994700559771052,0.9921081047964037,193424,64,65669,1997
12,5,vg giraffe,High,125,0.6,178224,296,178224,1786,2,60356,54,195,0.9996858873681849,0.9884529632957306,0.9990760143217781,0.9940376924921777,0.9911254270213729,178224,56,60551,2082
12,5,SAFARI,High,125,0.6,178457,298,178457,1551,2,60356,56,193,0.9996750973307565,0.9897452109192151,0.9990430148332701,0.994685372372297,0.9920842793871647,178457,58,60549,1849
12,5,vg giraffe,High,125,0.75,222653,368,222653,2239,2,75411,63,244,0.9997081511148628,0.9884267069164521,0.9991415742208135,0.9940354213822999,0.991122333709881,222653,65,75655,2607
12,5,SAFARI,High,125,0.75,222942,370,222942,1948,2,75411,65,242,0.9996995636947388,0.9897096688271331,0.9991151611199155,0.9946795339405581,0.9920758854408931,222942,67,75653,2318
12,5,vg giraffe,High,125,0.7,207984,347,207984,2086,2,70487,62,233,0.9996923786818427,0.9884372460400063,0.9990958408679927,0.9940329537715221,0.9911202307246418,207984,64,70720,2433
12,5,SAFARI,High,125,0.7,208252,349,208252,1816,2,70487,64,231,0.9996831766818037,0.9897109073886615,0.9990675858951176,0.9946720479539566,0.9920661733066383,208252,66,70718,2165
12,5,vg giraffe,High,125,0.85,252340,423,252340,2520,3,85284,72,272,0.9997028702731613,0.9884716177732163,0.9991241489647441,0.9940555211956714,0.9911473274784843,252340,75,85556,2943
12,5,SAFARI,High,125,0.85,252631,425,252631,2227,3,85284,74,270,0.9996953005049306,0.9896115291656711,0.9991007929371373,0.994627857580154,0.9919950486046334,252631,77,85554,2652
12,5,vg giraffe,High,125,0.8,237366,392,237366,2377,3,80294,69,261,0.9996967629444318,0.9884689861952651,0.9991069988961514,0.9940511712345547,0.9911429658126586,237366,72,80555,2769
12,5,SAFARI,High,125,0.8,237662,394,237662,2079,3,80294,71,259,0.9996887303563616,0.9897016261686135,0.9990821933099334,0.9946701097158019,0.9920595332364807,237662,74,80553,2473
12,5,vg giraffe,High,125,0.95,281891,464,281891,2809,3,95212,78,301,0.9997127374349226,0.9885223941310964,0.9991526664853443,0.9940860745923377,0.9911912553380362,281891,81,95513,3273
12,5,SAFARI,High,125,0.95,282216,467,282216,2481,3,95212,80,299,0.9997059854976461,0.989662089183768,0.9991317446701676,0.9946586825925214,0.9920395631871163,282216,83,95511,2948
12,5,vg giraffe,High,125,0.9,267044,448,267044,2671,3,90232,74,286,0.999711741121065,0.9884551178362693,0.9991500634692864,0.9940515630467314,0.9911408756008183,267044,77,90518,3119
12,5,SAFARI,High,125,0.9,267348,451,267348,2364,3,90232,76,284,0.9997045922812581,0.9895803644466489,0.9991279871957613,0.9946167153406872,0.9919780018738323,267348,79,90516,2815
12,5,vg giraffe,Mid,125,0.15,44836,60,44836,2,2,14954,22,38,0.9994650022291574,0.9986190921644617,0.9984017048481619,0.9990418681343166,0.9985646092732917,44836,24,14992,62
12,5,SAFARI,Mid,125,0.15,44835,61,44835,2,2,14954,22,38,0.9994649903029492,0.9985968194574368,0.9984017048481619,0.9990307162672548,0.9985479186834463,44835,24,14992,63
12,5,vg giraffe,Mid,125,0.1,29880,44,29880,1,0,10014,17,19,0.9994313810750243,0.9984962406015038,0.9983084577114428,0.9989635919895691,0.9984490306441526,29880,17,10033,45
12,5,SAFARI,Mid,125,0.1,29880,44,29880,1,0,10014,17,19,0.9994313810750243,0.9984962406015038,0.9983084577114428,0.9989635919895691,0.9984490306441526,29880,17,10033,45
12,5,vg giraffe,Mid,125,0.25,74775,104,74775,2,3,24983,42,69,0.9993985565356857,0.998584420614041,0.9982069570068136,0.9989913227032552,0.9984896677269,74775,45,25052,106
12,5,SAFARI,Mid,125,0.25,74774,105,74774,2,3,24983,42,69,0.9993985484970396,0.9985710660915319,0.9982069570068136,0.9989846359385437,0.9984796655264158,74774,45,25052,107
12,5,vg giraffe,Mid,125,0.2,59818,81,59818,2,2,19908,30,50,0.9994653299916458,0.9986143803943173,0.9983991995998,0.9990396739901963,0.9985605387340251,59818,32,19958,83
12,5,SAFARI,Mid,125,0.2,59817,82,59817,2,2,19908,30,50,0.9994653210579959,0.9985976861822007,0.9983991995998,0.9990313152400836,0.9985480216795384,59817,32,19958,84
12,5,vg giraffe,Mid,125,0.35,104625,159,104625,3,5,35005,45,94,0.9995223310246,0.9984540066993043,0.9985774844234544,0.9989878832437387,0.9984850217242168,104625,50,35099,162
12,5,SAFARI,Mid,125,0.35,104624,160,104624,3,5,35005,45,94,0.9995223264612033,0.9984444635307815,0.9985774844234544,0.9989831042532977,0.9984778756002745,104624,50,35099,163
12,5,vg giraffe,Mid,125,0.3,89521,134,89521,2,3,29882,44,85,0.9994752590210789,0.9984831078443401,0.9984340641034184,0.9989789370902497,0.9984708074637966,89521,47,29967,136
12,5,SAFARI,Mid,125,0.3,89520,135,89520,2,3,29882,44,85,0.999475253162437,0.9984719542255485,0.9984340641034184,0.9989733517832433,0.9984624512204293,89520,47,29967,137
12,5,vg giraffe,Mid,125,0.45,134932,209,134932,3,6,45251,53,131,0.999562933825218,0.9984313029065294,0.998701613080698,0.9989967978973476,0.998499321649085,134932,59,45382,212
12,5,SAFARI,Mid,125,0.45,134931,210,134931,3,6,45251,53,131,0.9995629305874509,0.9984239033919375,0.998701613080698,0.9989930923171463,0.9984937840905944,134931,59,45382,213
12,5,vg giraffe,Mid,125,0.4,119591,179,119591,3,6,40036,49,109,0.9995403105828862,0.9984804588680254,0.9986318407960199,0.999010103625861,0.9985184999968745,119591,55,40145,182
12,5,SAFARI,Mid,125,0.4,119590,180,119590,3,6,40036,49,109,0.9995403067407748,0.9984721097409266,0.9986318407960199,0.9990059226958709,0.998512248942009,119590,55,40145,183
12,5,vg giraffe,Mid,125,0.55,164943,254,164943,7,6,55334,61,158,0.9995939640021817,0.9984201351056875,0.9987940747673644,0.9990067047429848,0.9985142437817931,164943,67,55492,261
12,5,SAFARI,Mid,125,0.55,164942,255,164942,7,6,55334,61,158,0.9995939615414917,0.9984140819834871,0.9987940747673644,0.9990036733865717,0.9985097140372254,164942,67,55492,262
12,5,vg giraffe,Mid,125,0.5,150022,234,150022,4,6,50377,58,141,0.9995735778153858,0.9984160787967523,0.9987347277687715,0.9989944930180525,0.9984963304488105,150022,64,50518,238
12,5,SAFARI,Mid,125,0.5,150021,235,150021,4,6,50377,58,141,0.9995735749741813,0.9984094236656462,0.9987347277687715,0.9989911601658094,0.9984913514105616,150021,64,50518,239
12,5,vg giraffe,Mid,125,0.65,195113,305,195113,7,7,65455,71,200,0.9996003914114893,0.9984034795957528,0.9988133814065995,0.999001576996334,0.9985066511460495,195113,78,65655,312
12,5,SAFARI,Mid,125,0.65,195112,306,195112,7,7,65455,72,199,0.9995952682244571,0.9983983625431752,0.9987981683477096,0.9989964568783666,0.9984989929467984,195112,79,65654,313
12,5,vg giraffe,Mid,125,0.6,180024,277,180024,7,7,60353,66,179,0.9995946628761168,0.9984249173636223,0.9987954789208812,0.9990094477046656,0.9985181372528672,180024,73,60532,284
12,5,SAFARI,Mid,125,0.6,180023,278,180023,7,7,60353,67,178,0.9995891103127759,0.9984193712980012,0.9987789786321261,0.9990038983920867,0.9985098355007824,180023,74,60531,285
12,5,vg giraffe,Mid,125,0.75,224910,347,224910,9,8,75405,78,230,0.9996177709825953,0.9984196461072687,0.9988642516607018,0.9990183493166201,0.9985314980381212,224910,86,75635,356
12,5,SAFARI,Mid,125,0.75,224909,348,224909,9,8,75405,79,229,0.999613326459137,0.9984152069109409,0.9988510452846634,0.9990139074583242,0.9985248532328639,224909,87,75634,357
12,5,vg giraffe,Mid,125,0.7,210088,327,210088,8,7,70482,74,222,0.9996145958728452,0.9984079687106447,0.9988556897647807,0.999010917944231,0.9985206679753066,210088,81,70704,335
12,5,SAFARI,Mid,125,0.7,210087,328,210087,8,7,70482,75,221,0.9996098377972013,0.9984032163784378,0.9988415624779261,0.9990061627420399,0.9985135558021109,210087,82,70703,336
12,5,vg giraffe,Mid,125,0.85,254869,409,254869,11,9,85278,84,262,0.9996352397612194,0.9983548057299766,0.9989139700816274,0.9989946124554386,0.9984952569796024,254869,93,85540,420
12,5,SAFARI,Mid,125,0.85,254869,410,254869,10,9,85278,85,261,0.9996313190541373,0.9983548057299766,0.9989022923405696,0.9989926546098791,0.9984923237573404,254869,94,85539,420
12,5,vg giraffe,Mid,125,0.8,239747,383,239747,11,9,80288,82,246,0.9996205772229588,0.9983592972462012,0.9988713178294574,0.99898953912567,0.9984879943634923,239747,91,80534,394
12,5,SAFARI,Mid,125,0.8,239747,384,239747,10,9,80288,83,245,0.9996164093412664,0.9983592972462012,0.9988589147286822,0.9989874578107422,0.9984848768260975,239747,92,80533,394
12,5,vg giraffe,Mid,125,0.95,284704,453,284704,12,9,95204,91,291,0.9996488813359363,0.9983693879769541,0.99895392018411,0.9990087249746918,0.9985161412318392,284704,100,95495,465
12,5,SAFARI,Mid,125,0.95,284704,454,284704,11,9,95204,92,290,0.9996453713944629,0.9983693879769541,0.9989434593859512,0.999006972247857,0.9985135149331344,284704,101,95494,465
12,5,vg giraffe,Mid,125,0.9,269729,427,269729,12,9,90226,86,276,0.9996479186432637,0.9983750851322141,0.9989514001567381,0.9990110964606883,0.9985198120660264,269729,95,90502,439
12,5,SAFARI,Mid,125,0.9,269729,428,269729,11,9,90226,87,275,0.9996442138423052,0.9983750851322141,0.9989403622636511,0.9990092464161574,0.9985170401785095,269729,96,90501,439
12,5,vg giraffe,None,125,0.15,44827,73,44827,0,0,14958,17,41,0.9996209080367496,0.9983741648106904,0.998867874267448,0.9989971474416117,0.9984978970558782,44827,17,14999,73
12,5,SAFARI,None,125,0.15,44827,73,44827,0,0,14958,17,41,0.9996209080367496,0.9983741648106904,0.998867874267448,0.9989971474416117,0.9984978970558782,44827,17,14999,73
12,5,vg giraffe,None,125,0.1,29878,47,29878,0,0,10014,11,26,0.9996319716283583,0.9984294068504594,0.9989055815341757,0.9990303273481125,0.9985491294776866,29878,11,10040,47
12,5,SAFARI,None,125,0.1,29878,47,29878,0,0,10014,11,26,0.9996319716283583,0.9984294068504594,0.9989055815341757,0.9990303273481125,0.9985491294776866,29878,11,10040,47
12,5,vg giraffe,None,125,0.25,74769,114,74769,0,0,24988,37,77,0.9995053872684009,0.9984776250951485,0.9985260138634372,0.9989912418414179,0.9984897734660199,74769,37,25065,114
12,5,SAFARI,None,125,0.25,74769,114,74769,0,0,24988,37,77,0.9995053872684009,0.9984776250951485,0.9985260138634372,0.9989912418414179,0.9984897734660199,74769,37,25065,114
12,5,vg giraffe,None,125,0.2,59811,92,59811,0,0,19912,25,57,0.9995821913229493,0.9984641837637513,0.9987496248874662,0.9990228747525867,0.9985356146038024,59811,25,19969,92
12,5,SAFARI,None,125,0.2,59811,92,59811,0,0,19912,25,57,0.9995821913229493,0.9984641837637513,0.9987496248874662,0.9990228747525867,0.9985356146038024,59811,25,19969,92
12,5,vg giraffe,None,125,0.35,104628,158,104628,0,2,35010,42,107,0.9995796392540508,0.9984921649838719,0.9987486135206621,0.9990356061835786,0.9985565964257898,104628,44,35117,158
12,5,SAFARI,None,125,0.35,104628,158,104628,0,2,35010,42,107,0.9995796392540508,0.9984921649838719,0.9987486135206621,0.9990356061835786,0.9985565964257898,104628,44,35117,158
12,5,vg giraffe,None,125,0.3,89521,136,89521,0,1,29886,41,94,0.999531056351395,0.9984831078443401,0.9986010259143295,0.9990068072759737,0.9985126881073538,89521,42,29980,136
12,5,SAFARI,None,125,0.3,89521,136,89521,0,1,29886,41,94,0.999531056351395,0.9984831078443401,0.9986010259143295,0.9990068072759737,0.9985126881073538,89521,42,29980,136
12,5,vg giraffe,None,125,0.45,134935,208,134935,0,5,45252,49,146,0.9995999674047515,0.9984608895762267,0.9988119334682742,0.9990301038011046,0.9985492400121819,134935,54,45398,208
12,5,SAFARI,None,125,0.45,134935,208,134935,0,5,45252,49,146,0.9995999674047515,0.9984608895762267,0.9988119334682742,0.9990301038011046,0.9985492400121819,134935,54,45398,208
12,5,vg giraffe,None,125,0.4,119590,182,119590,0,3,40041,46,121,0.9995904345572932,0.9984804461810773,0.9987814279674716,0.9990351320532475,0.9985560965852622,119590,49,40162,182
12,5,SAFARI,None,125,0.4,119590,182,119590,0,3,40041,46,121,0.9995904345572932,0.9984804461810773,0.9987814279674716,0.9990351320532475,0.9985560965852622,119590,49,40162,182
12,5,vg giraffe,None,125,0.55,164947,256,164947,0,5,55335,58,168,0.9996182049572753,0.9984503913367191,0.9988662131519275,0.9990339568702625,0.9985550507544084,164947,63,55503,256
12,5,SAFARI,None,125,0.55,164947,256,164947,0,5,55335,58,168,0.9996182049572753,0.9984503913367191,0.9988662131519275,0.9990339568702625,0.9985550507544084,164947,63,55503,256
12,5,vg giraffe,None,125,0.5,150025,234,150025,0,5,50378,54,154,0.999606886810053,0.9984426889570674,0.9988337846652566,0.9990244487136374,0.9985411999004232,150025,59,50532,234
12,5,SAFARI,None,125,0.5,150025,234,150025,0,5,50378,54,154,0.999606886810053,0.9984426889570674,0.9988337846652566,0.9990244487136374,0.9985411999004232,150025,59,50532,234
12,5,vg giraffe,None,125,0.65,195117,310,195117,0,5,65459,67,204,0.9996311267540692,0.9984137299349629,0.9989046930858752,0.999022057468204,0.9985373063462525,195117,72,65663,310
12,5,SAFARI,None,125,0.65,195117,310,195117,0,5,65459,67,204,0.9996311267540692,0.9984137299349629,0.9989046930858752,0.999022057468204,0.9985373063462525,195117,72,65663,310
12,5,vg giraffe,None,125,0.6,180021,286,180021,0,5,60355,61,188,0.9996335104699395,0.998413816435302,0.9989110528139385,0.9990232911757687,0.9985389098274917,180021,66,60543,286
12,5,SAFARI,None,125,0.6,180021,286,180021,0,5,60355,61,188,0.9996335104699395,0.998413816435302,0.9989110528139385,0.9990232911757687,0.9985389098274917,180021,66,60543,286
12,5,vg giraffe,None,125,0.75,224915,357,224915,0,5,75410,73,234,0.9996533225478126,0.9984152491210625,0.9989699162726816,0.9990339022575594,0.9985547884675442,224915,78,75644,357
12,5,SAFARI,None,125,0.75,224915,357,224915,0,5,75410,73,234,0.9996533225478126,0.9984152491210625,0.9989699162726816,0.9990339022575594,0.9985547884675442,224915,78,75644,357
12,5,vg giraffe,None,125,0.7,210099,330,210099,0,5,70486,70,225,0.999643152816238,0.9984317750880345,0.9989404684542141,0.9990370967396809,0.9985598207776968,210099,75,70711,330
12,5,SAFARI,None,125,0.7,210099,330,210099,0,5,70486,70,225,0.999643152816238,0.9984317750880345,0.9989404684542141,0.9990370967396809,0.9985598207776968,210099,75,70711,330
12,5,vg giraffe,None,125,0.85,254885,410,254885,0,6,85285,85,259,0.9996431036646586,0.9983940147672301,0.9989373503824371,0.9990181687769831,0.9985304901299387,254885,91,85544,410
12,5,SAFARI,None,125,0.85,254885,410,254885,0,6,85285,85,259,0.9996431036646586,0.9983940147672301,0.9989373503824371,0.9990181687769831,0.9985304901299387,254885,91,85544,410
12,5,vg giraffe,None,125,0.8,239763,384,239763,0,5,80294,80,250,0.9996456088856276,0.9984009794001174,0.9989457887360627,0.9990229064886093,0.998537920542684,239763,85,80544,384
12,5,SAFARI,None,125,0.8,239763,384,239763,0,5,80294,80,250,0.9996456088856276,0.9984009794001174,0.9989457887360627,0.9990229064886093,0.998537920542684,239763,85,80544,384
12,5,vg giraffe,None,125,0.95,284713,461,284713,0,7,95211,93,286,0.9996488924311742,0.9983834430908849,0.9989539420693118,0.9990157670262656,0.9985266735124261,284713,100,95497,461
12,5,SAFARI,None,125,0.95,284713,461,284713,0,7,95211,93,286,0.9996488924311742,0.9983834430908849,0.9989539420693118,0.9990157670262656,0.9985266735124261,284713,100,95497,461
12,5,vg giraffe,None,125,0.9,269733,440,269733,0,6,90232,88,272,0.9996516286361261,0.9983714138718525,0.9989624495021965,0.9990111111111111,0.9985198366831037,269733,94,90504,440
12,5,SAFARI,None,125,0.9,269733,440,269733,0,6,90232,88,272,0.9996516286361261,0.9983714138718525,0.9989624495021965,0.9990111111111111,0.9985198366831037,269733,94,90504,440
12,5,vg giraffe,Single-stranded,125,0.15,44833,67,44833,0,0,14958,19,38,0.9995763845536431,0.9985077951002227,0.9987345987345987,0.9990418040823603,0.9985646332304098,44833,19,14996,67
12,5,SAFARI,Single-stranded,125,0.15,44833,67,44833,0,0,14958,19,38,0.9995763845536431,0.9985077951002227,0.9987345987345987,0.9990418040823603,0.9985646332304098,44833,19,14996,67
12,5,vg giraffe,Single-stranded,125,0.1,29883,42,29883,0,0,10014,12,18,0.9995985950827898,0.9985964912280701,0.998805256869773,0.9990972918756269,0.9986489529385274,29883,12,10032,42
12,5,SAFARI,Single-stranded,125,0.1,29883,42,29883,0,0,10014,12,18,0.9995985950827898,0.9985964912280701,0.998805256869773,0.9990972918756269,0.9986489529385274,29883,12,10032,42
12,5,vg giraffe,Single-stranded,125,0.25,74761,121,74761,0,0,24987,37,73,0.9995053343672291,0.9983841243556529,0.9985257202056023,0.9989444147514698,0.9984196681303074,74761,37,25060,121
12,5,SAFARI,Single-stranded,125,0.25,74761,121,74761,0,0,24987,37,73,0.9995053343672291,0.9983841243556529,0.9985257202056023,0.9989444147514698,0.9984196681303074,74761,37,25060,121
12,5,vg giraffe,Single-stranded,125,0.2,59804,99,59804,0,0,19911,26,50,0.9995654354003009,0.9983473281805586,0.9986991544503927,0.9989560104565993,0.9984353486043309,59804,26,19961,99
12,5,SAFARI,Single-stranded,125,0.2,59804,99,59804,0,0,19911,26,50,0.9995654354003009,0.9983473281805586,0.9986991544503927,0.9989560104565993,0.9984353486043309,59804,26,19961,99
12,5,vg giraffe,Single-stranded,125,0.35,104621,164,104621,0,3,35007,42,96,0.9995700609558023,0.9984348904900511,0.9987196995561625,0.9990021532482538,0.9985064280762936,104621,45,35103,164
12,5,SAFARI,Single-stranded,125,0.35,104621,164,104621,0,3,35007,42,96,0.9995700609558023,0.9984348904900511,0.9987196995561625,0.9990021532482538,0.9985064280762936,104621,45,35103,164
12,5,vg giraffe,Single-stranded,125,0.3,89516,140,89516,0,1,29884,41,85,0.9995310301703924,0.9984384759525297,0.9986005131451801,0.9989844543395047,0.9984791128715519,89516,42,29969,140
12,5,SAFARI,Single-stranded,125,0.3,89516,140,89516,0,1,29884,41,85,0.9995310301703924,0.9984384759525297,0.9986005131451801,0.9989844543395047,0.9984791128715519,89516,42,29969,140
12,5,vg giraffe,Single-stranded,125,0.45,134929,217,134929,0,4,45251,48,133,0.9996147605959357,0.9983943290959407,0.9988555330574874,0.9990041721116364,0.9985103720193597,134929,52,45384,217
12,5,SAFARI,Single-stranded,125,0.45,134929,217,134929,0,4,45251,48,133,0.9996147605959357,0.9983943290959407,0.9988555330574874,0.9990041721116364,0.9985103720193597,134929,52,45384,217
12,5,vg giraffe,Single-stranded,125,0.4,119584,191,119584,0,4,40038,45,112,0.9995904140161995,0.9984053433521185,0.9987810642055772,0.9989975272338435,0.9984997562103842,119584,49,40150,191
12,5,SAFARI,Single-stranded,125,0.4,119584,191,119584,0,4,40038,45,112,0.9995904140161995,0.9984053433521185,0.9987810642055772,0.9989975272338435,0.9984997562103842,119584,49,40150,191
12,5,vg giraffe,Single-stranded,125,0.55,164947,258,164947,0,4,55335,58,156,0.9996242629189923,0.998438303925426,0.9988839486616384,0.9990309314565705,0.9985504489078538,164947,62,55491,258
12,5,SAFARI,Single-stranded,125,0.55,164947,258,164947,0,4,55335,58,156,0.9996242629189923,0.998438303925426,0.9988839486616384,0.9990309314565705,0.9985504489078538,164947,62,55491,258
12,5,vg giraffe,Single-stranded,125,0.5,150022,239,150022,0,4,50377,53,146,0.9996202000279852,0.9984094342510698,0.9988730723606168,0.9990144502896717,0.9985261973401846,150022,57,50523,239
12,5,SAFARI,Single-stranded,125,0.5,150022,239,150022,0,4,50377,53,146,0.9996202000279852,0.9984094342510698,0.9988730723606168,0.9990144502896717,0.9985261973401846,150022,57,50523,239
12,5,vg giraffe,Single-stranded,125,0.65,195131,300,195131,0,4,65459,70,197,0.9996209113496068,0.9984649313568472,0.9988741822607637,0.9990425869607512,0.9985679331906372,195131,74,65656,300
12,5,SAFARI,Single-stranded,125,0.65,195131,300,195131,0,4,65459,70,197,0.9996209113496068,0.9984649313568472,0.9988741822607637,0.9990425869607512,0.9985679331906372,195131,74,65656,300
12,5,vg giraffe,Single-stranded,125,0.6,180033,276,180033,0,4,60355,65,179,0.999616883765866,0.9984692943779845,0.9988614425028464,0.9990427595162189,0.9985679418210799,180033,69,60534,276
12,5,SAFARI,Single-stranded,125,0.6,180033,276,180033,0,4,60355,65,179,0.999616883765866,0.9984692943779845,0.9988614425028464,0.9990427595162189,0.9985679418210799,180033,69,60534,276
12,5,vg giraffe,Single-stranded,125,0.75,224919,357,224919,0,5,75409,80,229,0.9996222289381522,0.9984152772598945,0.9988774876853797,0.9990183885582304,0.9985315565832444,224919,85,75638,357
12,5,SAFARI,Single-stranded,125,0.75,224919,357,224919,0,5,75409,80,229,0.9996222289381522,0.9984152772598945,0.9988774876853797,0.9990183885582304,0.9985315565832444,224919,85,75638,357
12,5,vg giraffe,Single-stranded,125,0.7,210098,335,210098,0,4,70486,75,218,0.9996241263316157,0.9984080443656651,0.9988839128039219,0.9990157152706783,0.998527822030041,210098,79,70704,335
12,5,SAFARI,Single-stranded,125,0.7,210098,335,210098,0,4,70486,75,218,0.9996241263316157,0.9984080443656651,0.9988839128039219,0.9990157152706783,0.998527822030041,210098,79,70704,335
12,5,vg giraffe,Single-stranded,125,0.85,254891,407,254891,0,6,85286,89,258,0.9996274305255974,0.9984057846124921,0.9988906923247586,0.9990162340970911,0.9985275872081939,254891,95,85544,407
12,5,SAFARI,Single-stranded,125,0.85,254891,407,254891,0,6,85286,89,258,0.9996274305255974,0.9984057846124921,0.9988906923247586,0.9990162340970911,0.9985275872081939,254891,95,85544,407
12,5,vg giraffe,Single-stranded,125,0.8,239768,383,239768,0,6,80294,85,245,0.999620610441968,0.998405170080491,0.9988713878209103,0.9990125205724881,0.9985223563739748,239768,91,80539,383
12,5,SAFARI,Single-stranded,125,0.8,239768,383,239768,0,6,80294,85,245,0.999620610441968,0.998405170080491,0.9988713878209103,0.9990125205724881,0.9985223563739748,239768,91,80539,383
12,5,vg giraffe,Single-stranded,125,0.95,284720,457,284720,0,7,95212,94,293,0.9996453913159493,0.9983974864733131,0.9989435809468025,0.9990210491966638,0.998534598445834,284720,101,95505,457
12,5,SAFARI,Single-stranded,125,0.95,284720,457,284720,0,7,95212,94,293,0.9996453913159493,0.9983974864733131,0.9989435809468025,0.9990210491966638,0.998534598445834,284720,101,95505,457
12,5,vg giraffe,Single-stranded,125,0.9,269747,429,269747,0,6,90233,91,273,0.9996405330487245,0.9984121461565794,0.9989293952738871,0.9990259620014073,0.9985420437442313,269747,97,90506,429
12,5,SAFARI,Single-stranded,125,0.9,269747,429,269747,0,6,90233,91,273,0.9996405330487245,0.9984121461565794,0.9989293952738871,0.9990259620014073,0.9985420437442313,269747,97,90506,429
12,7,vg giraffe,High,125,0.15,44138,71,44138,687,0,14956,15,43,0.9996602722351822,0.9831165359942979,0.9990009324630345,0.9913193859560466,0.9870973126356201,44138,15,14999,758
12,7,SAFARI,High,125,0.15,44190,71,44190,635,0,14956,15,43,0.999660671869698,0.9842747683535281,0.9990009324630345,0.9919080593932729,0.9879652812552162,44190,15,14999,706
12,7,vg giraffe,High,125,0.1,29416,46,29416,461,0,10014,11,26,0.9996261936316988,0.9830565117133977,0.9989055815341757,0.9912721145745577,0.9870415770250663,29416,11,10040,507
12,7,SAFARI,High,125,0.1,29447,46,29447,430,0,10014,11,26,0.9996265870052278,0.9840925040938409,0.9989055815341757,0.991798723497415,0.9878170811027168,29447,11,10040,476
12,7,vg giraffe,High,125,0.25,73557,125,73557,1198,1,24985,31,83,0.9995651524004946,0.9823317307692307,0.9987250996015936,0.9908735156834086,0.9864472894578916,73557,32,25068,1323
12,7,SAFARI,High,125,0.25,73652,125,73652,1103,1,24985,32,82,0.9995521476555609,0.9836004273504273,0.9986852589641434,0.9915121327365126,0.9873874774954992,73652,33,25067,1228
12,7,vg giraffe,High,125,0.2,58876,91,58876,933,0,19910,23,59,0.999609501010204,0.9829048414023372,0.9988495398159264,0.9911867945016374,0.9868948079907875,58876,23,19969,1024
12,7,SAFARI,High,125,0.2,58946,91,58946,863,0,19910,24,58,0.9995930133966424,0.9840734557595994,0.9987995198079231,0.9917725246067133,0.9877584739398187,58946,24,19968,954
12,7,vg giraffe,High,125,0.35,102938,177,102938,1671,2,35008,34,115,0.9996503971876396,0.9823640562670586,0.9989760800932905,0.9909318444358876,0.9865375683304155,102938,36,35123,1848
12,7,SAFARI,High,125,0.35,103062,177,103062,1547,2,35008,35,114,0.9996411216403651,0.9835474204569312,0.9989476378736597,0.9915289703441807,0.9874164850476973,103062,37,35122,1724
12,7,vg giraffe,High,125,0.3,88074,145,88074,1437,1,29884,33,102,0.9996141099559631,0.9823547782635853,0.9988674217188541,0.990909295470399,0.9864968748955513,88074,34,29986,1582
12,7,SAFARI,High,125,0.3,88186,145,88186,1325,1,29884,34,101,0.9996032690629215,0.9836039975015616,0.998834110592938,0.9915390972413521,0.9874243791570574,88186,35,29985,1470
12,7,vg giraffe,High,125,0.45,132734,224,132734,2187,2,45253,40,155,0.9996836777730915,0.9821599023271301,0.999075907590759,0.9908443160483874,0.986417121182757,132734,42,45408,2411
12,7,SAFARI,High,125,0.45,132910,224,132910,2011,2,45253,41,154,0.9996765774371394,0.9834622072588701,0.9990539053905391,0.9915031070727869,0.9873861402585896,132910,43,45407,2235
12,7,vg giraffe,High,125,0.4,117641,195,117641,1937,2,40040,37,130,0.9996685927940177,0.9821996610254398,0.9990300678952473,0.9908571380441603,0.9864297233438762,117641,39,40170,2132
12,7,SAFARI,High,125,0.4,117800,195,117800,1778,2,40040,38,129,0.9996605566870332,0.9835271722341429,0.9990051978412793,0.9915282412999289,0.9874173344501257,117800,40,40169,1973
12,7,vg giraffe,High,125,0.55,162269,268,162269,2667,2,55336,46,180,0.9997042823610589,0.982234086341735,0.9991361313080411,0.9908921870658675,0.9864880779823163,162269,48,55516,2935
12,7,SAFARI,High,125,0.55,162486,269,162486,2449,2,55336,47,179,0.9996985264712216,0.9835476138592286,0.9991181340436254,0.9915573062711487,0.9874664806493695,162486,49,55515,2718
12,7,vg giraffe,High,125,0.5,147597,242,147597,2423,2,50379,44,164,0.999688437650278,0.9822643116689516,0.9990907114194786,0.9908997834880248,0.9865024321511967,147597,46,50543,2665
12,7,SAFARI,High,125,0.5,147795,243,147795,2224,2,50379,45,163,0.9996820930452781,0.9835820100890444,0.9990709442764237,0.9915667015538201,0.9874832587340865,147795,47,50542,2467
12,7,vg giraffe,High,125,0.65,191978,317,191978,3126,2,65460,57,214,0.9996927675395887,0.9823816273583699,0.9991024295255047,0.9909616009993341,0.9865902877229528,191978,59,65674,3443
12,7,SAFARI,High,125,0.65,192232,318,192232,2871,2,65460,58,213,0.9996879745387224,0.9836813853168288,0.9990872164666149,0.991620090118206,0.987559064766383,192232,60,65673,3189
12,7,vg giraffe,High,125,0.6,177115,294,177115,2897,2,60356,51,198,0.9997008489117674,0.9823023082981154,0.9991255135545399,0.9909252141414481,0.9865345581184909,177115,53,60554,3191
12,7,SAFARI,High,125,0.6,177348,295,177348,2663,2,60356,52,197,0.9996956065884263,0.9835945559216,0.9991090138102859,0.9915797242443558,0.9874975613603251,177348,54,60553,2958
12,7,vg giraffe,High,125,0.75,221284,366,221284,3610,2,75411,60,247,0.9997198955481463,0.9823492852703543,0.9991811938721606,0.9909584734643063,0.9865838261678517,221284,62,75658,3976
12,7,SAFARI,High,125,0.75,221575,367,221575,3318,2,75411,61,246,0.9997157527138848,0.9836411258101749,0.9991679873217115,0.9916132987840626,0.9875473453385607,221575,63,75657,3685
12,7,vg giraffe,High,125,0.7,206707,345,206707,3365,2,70487,59,236,0.9997049833629962,0.9823683447630182,0.9991382233273056,0.9909608447091818,0.9865896636213953,206707,61,70723,3710
12,7,SAFARI,High,125,0.7,206976,346,206976,3095,2,70487,60,235,0.9997005380654759,0.9836467585793923,0.999124095840868,0.9916086763842809,0.9875427185536324,206976,62,70722,3441
12,7,vg giraffe,High,125,0.85,250785,421,250785,4077,3,85284,68,276,0.999716969097809,0.9823803386829518,0.9991708610199578,0.9909728355254188,0.986597792991781,250785,71,85560,4498
12,7,SAFARI,High,125,0.85,251073,422,251073,3788,3,85284,69,275,0.9997133130263394,0.9835084984115667,0.9991591830061544,0.9915447013198323,0.9874396475357422,251073,72,85559,4210
12,7,vg giraffe,High,125,0.8,235901,390,235901,3844,3,80294,66,264,0.9997075899478747,0.9823682511920379,0.9991442072754785,0.990962077692946,0.9865850693037205,235901,69,80558,4234
12,7,SAFARI,High,125,0.8,236197,391,236197,3547,3,80294,67,263,0.9997037250229613,0.9836008911653862,0.9991318044823694,0.991586937082548,0.987504754303814,236197,70,80557,3938
12,7,vg giraffe,High,125,0.95,280143,462,280143,4559,3,95212,74,305,0.9997252159017914,0.9823925881247282,0.9991945101156976,0.9909831194374089,0.9866109182210223,280143,77,95517,5021
12,7,SAFARI,High,125,0.95,280475,464,280475,4225,3,95212,75,304,0.9997219776655392,0.9835568304554572,0.9991840492081093,0.9915735252785404,0.9874802367908225,280475,78,95516,4689
12,7,vg giraffe,High,125,0.9,265395,446,265395,4322,3,90232,70,290,0.9997250139376498,0.9823513952687822,0.9991942160163364,0.9909620615685053,0.986581032160063,265395,73,90522,4768
12,7,SAFARI,High,125,0.9,265709,448,265709,4006,3,90232,71,289,0.9997215773770332,0.9835136565702928,0.9991831778795739,0.9915513876397996,0.9874486497873921,265709,74,90521,4454
12,7,vg giraffe,Mid,125,0.15,44830,60,44830,8,2,14954,19,41,0.9995317830148714,0.9984854559223127,0.9986014917421417,0.9990083454968857,0.9985145375037554,44830,21,14995,68
12,7,SAFARI,Mid,125,0.15,44829,61,44829,8,2,14954,19,41,0.9995317725752508,0.998463183215288,0.9986014917421417,0.9989971921379863,0.99849784691391,44829,21,14995,69
12,7,vg giraffe,Mid,125,0.1,29877,44,29877,4,0,10014,15,21,0.9994981934965878,0.9983959899749374,0.9985074626865672,0.9989467877024926,0.9984240150093808,29877,15,10035,48
12,7,SAFARI,Mid,125,0.1,29877,44,29877,4,0,10014,15,21,0.9994981934965878,0.9983959899749374,0.9985074626865672,0.9989467877024926,0.9984240150093808,29877,15,10035,48
12,7,vg giraffe,Mid,125,0.25,74768,104,74768,9,3,24983,37,74,0.9994652978291092,0.9984909389564776,0.9984061840060565,0.9989778808062049,0.9984696633259317,74768,40,25057,113
12,7,SAFARI,Mid,125,0.25,74767,105,74767,9,3,24983,37,74,0.9994652906813534,0.9984775844339686,0.9984061840060565,0.9989711934156379,0.9984596611254476,74767,40,25057,114
12,7,vg giraffe,Mid,125,0.2,59812,81,59812,8,2,19908,27,53,0.9995153824301064,0.9985142151216173,0.9985492746373187,0.9990145479447478,0.9985229875705649,59812,29,19961,89
12,7,SAFARI,Mid,125,0.2,59811,82,59811,8,2,19908,27,53,0.9995153743315508,0.9984975209095007,0.9985492746373187,0.9990061883565362,0.9985104705160781,59811,29,19961,90
12,7,vg giraffe,Mid,125,0.35,104616,159,104616,12,4,35006,40,99,0.9995795910567552,0.998368118182599,0.99874818629264,0.9989734873261492,0.9984635833523897,104616,44,35105,171
12,7,SAFARI,Mid,125,0.35,104615,160,104615,12,4,35006,40,99,0.999579587039815,0.9983585750140762,0.99874818629264,0.9989687079247157,0.9984564372284472,104615,44,35105,172
12,7,vg giraffe,Mid,125,0.3,89513,134,89513,10,3,29882,39,90,0.9995310144603875,0.9983938788940072,0.9986006530285867,0.9989621230721157,0.9984457387336949,89513,42,29972,144
12,7,SAFARI,Mid,125,0.3,89512,135,89512,10,3,29882,39,90,0.9995310092234853,0.9983827252752155,0.9986006530285867,0.9989565372661277,0.9984373824903277,89512,42,29972,145
12,7,vg giraffe,Mid,125,0.45,134919,209,134919,16,5,45252,47,137,0.9996147320535522,0.9983351092168353,0.998855658986378,0.998974510856487,0.9984660962981422,134919,52,45389,225
12,7,SAFARI,Mid,125,0.45,134918,210,134918,16,5,45252,47,137,0.9996147291990812,0.9983277097022435,0.998855658986378,0.9989708049194044,0.9984605587396517,134918,52,45389,226
12,7,vg giraffe,Mid,125,0.4,119581,179,119581,13,5,40037,43,115,0.999598759498115,0.9983969675970378,0.9988059701492538,0.9989975021094226,0.9984997468322779,119581,48,40152,192
12,7,SAFARI,Mid,125,0.4,119580,180,119580,13,5,40037,43,115,0.9995987561440466,0.998388618469939,0.9988059701492538,0.9989933208299047,0.9984934957774124,119580,48,40152,193
12,7,vg giraffe,Mid,125,0.55,164929,255,164929,20,5,55335,55,164,0.9996363393923231,0.9983353913948815,0.9989200669558488,0.9989854418476466,0.9984825355698193,164929,60,55499,275
12,7,SAFARI,Mid,125,0.55,164928,256,164928,20,5,55335,55,164,0.9996363371881591,0.998329338272681,0.9989200669558488,0.9989824102340457,0.9984780058252515,164928,60,55499,276
12,7,vg giraffe,Mid,125,0.5,150009,234,150009,17,5,50378,52,147,0.9996201671264644,0.9983295620923732,0.9988731169190621,0.9989744477667603,0.9984664562193166,150009,57,50525,251
12,7,SAFARI,Mid,125,0.5,150008,235,150008,17,5,50378,52,147,0.999620164595342,0.9983229069612671,0.9988731169190621,0.998971114625822,0.9984614771810677,150008,57,50525,252
12,7,vg giraffe,Mid,125,0.65,195098,306,195098,21,6,65456,65,206,0.9996362127182084,0.9983267238070871,0.9989198728188277,0.9989810391352658,0.9984760183490454,195098,71,65662,327
12,7,SAFARI,Mid,125,0.65,195097,307,195097,21,6,65456,66,205,0.999631088953676,0.9983216067545094,0.9989046597599379,0.9989759187289103,0.9984683601497943,195097,72,65661,328
12,7,vg giraffe,Mid,125,0.6,180009,278,180009,21,6,60354,60,185,0.9996334860474803,0.9983417263793065,0.9989109809421665,0.9989871886298745,0.9984849302445281,180009,66,60539,299
12,7,SAFARI,Mid,125,0.6,180008,279,180008,21,6,60354,61,184,0.9996279328057753,0.9983361803136854,0.9988944806534115,0.9989816389785312,0.9984766284924433,180008,67,60538,300
12,7,vg giraffe,Mid,125,0.75,224893,348,224893,25,7,75406,72,236,0.9996488451896236,0.9983441797696945,0.9989566962929702,0.9989960865142435,0.9984982740118344,224893,79,75642,373
12,7,SAFARI,Mid,125,0.75,224892,349,224892,25,7,75406,73,235,0.9996444001920239,0.9983397405733666,0.9989434899169319,0.9989916444191739,0.9984916292065771,224892,80,75641,374
12,7,vg giraffe,Mid,125,0.7,210073,328,210073,22,6,70483,68,228,0.9996478655417398,0.9983366837275393,0.9989545807727626,0.9989918444016452,0.998492219282524,210073,74,70711,350
12,7,SAFARI,Mid,125,0.7,210072,329,210072,22,6,70483,69,227,0.9996431069679795,0.9983319313953323,0.998940453485908,0.9989870889507098,0.9984851071093284,210072,75,70710,351
12,7,vg giraffe,Mid,125,0.85,254848,410,254848,31,8,85279,78,268,0.9996626577859368,0.9982725460164754,0.9989957142690318,0.9989671182992534,0.9984541918679346,254848,86,85547,441
12,7,SAFARI,Mid,125,0.85,254848,411,254848,30,8,85279,79,267,0.9996587365406868,0.9982725460164754,0.9989840365279741,0.9989651604001379,0.9984512586456726,254848,87,85546,441
12,7,vg giraffe,Mid,125,0.8,239729,384,239729,28,8,80289,76,252,0.9996497270790158,0.9982843412828297,0.9989581395348838,0.998966567629398,0.998453701452149,239729,84,80541,412
12,7,SAFARI,Mid,125,0.8,239729,385,239729,27,8,80289,77,251,0.9996455586412804,0.9982843412828297,0.9989457364341086,0.9989644862539198,0.998450583914754,239729,85,80540,412
12,7,vg giraffe,Mid,125,0.95,284681,454,284681,34,8,95205,85,297,0.9996734252424729,0.9982887340489324,0.9990271457712223,0.9989805998143675,0.9984741204525638,284681,93,95502,488
12,7,SAFARI,Mid,125,0.95,284681,455,284681,33,8,95205,86,296,0.9996699148450531,0.9982887340489324,0.9990166849730634,0.998978847044622,0.998471494153859,284681,94,95501,488
12,7,vg giraffe,Mid,125,0.9,269707,428,269707,33,8,90227,80,282,0.9996738264237662,0.9982936543187942,0.9990286654083469,0.9989832636680661,0.9984782337532743,269707,88,90509,461
12,7,SAFARI,Mid,125,0.9,269707,429,269707,32,8,90227,81,281,0.9996701211285564,0.9982936543187942,0.9990176275152599,0.9989814135757198,0.9984754618657575,269707,89,90508,461
12,7,vg giraffe,None,125,0.15,44827,73,44827,0,0,14958,15,43,0.9996654921725169,0.9983741648106904,0.9990010655301013,0.9990194112009985,0.9985312771213032,44827,15,15001,73
12,7,SAFARI,None,125,0.15,44827,73,44827,0,0,14958,15,43,0.9996654921725169,0.9983741648106904,0.9990010655301013,0.9990194112009985,0.9985312771213032,44827,15,15001,73
12,7,vg giraffe,None,125,0.1,29878,47,29878,0,0,10014,10,27,0.9996654175588865,0.9984294068504594,0.9990050741219779,0.9990470299098858,0.998574144486692,29878,10,10041,47
12,7,SAFARI,None,125,0.1,29878,47,29878,0,0,10014,10,27,0.9996654175588865,0.9984294068504594,0.9990050741219779,0.9990470299098858,0.998574144486692,29878,10,10041,47
12,7,vg giraffe,None,125,0.25,74769,114,74769,0,0,24988,34,80,0.999545472775156,0.9984776250951485,0.9986455262528883,0.9990112635784241,0.998519777966695,74769,34,25068,114
12,7,SAFARI,None,125,0.25,74769,114,74769,0,0,24988,34,80,0.999545472775156,0.9984776250951485,0.9986455262528883,0.9990112635784241,0.998519777966695,74769,34,25068,114
12,7,vg giraffe,None,125,0.2,59811,92,59811,0,0,19912,23,59,0.999615603168767,0.9984641837637513,0.9988496548964689,0.9990395617060724,0.9985606468327972,59811,23,19971,92
12,7,SAFARI,None,125,0.2,59811,92,59811,0,0,19912,23,59,0.999615603168767,0.9984641837637513,0.9988496548964689,0.9990395617060724,0.9985606468327972,59811,23,19971,92
12,7,vg giraffe,None,125,0.35,104628,158,104628,0,2,35010,38,111,0.9996178392631941,0.9984921649838719,0.9988623759278746,0.9990546850382424,0.998585178674784,104628,40,35121,158
12,7,SAFARI,None,125,0.35,104628,158,104628,0,2,35010,38,111,0.9996178392631941,0.9984921649838719,0.9988623759278746,0.9990546850382424,0.998585178674784,104628,40,35121,158
12,7,vg giraffe,None,125,0.3,89521,136,89521,0,1,29886,37,98,0.9995756987014147,0.9984831078443401,0.9987342615415362,0.9990291045442371,0.9985461108465145,89521,38,29984,136
12,7,SAFARI,None,125,0.3,89521,136,89521,0,1,29886,37,98,0.9995756987014147,0.9984831078443401,0.9987342615415362,0.9990291045442371,0.9985461108465145,89521,38,29984,136
12,7,vg giraffe,None,125,0.45,134935,208,134935,0,5,45252,45,150,0.9996295884727933,0.9984608895762267,0.9988999383965502,0.999044897233904,0.9985713890196296,134935,50,45402,208
12,7,SAFARI,None,125,0.45,134935,208,134935,0,5,45252,45,150,0.9996295884727933,0.9984608895762267,0.9988999383965502,0.999044897233904,0.9985713890196296,134935,50,45402,208
12,7,vg giraffe,None,125,0.4,119590,182,119590,0,3,40041,42,125,0.999623855895014,0.9984804461810773,0.9988809032354331,0.9990518238815073,0.9985810992417944,119590,45,40166,182
12,7,SAFARI,None,125,0.4,119590,182,119590,0,3,40041,42,125,0.999623855895014,0.9984804461810773,0.9988809032354331,0.9990518238815073,0.9985810992417944,119590,45,40166,182
12,7,vg giraffe,None,125,0.55,164947,256,164947,0,5,55335,54,172,0.9996424372447063,0.9984503913367191,0.9989381996184717,0.9990460587082726,0.9985731692402466,164947,59,55507,256
12,7,SAFARI,None,125,0.55,164947,256,164947,0,5,55335,54,172,0.9996424372447063,0.9984503913367191,0.9989381996184717,0.9990460587082726,0.9985731692402466,164947,59,55507,256
12,7,vg giraffe,None,125,0.5,150025,234,150025,0,5,50378,50,158,0.9996335287846482,0.9984426889570674,0.99891285011168,0.9990377540046416,0.9985611152601443,150025,55,50536,234
12,7,SAFARI,None,125,0.5,150025,234,150025,0,5,50378,50,158,0.9996335287846482,0.9984426889570674,0.99891285011168,0.9990377540046416,0.9985611152601443,150025,55,50536,234
12,7,vg giraffe,None,125,0.65,195117,310,195117,0,5,65459,63,208,0.9996516125726874,0.9984137299349629,0.9989655434699931,0.9990322877945378,0.9985526225101661,195117,68,65667,310
12,7,SAFARI,None,125,0.65,195117,310,195117,0,5,65459,63,208,0.9996516125726874,0.9984137299349629,0.9989655434699931,0.9990322877945378,0.9985526225101661,195117,68,65667,310
12,7,vg giraffe,None,125,0.6,180021,286,180021,0,5,60355,57,192,0.9996557143095128,0.998413816435302,0.9989770496130937,0.9990343794222926,0.9985555131249066,180021,62,60547,286
12,7,SAFARI,None,125,0.6,180021,286,180021,0,5,60355,57,192,0.9996557143095128,0.998413816435302,0.9989770496130937,0.9990343794222926,0.9985555131249066,180021,62,60547,286
12,7,vg giraffe,None,125,0.75,224915,357,224915,0,5,75410,69,238,0.9996710950313127,0.9984152491210625,0.9990227410792109,0.9990427774113236,0.998568077768992,224915,74,75648,357
12,7,SAFARI,None,125,0.75,224915,357,224915,0,5,75410,69,238,0.9996710950313127,0.9984152491210625,0.9990227410792109,0.9990427774113236,0.998568077768992,224915,74,75648,357
12,7,vg giraffe,None,125,0.7,210099,330,210099,0,5,70486,66,229,0.9996621782366656,0.9984317750880345,0.9989969768033227,0.9990465978283354,0.9985740447700159,210099,71,70715,330
12,7,SAFARI,None,125,0.7,210099,330,210099,0,5,70486,66,229,0.9996621782366656,0.9984317750880345,0.9989969768033227,0.9990465978283354,0.9985740447700159,210099,71,70715,330
12,7,vg giraffe,None,125,0.85,254885,410,254885,0,5,85286,80,264,0.9996666274463663,0.9983940147672301,0.9990074151923863,0.9990299158280501,0.9985480890505383,254885,85,85550,410
12,7,SAFARI,None,125,0.85,254885,410,254885,0,5,85286,80,264,0.9996666274463663,0.9983940147672301,0.9990074151923863,0.9990299158280501,0.9985480890505383,254885,85,85550,410
12,7,vg giraffe,None,125,0.8,239763,384,239763,0,5,80294,76,254,0.9996622804823135,0.9984009794001174,0.998995398677895,0.9990312318355971,0.998550390303514,239763,81,80548,384
12,7,SAFARI,None,125,0.8,239763,384,239763,0,5,80294,76,254,0.9996622804823135,0.9984009794001174,0.998995398677895,0.9990312318355971,0.998550390303514,239763,81,80548,384
12,7,vg giraffe,None,125,0.95,284713,461,284713,0,6,95212,88,291,0.9996699519323612,0.9983834430908849,0.9990167055451531,0.9990262833322514,0.998542431014967,284713,94,95503,461
12,7,SAFARI,None,125,0.95,284713,461,284713,0,6,95212,88,291,0.9996699519323612,0.9983834430908849,0.9990167055451531,0.9990262833322514,0.998542431014967,284713,94,95503,461
12,7,vg giraffe,None,125,0.9,269733,440,269733,0,5,90233,83,277,0.9996738578539106,0.9983714138718525,0.9990286761297159,0.999022211357904,0.9985364677316081,269733,88,90510,440
12,7,SAFARI,None,125,0.9,269733,440,269733,0,5,90233,83,277,0.9996738578539106,0.9983714138718525,0.9990286761297159,0.999022211357904,0.9985364677316081,269733,88,90510,440
12,7,vg giraffe,Single-stranded,125,0.15,44833,67,44833,0,0,14958,16,41,0.9996432473410778,0.9985077951002227,0.998934398934399,0.9990751986094552,0.9986147041642327,44833,16,14999,67
12,7,SAFARI,Single-stranded,125,0.15,44833,67,44833,0,0,14958,16,41,0.9996432473410778,0.9985077951002227,0.998934398934399,0.9990751986094552,0.9986147041642327,44833,16,14999,67
12,7,vg giraffe,Single-stranded,125,0.1,29883,42,29883,0,0,10014,10,20,0.9996654735222292,0.9985964912280701,0.9990043807248108,0.9991306964458857,0.9986989917185819,29883,10,10034,42
12,7,SAFARI,Single-stranded,125,0.1,29883,42,29883,0,0,10014,10,20,0.9996654735222292,0.9985964912280701,0.9990043807248108,0.9991306964458857,0.9986989917185819,29883,10,10034,42
12,7,vg giraffe,Single-stranded,125,0.25,74761,121,74761,0,0,24987,33,77,0.999558788138086,0.9983841243556529,0.9986851018049966,0.9989711109329485,0.9984596765320717,74761,33,25064,121
12,7,SAFARI,Single-stranded,125,0.25,74761,121,74761,0,0,24987,33,77,0.999558788138086,0.9983841243556529,0.9986851018049966,0.9989711109329485,0.9984596765320717,74761,33,25064,121
12,7,vg giraffe,Single-stranded,125,0.2,59804,99,59804,0,0,19911,23,53,0.9996155581927892,0.9983473281805586,0.998849252013809,0.9989810406748518,0.998472900237827,59804,23,19964,99
12,7,SAFARI,Single-stranded,125,0.2,59804,99,59804,0,0,19911,23,53,0.9996155581927892,0.9983473281805586,0.998849252013809,0.9989810406748518,0.998472900237827,59804,23,19964,99
12,7,vg giraffe,Single-stranded,125,0.35,104621,164,104621,0,2,35008,38,100,0.9996178137032896,0.9984348904900511,0.9988619551610334,0.9990260019288981,0.9985421594620283,104621,40,35108,164
12,7,SAFARI,Single-stranded,125,0.35,104621,164,104621,0,2,35008,38,100,0.9996178137032896,0.9984348904900511,0.9988619551610334,0.9990260019288981,0.9985421594620283,104621,40,35108,164
12,7,vg giraffe,Single-stranded,125,0.3,89516,140,89516,0,1,29884,37,89,0.9995756750117247,0.9984384759525297,0.9987337976075439,0.9990067518553652,0.998512538962287,89516,38,29973,140
12,7,SAFARI,Single-stranded,125,0.3,89516,140,89516,0,1,29884,37,89,0.9995756750117247,0.9984384759525297,0.9987337976075439,0.9990067518553652,0.998512538962287,89516,38,29973,140
12,7,vg giraffe,Single-stranded,125,0.45,134929,217,134929,0,3,45252,43,138,0.9996591961474347,0.9983943290959407,0.9989875869354696,0.9990263622598761,0.9985435979222735,134929,46,45390,217
12,7,SAFARI,Single-stranded,125,0.45,134929,217,134929,0,3,45252,43,138,0.9996591961474347,0.9983943290959407,0.9989875869354696,0.9990263622598761,0.9985435979222735,134929,46,45390,217
12,7,vg giraffe,Single-stranded,125,0.4,119584,191,119584,0,3,40039,40,117,0.9996405493743051,0.9984053433521185,0.9989303216497922,0.999022564556687,0.9985372623051246,119584,43,40156,191
12,7,SAFARI,Single-stranded,125,0.4,119584,191,119584,0,3,40039,40,117,0.9996405493743051,0.9984053433521185,0.9989303216497922,0.999022564556687,0.9985372623051246,119584,43,40156,191
12,7,vg giraffe,Single-stranded,125,0.55,164947,258,164947,0,3,55336,53,161,0.9996606122312928,0.998438303925426,0.9989919536298669,0.9990490842135866,0.9985776279908316,164947,56,55497,258
12,7,SAFARI,Single-stranded,125,0.55,164947,258,164947,0,3,55336,53,161,0.9996606122312928,0.998438303925426,0.9989919536298669,0.9990490842135866,0.9985776279908316,164947,56,55497,258
12,7,vg giraffe,Single-stranded,125,0.5,150022,239,150022,0,3,50378,48,151,0.9996601653861787,0.9984094342510698,0.9989916963226572,0.9990344083586941,0.998556071718424,150022,51,50529,239
12,7,SAFARI,Single-stranded,125,0.5,150022,239,150022,0,3,50378,48,151,0.9996601653861787,0.9984094342510698,0.9989916963226572,0.9990344083586941,0.998556071718424,150022,51,50529,239
12,7,vg giraffe,Single-stranded,125,0.65,195131,300,195131,0,3,65460,65,202,0.9996516375596186,0.9984649313568472,0.9989654647801612,0.9990579320584696,0.9985909075244772,195131,68,65662,300
12,7,SAFARI,Single-stranded,125,0.65,195131,300,195131,0,3,65460,65,202,0.9996516375596186,0.9984649313568472,0.9989654647801612,0.9990579320584696,0.9985909075244772,195131,68,65662,300
12,7,vg giraffe,Single-stranded,125,0.6,180033,276,180033,0,3,60356,60,184,0.9996501865671642,0.9984692943779845,0.9989604475025989,0.9990593915178758,0.9985928471807133,180033,63,60540,276
12,7,SAFARI,Single-stranded,125,0.6,180033,276,180033,0,3,60356,60,184,0.9996501865671642,0.9984692943779845,0.9989604475025989,0.9990593915178758,0.9985928471807133,180033,63,60540,276
12,7,vg giraffe,Single-stranded,125,0.75,224919,357,224919,0,4,75410,75,234,0.9996488857678735,0.9984152772598945,0.9989567238487645,0.9990317006977973,0.9985514902042864,224919,79,75644,357
12,7,SAFARI,Single-stranded,125,0.75,224919,357,224919,0,4,75410,75,234,0.9996488857678735,0.9984152772598945,0.9989567238487645,0.9990317006977973,0.9985514902042864,224919,79,75644,357
12,7,vg giraffe,Single-stranded,125,0.7,210098,335,210098,0,3,70487,70,223,0.9996526637833003,0.9984080443656651,0.9989686789200797,0.9990299664292304,0.9985491579426491,210098,73,70710,335
12,7,SAFARI,Single-stranded,125,0.7,210098,335,210098,0,3,70487,70,223,0.9996526637833003,0.9984080443656651,0.9989686789200797,0.9990299664292304,0.9985491579426491,210098,73,70710,335
12,7,vg giraffe,Single-stranded,125,0.85,254891,407,254891,0,5,85287,84,263,0.9996509530159228,0.9984057846124921,0.9989607538621422,0.9990279808261379,0.9985451857674585,254891,89,85550,407
12,7,SAFARI,Single-stranded,125,0.85,254891,407,254891,0,5,85287,84,263,0.9996509530159228,0.9984057846124921,0.9989607538621422,0.9990279808261379,0.9985451857674585,254891,89,85550,407
12,7,vg giraffe,Single-stranded,125,0.8,239768,383,239768,0,5,80295,80,250,0.9996456162733007,0.998405170080491,0.9989458018107404,0.9990250081249322,0.9985410607236713,239768,85,80545,383
12,7,SAFARI,Single-stranded,125,0.8,239768,383,239768,0,5,80295,80,250,0.9996456162733007,0.998405170080491,0.9989458018107404,0.9990250081249322,0.9985410607236713,239768,85,80545,383
12,7,vg giraffe,Single-stranded,125,0.95,284719,457,284719,1,6,95213,89,298,0.9996664489807383,0.9983939798791628,0.9990063385143192,0.9990298092426021,0.9985477292841329,284719,95,95511,458
12,7,SAFARI,Single-stranded,125,0.95,284719,457,284719,1,6,95213,89,298,0.9996664489807383,0.9983939798791628,0.9990063385143192,0.9990298092426021,0.9985477292841329,284719,95,95511,458
12,7,vg giraffe,Single-stranded,125,0.9,269747,429,269747,0,5,90234,86,278,0.9996627606193346,0.9984121461565794,0.9989956182466364,0.9990370620020963,0.9985586744239549,269747,91,90512,429
12,7,SAFARI,Single-stranded,125,0.9,269747,429,269747,0,5,90234,86,278,0.9996627606193346,0.9984121461565794,0.9989956182466364,0.9990370620020963,0.9985586744239549,269747,91,90512,429
15,15,vg giraffe,High,125,0.15,38552,60,38552,6284,0,14956,6,52,0.9998443902692048,0.8586956521739131,0.9996003729852138,0.923910178062166,0.8940076781839426,38552,6,15008,6344
15,15,SAFARI,High,125,0.15,38608,60,38608,6228,0,14956,6,52,0.9998446159424043,0.8599429793300071,0.9996003729852138,0.9246317806250748,0.8949424136204307,38608,6,15008,6288
15,15,vg giraffe,High,125,0.1,25707,38,25707,4178,0,10014,5,32,0.9998055382700685,0.8591050362597333,0.9995025370609889,0.9241304933944459,0.8944063641366888,25707,5,10046,4216
15,15,SAFARI,High,125,0.1,25741,38,25741,4144,0,10014,5,32,0.9998057950749631,0.8602412859673161,0.9995025370609889,0.9247875837539743,0.8952569169960475,25741,5,10046,4182
15,15,vg giraffe,High,125,0.25,64148,103,64148,10629,0,24986,14,100,0.9997818023128955,0.8566773504273504,0.9994422310756972,0.9227140000863048,0.8925185037007402,64148,14,25086,10732
15,15,SAFARI,High,125,0.25,64244,103,64244,10533,0,24986,14,100,0.9997821282953095,0.8579594017094017,0.9994422310756972,0.923457287010019,0.8934786957391478,64244,14,25086,10636
15,15,vg giraffe,High,125,0.2,51421,79,51421,8400,0,19910,10,72,0.9998055647372207,0.8584474123539232,0.999499799919968,0.923749898949978,0.8937440544735393,51421,10,19982,8479
15,15,SAFARI,High,125,0.2,51498,79,51498,8323,0,19910,10,72,0.9998058554011028,0.8597328881469115,0.999499799919968,0.9244937526928048,0.8947078556050668,51498,10,19982,8402
15,15,vg giraffe,High,125,0.35,89832,150,89832,14804,0,35010,16,133,0.9998219214673671,0.8572900960051916,0.9995449244859069,0.9230864083356454,0.8930294044088749,89832,16,35143,14954
15,15,SAFARI,High,125,0.35,89979,150,89979,14657,0,35010,16,133,0.9998222123451302,0.8586929551657664,0.9995449244859069,0.9238991482742156,0.8940798170709922,89979,16,35143,14807
15,15,vg giraffe,High,125,0.3,76801,122,76801,12733,0,29885,15,120,0.9998047281816288,0.8566186312126349,0.9995003331112592,0.9226897015714355,0.8924596410307831,76801,15,30005,12855
15,15,SAFARI,High,125,0.3,76928,122,76928,12606,0,29885,15,120,0.9998050504919226,0.8580351565985544,0.9995003331112592,0.9235109454438502,0.893520839600254,76928,15,30005,12728
15,15,vg giraffe,High,125,0.45,115731,190,115731,19224,0,45255,21,174,0.9998185776487664,0.8563468866772725,0.9995379537953796,0.9225379338931913,0.8923835100639552,115731,21,45429,19414
15,15,SAFARI,High,125,0.45,115915,190,115915,19040,0,45255,21,174,0.9998188655810102,0.857708387287728,0.9995379537953796,0.9233275317527014,0.8934023644065451,115915,21,45429,19230
15,15,vg giraffe,High,125,0.4,102619,166,102619,16988,0,40042,19,148,0.9998148833765272,0.8567790737478397,0.9995274689746076,0.9227870923650359,0.892656673875811,102619,19,40190,17154
15,15,SAFARI,High,125,0.4,102788,166,102788,16819,0,40042,19,148,0.9998151876817727,0.8581900762275304,0.9995274689746076,0.92360499595651,0.8937130427173057,102788,19,40190,16985
15,15,vg giraffe,High,125,0.55,141413,227,141413,23564,0,55338,23,203,0.9998373822789106,0.8559901697295464,0.9995860629184364,0.9223388990346987,0.8921311059573851,141413,23,55541,23791
15,15,SAFARI,High,125,0.55,141642,227,141642,23335,0,55338,23,203,0.9998376451487665,0.8573763347134452,0.9995860629184364,0.923143100150227,0.8931683939701406,141642,23,55541,23562
15,15,vg giraffe,High,125,0.5,128696,206,128696,21360,0,50381,22,186,0.9998290837334328,0.8564773528902849,0.9995651228527941,0.9226181088250054,0.8925173387237305,128696,22,50567,21566
15,15,SAFARI,High,125,0.5,128894,206,128894,21162,0,50381,22,186,0.9998293462409631,0.8577950513103779,0.9995651228527941,0.9233822149309758,0.8935031441217619,128894,22,50567,21368
15,15,vg giraffe,High,125,0.65,167302,268,167302,27851,0,65462,26,245,0.999844616561484,0.8561106534098177,0.9996044604688665,0.9224119156772314,0.8922283403662207,167302,26,65707,28119
15,15,SAFARI,High,125,0.65,167568,268,167568,27585,0,65462,26,245,0.9998448631812594,0.8574718172560779,0.9996044604688665,0.9232015205983224,0.8932468964672186,167568,26,65707,27853
15,15,vg giraffe,High,125,0.6,154337,249,154337,25720,0,60358,24,225,0.9998445203127733,0.8559726243164398,0.9996040061379049,0.9223317506655869,0.8921062790301894,154337,24,60583,25969
15,15,SAFARI,High,125,0.6,154588,249,154588,25469,0,60358,24,225,0.9998447727213929,0.8573647022284339,0.9996040061379049,0.923139395314674,0.8931481489168289,154588,24,60583,25718
15,15,vg giraffe,High,125,0.75,192768,314,192768,32178,0,75413,28,279,0.9998547687711363,0.8557577909970701,0.9996302165874273,0.9222113783799301,0.8919529536846302,192768,28,75692,32492
15,15,SAFARI,High,125,0.75,193083,314,193083,31863,0,75413,28,279,0.9998550056703139,0.8571561750865666,0.9996302165874273,0.9230228672637444,0.8929995348528141,193083,28,75692,32177
15,15,vg giraffe,High,125,0.7,180063,292,180063,30062,0,70489,28,267,0.9998445230466819,0.8557435948616319,0.9996044303797469,0.9221987769776804,0.8919562874954214,180063,28,70756,30354
15,15,SAFARI,High,125,0.7,180351,292,180351,29774,0,70489,28,267,0.9998447712871232,0.8571123055646644,0.9996044303797469,0.9229930705534346,0.8929804659300643,180351,28,70756,30066
15,15,vg giraffe,High,125,0.85,218544,363,218544,36376,0,85287,33,311,0.9998490234562648,0.8560852073972807,0.9996146255444874,0.9223990208078334,0.8921370198935802,218544,33,85598,36739
15,15,SAFARI,High,125,0.85,218882,363,218882,36038,0,85287,33,311,0.9998492565607656,0.8574092281898912,0.9996146255444874,0.9231671158461233,0.8931284722833325,218882,33,85598,36401
15,15,vg giraffe,High,125,0.8,205580,337,205580,34218,0,80297,32,298,0.9998443670602883,0.856101776084286,0.9996031106205118,0.9224066566909032,0.8921723894975091,205580,32,80595,34555
15,15,SAFARI,High,125,0.8,205916,337,205916,33882,0,80297,32,298,0.9998446209722842,0.8575009890270057,0.9996031106205118,0.923218324840893,0.8932198951247342,205916,32,80595,34219
15,15,vg giraffe,High,125,0.95,244062,399,244062,40703,0,95215,36,343,0.9998525182508664,0.8558653967541485,0.9996234073268196,0.9222729007561473,0.8919576213763073,244062,36,95558,41102
15,15,SAFARI,High,125,0.95,244442,399,244442,40323,0,95215,36,343,0.9998527474864815,0.857197963277272,0.9996234073268196,0.9230461330483609,0.892955630610519,244442,36,95558,40722
15,15,vg giraffe,High,125,0.9,231284,384,231284,38495,0,90235,33,327,0.9998573386305373,0.8560905823521355,0.999635741486837,0.9224056791895988,0.8921382200810516,231284,33,90562,38879
15,15,SAFARI,High,125,0.9,231642,384,231642,38137,0,90235,33,327,0.9998575590806086,0.8574157082946221,0.999635741486837,0.9231744108656579,0.8931305750669424,231642,33,90562,38521
15,15,vg giraffe,Mid,125,0.15,44315,60,44315,523,0,14956,7,53,0.9998420648887686,0.9870150118045348,0.9995338305807139,0.9933871329298365,0.9901525519911873,44315,7,15009,583
15,15,SAFARI,Mid,125,0.15,44316,60,44316,522,0,14956,7,53,0.9998420684520453,0.9870372845115596,0.9995338305807139,0.9933984151713162,0.9901692425810328,44316,7,15009,582
15,15,vg giraffe,Mid,125,0.1,29532,44,29532,349,0,10014,5,31,0.9998307207908724,0.9868671679197994,0.9995024875621891,0.9933066496249706,0.9900437773608506,29532,5,10045,393
15,15,SAFARI,Mid,125,0.1,29532,44,29532,349,0,10014,5,31,0.9998307207908724,0.9868671679197994,0.9995024875621891,0.9933066496249706,0.9900437773608506,29532,5,10045,393
15,15,vg giraffe,Mid,125,0.25,73882,102,73882,897,0,24986,15,96,0.9997970147637929,0.9866588320134614,0.9994023190022712,0.9931844761994381,0.989857768709116,73882,15,25082,999
15,15,SAFARI,Mid,125,0.25,73885,102,73885,894,0,24986,15,96,0.9997970230040596,0.9866988955809886,0.9994023190022712,0.9932047774917496,0.9898877753105684,73885,15,25082,996
15,15,vg giraffe,Mid,125,0.2,59116,80,59116,705,0,19910,11,69,0.9998139597814873,0.9868950434884226,0.9994497248624312,0.9933124978996539,0.9900364246285565,59116,11,19979,785
15,15,SAFARI,Mid,125,0.2,59118,80,59118,703,0,19910,11,69,0.9998139660741768,0.9869284319126559,0.9994497248624312,0.9933294127530874,0.9900614587375299,59118,11,19979,783
15,15,vg giraffe,Mid,125,0.35,103361,156,103361,1270,1,35009,17,122,0.9998258833999168,0.9863914416864688,0.9994878943924436,0.9930632283850388,0.9896809970272125,103361,18,35131,1426
15,15,SAFARI,Mid,125,0.35,103366,156,103366,1265,1,35009,17,122,0.9998258918207846,0.9864391575290828,0.9994878943924436,0.993087413712765,0.9897167276469243,103366,18,35131,1421
15,15,vg giraffe,Mid,125,0.3,88448,131,88448,1078,0,29885,16,113,0.9998191354675349,0.9865152748809352,0.9994669154394615,0.9931226525788649,0.989763601875141,88448,16,29998,1209
15,15,SAFARI,Mid,125,0.3,88451,131,88451,1075,0,29885,16,113,0.9998191416008229,0.98654873573731,0.9994669154394615,0.9931396106083402,0.9897886706052427,88451,16,29998,1206
15,15,vg giraffe,Mid,125,0.45,133348,203,133348,1593,1,45256,22,162,0.9998275487174874,0.9867104717930504,0.9994938491670518,0.9932257043368156,0.9899271811058504,133348,23,45418,1796
15,15,SAFARI,Mid,125,0.45,133353,203,133353,1588,1,45256,22,162,0.9998275551823417,0.9867474693660095,0.9994938491670518,0.9932444510650976,0.9899548688983028,133353,23,45418,1791
15,15,vg giraffe,Mid,125,0.4,118156,175,118156,1442,1,40041,19,139,0.9998307608989981,0.9864994614813021,0.9995024875621891,0.9931203745340389,0.9897670231851625,118156,20,40180,1617
15,15,SAFARI,Mid,125,0.4,118161,175,118161,1437,1,40041,19,139,0.9998307680591635,0.9865412071167959,0.9995024875621891,0.9931415315565193,0.9897982784594901,118161,20,40180,1612
15,15,vg giraffe,Mid,125,0.55,162989,247,162989,1968,1,55339,26,193,0.9998343720861755,0.9865923343260454,0.999514030130132,0.9931692157699105,0.989844312679208,162989,27,55532,2215
15,15,SAFARI,Mid,125,0.55,162995,247,162995,1962,1,55339,26,193,0.9998343781820859,0.986628653059248,0.999514030130132,0.9931876207247445,0.9898714911466142,162995,27,55532,2209
15,15,vg giraffe,Mid,125,0.5,148244,227,148244,1789,1,50382,25,174,0.9998246442301207,0.986583255690137,0.9994859831560634,0.9931598164338593,0.9898328038955996,148244,26,50556,2016
15,15,SAFARI,Mid,125,0.5,148250,227,148250,1783,1,50382,25,174,0.9998246513259057,0.9866231864767736,0.9994859831560634,0.9931800519870301,0.9898626781250933,148250,26,50556,2010
15,15,vg giraffe,Mid,125,0.65,192830,294,192830,2301,1,65461,31,240,0.999834078252844,0.986721248560829,0.999513182115528,0.993234385905271,0.9899409552837746,192830,32,65701,2595
15,15,SAFARI,Mid,125,0.65,192836,294,192836,2295,1,65461,31,240,0.9998340834145634,0.9867519508762953,0.999513182115528,0.9932499426979112,0.9899639298815277,192836,32,65701,2589
15,15,vg giraffe,Mid,125,0.6,177907,268,177907,2133,1,60359,28,217,0.9998370200521536,0.9866838964438627,0.9995214916261035,0.9932169136119516,0.9899133712169953,177907,29,60576,2401
15,15,SAFARI,Mid,125,0.6,177913,268,177913,2127,1,60359,28,217,0.9998370255476503,0.986717172837589,0.9995214916261035,0.9932337752965805,0.9899382764732497,177913,29,60576,2395
15,15,vg giraffe,Mid,125,0.75,222287,336,222287,2643,1,75412,35,273,0.9998380734336978,0.9867756341391954,0.9995245704626193,0.9932639095241393,0.9899829560745148,222287,36,75685,2979
15,15,SAFARI,Mid,125,0.75,222293,336,222293,2637,1,75412,35,273,0.9998380778036153,0.9868022693171629,0.9995245704626193,0.993277404796747,0.990002890490287,222293,36,75685,2973
15,15,vg giraffe,Mid,125,0.7,207647,316,207647,2460,1,70488,34,262,0.9998314731175547,0.986807525793283,0.9995055449600904,0.9932768084572057,0.9900038405735256,207647,35,70750,2776
15,15,SAFARI,Mid,125,0.7,207653,316,207653,2454,1,70488,34,262,0.9998314779862101,0.9868360397865252,0.9995055449600904,0.993291255192999,0.9900251770931126,207653,35,70750,2770
15,15,vg giraffe,Mid,125,0.85,251902,397,251902,2990,1,85286,39,307,0.9998412332997277,0.9867326833510257,0.9995328903576892,0.993243709473593,0.989947847308182,251902,40,85593,3387
15,15,SAFARI,Mid,125,0.85,251910,397,251910,2982,1,85286,39,307,0.9998412383409406,0.9867640203847404,0.9995328903576892,0.9932595876894325,0.9899713130862778,251910,40,85593,3379
15,15,vg giraffe,Mid,125,0.8,236961,371,236961,2809,1,80296,38,290,0.9998354430379747,0.986757779804365,0.9995162790697675,0.9932535665557979,0.9899646471259422,236961,39,80586,3180
15,15,SAFARI,Mid,125,0.8,236968,371,236968,2802,1,80296,38,290,0.9998354478981634,0.9867869293456761,0.9995162790697675,0.9932683360299112,0.9899864698877063,236968,39,80586,3173
15,15,vg giraffe,Mid,125,0.95,281417,441,281417,3311,1,95212,44,338,0.9998401205136039,0.9868428896549064,0.9995292640828495,0.9932989899952527,0.9900279438182181,281417,45,95550,3752
15,15,SAFARI,Mid,125,0.95,281425,441,281425,3303,1,95212,44,338,0.9998401250577326,0.9868709431950878,0.9995292640828495,0.9933132029387317,0.9900489542078558,281425,45,95550,3744
15,15,vg giraffe,Mid,125,0.9,266589,415,266589,3164,1,90234,40,322,0.9998462288564678,0.9867526872168428,0.9995474463834343,0.9932563087045778,0.9899657671891675,266589,41,90556,3579
15,15,SAFARI,Mid,125,0.9,266597,415,266597,3156,1,90234,40,322,0.999846233470098,0.9867822984217228,0.9995474463834343,0.993271312168642,0.9899879422893019,266597,41,90556,3571
15,15,vg giraffe,None,125,0.15,44802,72,44802,26,0,14958,8,50,0.9998214684222272,0.9978173719376392,0.9994672349493873,0.9988184148924312,0.9982308565324788,44802,8,15008,98
15,15,SAFARI,None,125,0.15,44802,72,44802,26,0,14958,8,50,0.9998214684222272,0.9978173719376392,0.9994672349493873,0.9988184148924312,0.9982308565324788,44802,8,15008,98
15,15,vg giraffe,None,125,0.1,29860,46,29860,19,0,10014,5,32,0.9998325799430772,0.997827903091061,0.9995025370609889,0.9988292356581367,0.9982489493696217,29860,5,10046,65
15,15,SAFARI,None,125,0.1,29860,46,29860,19,0,10014,5,32,0.9998325799430772,0.997827903091061,0.9995025370609889,0.9988292356581367,0.9982489493696217,29860,5,10046,65
15,15,vg giraffe,None,125,0.25,74723,111,74723,49,0,24988,17,97,0.9997725448220498,0.997863333466875,0.9993227631264441,0.998817026794009,0.998229734460169,74723,17,25085,160
15,15,SAFARI,None,125,0.25,74723,111,74723,49,0,24988,17,97,0.9997725448220498,0.997863333466875,0.9993227631264441,0.998817026794009,0.998229734460169,74723,17,25085,160
15,15,vg giraffe,None,125,0.2,59776,91,59776,36,0,19912,12,70,0.9997992908275908,0.9978799058477873,0.9993998199459838,0.9988386762580311,0.9982602600848592,59776,12,19982,127
15,15,SAFARI,None,125,0.2,59776,91,59776,36,0,19912,12,70,0.9997992908275908,0.9978799058477873,0.9993998199459838,0.9988386762580311,0.9982602600848592,59776,12,19982,127
15,15,vg giraffe,None,125,0.35,104564,154,104564,68,0,35012,20,129,0.9998087661592595,0.997881396369744,0.9994311879639373,0.9988441515021255,0.9982707739358472,104564,20,35141,222
15,15,SAFARI,None,125,0.35,104564,154,104564,68,0,35012,20,129,0.9998087661592595,0.997881396369744,0.9994311879639373,0.9988441515021255,0.9982707739358472,104564,20,35141,222
15,15,vg giraffe,None,125,0.3,89465,132,89465,60,0,29887,19,116,0.9997876715390461,0.9978585051920096,0.9993671307707681,0.998822156848516,0.998236950509279,89465,19,30003,192
15,15,SAFARI,None,125,0.3,89465,132,89465,60,0,29887,19,116,0.9997876715390461,0.9978585051920096,0.9993671307707681,0.998822156848516,0.998236950509279,89465,19,30003,192
15,15,vg giraffe,None,125,0.45,134852,204,134852,87,0,45257,25,170,0.9998146459366682,0.9978467253205864,0.9994499691982751,0.9988297163173098,0.9982502284116394,134852,25,45427,291
15,15,SAFARI,None,125,0.45,134852,204,134852,87,0,45257,25,170,0.9998146459366682,0.9978467253205864,0.9994499691982751,0.9988297163173098,0.9982502284116394,134852,25,45427,291
15,15,vg giraffe,None,125,0.4,119514,178,119514,80,0,40044,23,144,0.9998075909551017,0.9978459072237251,0.9994280172092214,0.9988257859085952,0.998243563378609,119514,23,40188,258
15,15,SAFARI,None,125,0.4,119514,178,119514,80,0,40044,23,144,0.9998075909551017,0.9978459072237251,0.9994280172092214,0.9988257859085952,0.998243563378609,119514,23,40188,258
15,15,vg giraffe,None,125,0.55,164851,250,164851,102,0,55340,30,196,0.9998180505940648,0.9978692880879887,0.9994601015009178,0.9988427188230874,0.9982696846024578,164851,30,55536,352
15,15,SAFARI,None,125,0.55,164851,250,164851,102,0,55340,30,196,0.9998180505940648,0.9978692880879887,0.9994601015009178,0.9988427188230874,0.9982696846024578,164851,30,55536,352
15,15,vg giraffe,None,125,0.5,149934,229,149934,96,0,50383,28,180,0.9998132860324616,0.9978370679959271,0.999446541875037,0.9988241995063637,0.9982424695046054,149934,28,50563,325
15,15,SAFARI,None,125,0.5,149934,229,149934,96,0,50383,28,180,0.9998132860324616,0.9978370679959271,0.999446541875037,0.9988241995063637,0.9982424695046054,149934,28,50563,325
15,15,vg giraffe,None,125,0.65,195008,302,195008,117,0,65464,34,237,0.9998256785717948,0.997855976912095,0.9994827717349966,0.9988398566851658,0.9982654444367863,195008,34,65701,419
15,15,SAFARI,None,125,0.65,195008,302,195008,117,0,65464,34,237,0.9998256785717948,0.997855976912095,0.9994827717349966,0.9988398566851658,0.9982654444367863,195008,34,65701,419
15,15,vg giraffe,None,125,0.6,179915,279,179915,113,0,60360,31,218,0.9998277260956064,0.9978259302190153,0.9994885248065469,0.9988258251839679,0.9982442012983779,179915,31,60578,392
15,15,SAFARI,None,125,0.6,179915,279,179915,113,0,60360,31,218,0.9998277260956064,0.9978259302190153,0.9994885248065469,0.9988258251839679,0.9982442012983779,179915,31,60578,392
15,15,vg giraffe,None,125,0.75,224786,349,224786,137,0,75415,37,270,0.9998354260907469,0.9978426080471607,0.9995113705396054,0.9988380230840156,0.9982624238356911,224786,37,75685,486
15,15,SAFARI,None,125,0.75,224786,349,224786,137,0,75415,37,270,0.9998354260907469,0.9978426080471607,0.9995113705396054,0.9988380230840156,0.9982624238356911,224786,37,75685,486
15,15,vg giraffe,None,125,0.7,209981,322,209981,126,0,70491,36,259,0.9998285853049991,0.9978710158770892,0.9994914248580228,0.9988488414683455,0.9982788969293956,209981,36,70750,448
15,15,SAFARI,None,125,0.7,209981,322,209981,126,0,70491,36,259,0.9998285853049991,0.9978710158770892,0.9994914248580228,0.9988488414683455,0.9982788969293956,209981,36,70750,448
15,15,vg giraffe,None,125,0.85,254734,402,254734,159,1,85290,44,300,0.9998233763379243,0.9978025421571124,0.999474513925381,0.9988119370914809,0.9982225090194468,254734,45,85590,561
15,15,SAFARI,None,125,0.85,254734,402,254734,159,1,85290,44,300,0.9998233763379243,0.9978025421571124,0.999474513925381,0.9988119370914809,0.9982225090194468,254734,45,85590,561
15,15,vg giraffe,None,125,0.8,239617,376,239617,154,0,80299,43,287,0.9998205791538012,0.9977930184428704,0.9994666931253023,0.9988057698199484,0.9982137067611043,239617,43,80586,530
15,15,SAFARI,None,125,0.8,239617,376,239617,154,0,80299,43,287,0.9998205791538012,0.9977930184428704,0.9994666931253023,0.9988057698199484,0.9982137067611043,239617,43,80586,530
15,15,vg giraffe,None,125,0.95,284542,453,284542,179,1,95217,50,329,0.9998207967167148,0.9977838091831653,0.9994665104553491,0.9988012643764907,0.9982062709607612,284542,51,95546,632
15,15,SAFARI,None,125,0.95,284542,453,284542,179,1,95217,50,329,0.9998207967167148,0.9977838091831653,0.9994665104553491,0.9988012643764907,0.9982062709607612,284542,51,95546,632
15,15,vg giraffe,None,125,0.9,269573,432,269573,168,1,90237,46,314,0.9998256805874935,0.9977792007343443,0.9994812247510982,0.9988013923855997,0.9982066186029365,269573,47,90551,600
15,15,SAFARI,None,125,0.9,269573,432,269573,168,1,90237,46,314,0.9998256805874935,0.9977792007343443,0.9994812247510982,0.9988013923855997,0.9982066186029365,269573,47,90551,600
15,15,vg giraffe,Single-stranded,125,0.15,44734,66,44734,100,0,14958,6,51,0.999865891819401,0.9963028953229399,0.9996003996003996,0.9980812137438643,0.9971292664608195,44734,6,15009,166
15,15,SAFARI,Single-stranded,125,0.15,44734,66,44734,100,0,14958,6,51,0.999865891819401,0.9963028953229399,0.9996003996003996,0.9980812137438643,0.9971292664608195,44734,6,15009,166
15,15,vg giraffe,Single-stranded,125,0.1,29813,41,29813,71,0,10014,3,27,0.9998993828816742,0.9962573099415205,0.9997013142174432,0.9980750238529652,0.9971227701468638,29813,3,10041,112
15,15,SAFARI,Single-stranded,125,0.1,29813,41,29813,71,0,10014,3,27,0.9998993828816742,0.9962573099415205,0.9997013142174432,0.9980750238529652,0.9971227701468638,29813,3,10041,112
15,15,vg giraffe,Single-stranded,125,0.25,74599,121,74599,162,0,24987,15,95,0.9997989653416249,0.9962207206004113,0.9994023190022712,0.998006635629047,0.9970193740685543,74599,15,25082,283
15,15,SAFARI,Single-stranded,125,0.25,74599,121,74599,162,0,24987,15,95,0.9997989653416249,0.9962207206004113,0.9994023190022712,0.998006635629047,0.9970193740685543,74599,15,25082,283
15,15,vg giraffe,Single-stranded,125,0.2,59669,98,59669,136,0,19911,11,65,0.9998156836461126,0.9960936847904112,0.9994496422674739,0.9979512138012929,0.9969332832644887,59669,11,19976,234
15,15,SAFARI,Single-stranded,125,0.2,59669,98,59669,136,0,19911,11,65,0.9998156836461126,0.9960936847904112,0.9994496422674739,0.9979512138012929,0.9969332832644887,59669,11,19976,234
15,15,vg giraffe,Single-stranded,125,0.35,104401,162,104401,222,1,35009,17,121,0.9998276175791762,0.9963353533425586,0.999487879822465,0.9980784306227414,0.997127196586938,104401,18,35130,384
15,15,SAFARI,Single-stranded,125,0.35,104401,162,104401,222,1,35009,17,121,0.9998276175791762,0.9963353533425586,0.999487879822465,0.9980784306227414,0.997127196586938,104401,18,35130,384
15,15,vg giraffe,Single-stranded,125,0.3,89325,138,89325,193,0,29885,16,110,0.9998209108919757,0.9963081110020523,0.9994668621505448,0.9980614200237993,0.9971002866287281,89325,16,29995,331
15,15,SAFARI,Single-stranded,125,0.3,89325,138,89325,193,0,29885,16,110,0.9998209108919757,0.9963081110020523,0.9994668621505448,0.9980614200237993,0.9971002866287281,89325,16,29995,331
15,15,vg giraffe,Single-stranded,125,0.45,134634,212,134634,300,1,45254,22,159,0.9998291956600845,0.9962115045950306,0.9994937934677348,0.9980170717152888,0.9970373569901763,134634,23,45413,512
15,15,SAFARI,Single-stranded,125,0.45,134634,212,134634,300,1,45254,22,159,0.9998291956600845,0.9962115045950306,0.9994937934677348,0.9980170717152888,0.9970373569901763,134634,23,45413,512
15,15,vg giraffe,Single-stranded,125,0.4,119326,187,119326,262,1,40041,19,138,0.9998324200224558,0.9962513045293259,0.9995024751859499,0.9980386498885501,0.9970682735944592,119326,20,40179,449
15,15,SAFARI,Single-stranded,125,0.4,119326,187,119326,262,1,40041,19,138,0.9998324200224558,0.9962513045293259,0.9995024751859499,0.9980386498885501,0.9970682735944592,119326,20,40179,449
15,15,vg giraffe,Single-stranded,125,0.55,164585,253,164585,367,1,55338,27,187,0.9998299040780497,0.996247086952574,0.9994959768149335,0.9980352800635501,0.997064659038404,164585,28,55525,620
15,15,SAFARI,Single-stranded,125,0.55,164585,253,164585,367,1,55338,27,187,0.9998299040780497,0.996247086952574,0.9994959768149335,0.9980352800635501,0.997064659038404,164585,28,55525,620
15,15,vg giraffe,Single-stranded,125,0.5,149701,234,149701,326,1,50380,24,175,0.9998330283317527,0.9962731513832598,0.9995057334914986,0.9980499154963381,0.9970872481216485,149701,25,50555,560
15,15,SAFARI,Single-stranded,125,0.5,149701,234,149701,326,1,50380,24,175,0.9998330283317527,0.9962731513832598,0.9995057334914986,0.9980499154963381,0.9970872481216485,149701,25,50555,560
15,15,vg giraffe,Single-stranded,125,0.65,194703,294,194703,434,1,65462,32,235,0.9998305398077397,0.9962749000926158,0.9994979461433136,0.9980495531400656,0.9970860886579543,194703,33,65697,728
15,15,SAFARI,Single-stranded,125,0.65,194703,294,194703,434,1,65462,32,235,0.9998305398077397,0.9962749000926158,0.9994979461433136,0.9980495531400656,0.9970860886579543,194703,33,65697,728
15,15,vg giraffe,Single-stranded,125,0.6,179632,270,179632,407,1,60358,30,214,0.9998274547346977,0.996245334398172,0.9994884741679455,0.9980331803584723,0.9970611675632596,179632,31,60572,677
15,15,SAFARI,Single-stranded,125,0.6,179632,270,179632,407,1,60358,30,214,0.9998274547346977,0.996245334398172,0.9994884741679455,0.9980331803584723,0.9970611675632596,179632,31,60572,677
15,15,vg giraffe,Single-stranded,125,0.75,224406,350,224406,520,1,75413,39,270,0.9998217834133822,0.9961380706333565,0.9994717589107669,0.9979765277215702,0.9969767341419739,224406,40,75683,870
15,15,SAFARI,Single-stranded,125,0.75,224406,350,224406,520,1,75413,39,270,0.9998217834133822,0.9961380706333565,0.9994717589107669,0.9979765277215702,0.9969767341419739,224406,40,75683,870
15,15,vg giraffe,Single-stranded,125,0.7,209617,328,209617,488,1,70489,37,256,0.9998187498509457,0.9961222812011424,0.9994631479310003,0.9979670926091676,0.9969631884387802,209617,38,70745,816
15,15,SAFARI,Single-stranded,125,0.7,209617,328,209617,488,1,70489,37,256,0.9998187498509457,0.9961222812011424,0.9994631479310003,0.9979670926091676,0.9969631884387802,209617,38,70745,816
15,15,vg giraffe,Single-stranded,125,0.85,254285,400,254285,613,1,85291,45,302,0.9998191333341198,0.9960320879912886,0.9994628615467253,0.9979220177815628,0.9968938542897955,254285,46,85593,1013
15,15,SAFARI,Single-stranded,125,0.85,254285,400,254285,613,1,85291,45,302,0.9998191333341198,0.9960320879912886,0.9994628615467253,0.9979220177815628,0.9968938542897955,254285,46,85593,1013
15,15,vg giraffe,Single-stranded,125,0.8,239205,376,239205,570,1,80299,43,287,0.9998160911853341,0.9960608117392807,0.9994542974079127,0.9979349186483103,0.9969137823000739,239205,44,80586,946
15,15,SAFARI,Single-stranded,125,0.8,239205,376,239205,570,1,80299,43,287,0.9998160911853341,0.9960608117392807,0.9994542974079127,0.9979349186483103,0.9969137823000739,239205,44,80586,946
15,15,vg giraffe,Single-stranded,125,0.95,284043,450,284043,684,1,95218,49,338,0.9998240012953504,0.9960235222335602,0.9994770202706943,0.9979201433414724,0.9968906174908019,284043,50,95556,1134
15,15,SAFARI,Single-stranded,125,0.95,284043,450,284043,684,1,95218,49,338,0.9998240012953504,0.9960235222335602,0.9994770202706943,0.9979201433414724,0.9968906174908019,284043,50,95556,1134
15,15,vg giraffe,Single-stranded,125,0.9,269102,422,269102,652,1,90238,46,318,0.9998253755354841,0.9960248134549331,0.9994812533801309,0.9979214759189727,0.9968928346716411,269102,47,90556,1074
15,15,SAFARI,Single-stranded,125,0.9,269102,422,269102,652,1,90238,46,318,0.9998253755354841,0.9960248134549331,0.9994812533801309,0.9979214759189727,0.9968928346716411,269102,47,90556,1074
18,8,vg giraffe,High,125,0.15,39334,59,39334,5503,0,14956,8,50,0.9997966549743277,0.8761136849607983,0.9994671639802851,0.9338778223604549,0.9070272074778835,39334,8,15006,5562
18,8,SAFARI,High,125,0.15,39396,59,39396,5441,0,14956,8,50,0.9997969749264034,0.8774946543121882,0.9994671639802851,0.9346619217081852,0.9080620931397095,39396,8,15006,5500
18,8,vg giraffe,High,125,0.1,26211,38,26211,3674,0,10014,7,30,0.9997330078571973,0.8759482672191959,0.9993035518853846,0.9337560784453428,0.9069645269425126,26211,7,10044,3712
18,8,SAFARI,High,125,0.1,26254,38,26254,3631,0,10014,7,30,0.9997334450325578,0.8773852889081977,0.9993035518853846,0.9345721201765627,0.9080402261469955,26254,7,10044,3669
18,8,vg giraffe,High,125,0.25,65573,103,65573,9204,0,24986,13,101,0.9998017869667307,0.8757077991452992,0.9994820717131474,0.9336494240599149,0.9067813562712542,65573,13,25087,9307
18,8,SAFARI,High,125,0.25,65692,103,65692,9085,0,24986,13,101,0.9998021459554067,0.8772970085470085,0.9994820717131474,0.9345520503609916,0.9079715943188638,65692,13,25087,9188
18,8,vg giraffe,High,125,0.2,52522,78,52522,7300,0,19910,11,71,0.9997906078084252,0.8768280467445743,0.9994497799119648,0.9342808606014249,0.9075126420667902,52522,11,19981,7378
18,8,SAFARI,High,125,0.2,52614,78,52614,7208,0,19910,11,71,0.999790973871734,0.8783639398998331,0.9994497799119648,0.9351521884025772,0.9086641966654985,52614,11,19981,7286
18,8,vg giraffe,High,125,0.35,91745,154,91745,12887,0,35010,16,133,0.9998256339839365,0.8755463516118566,0.9995449244859069,0.9335680524251198,0.9066990603451356,91745,16,35143,13041
18,8,SAFARI,High,125,0.35,91940,154,91940,12692,0,35010,16,133,0.9998260037409196,0.8774072872330273,0.9995449244859069,0.9346250419330899,0.9080924648969237,91940,16,35143,12846
18,8,vg giraffe,High,125,0.3,78480,123,78480,11053,0,29885,15,120,0.9998089050257978,0.8753457660390828,0.9995003331112592,0.933446723480681,0.9064891874728433,78480,15,30005,11176
18,8,SAFARI,High,125,0.3,78636,123,78636,10897,0,29885,15,120,0.9998092840523325,0.8770857499776925,0.9995003331112592,0.9344352878965225,0.9077927069755005,78636,15,30005,11020
18,8,vg giraffe,High,125,0.45,118252,197,118252,16696,0,45255,21,174,0.9998224446830638,0.8750009249324799,0.9995379537953796,0.9332565169009305,0.9063429220078075,118252,21,45429,16893
18,8,SAFARI,High,125,0.45,118494,197,118494,16454,0,45255,21,174,0.9998228072395899,0.8767915942136224,0.9995379537953796,0.9342742253410076,0.9076829369583875,118494,21,45429,16651
18,8,vg giraffe,High,125,0.4,104801,172,104801,14800,0,40042,19,148,0.9998187368822744,0.874996869077338,0.9995274689746076,0.9332525946935123,0.9062957082671801,104801,19,40190,14972
18,8,SAFARI,High,125,0.4,105018,172,105018,14583,0,40042,19,148,0.9998191113607586,0.8768086296577693,0.9995274689746076,0.9342822828166006,0.907652110862472,105018,19,40190,14755
18,8,vg giraffe,High,125,0.55,144547,237,144547,20420,0,55338,23,203,0.999840907518849,0.8749606547056972,0.9995860629184364,0.9332416535926191,0.9063270039136107,144547,23,55541,20657
18,8,SAFARI,High,125,0.55,144838,237,144838,20129,0,55338,23,203,0.999841227107365,0.8767221132660226,0.9995860629184364,0.9342428200538596,0.9076451297289462,144838,23,55541,20366
18,8,vg giraffe,High,125,0.5,131518,212,131518,18532,0,50381,22,186,0.9998327504941462,0.8752578828978718,0.9995651228527941,0.9334071440231084,0.9065675550532484,131518,22,50567,18744
18,8,SAFARI,High,125,0.5,131782,212,131782,18268,0,50381,22,186,0.9998330854905769,0.8770148141246623,0.9995651228527941,0.9344054228442988,0.9078819622506236,131782,22,50567,18480
18,8,vg giraffe,High,125,0.65,170970,280,170970,24171,0,65462,29,242,0.9998304083649612,0.8748803864477206,0.9995588212921972,0.9331914196823318,0.9062622054419998,170970,29,65704,24451
18,8,SAFARI,High,125,0.65,171317,280,171317,23824,0,65462,29,242,0.9998307518121229,0.8766560400366389,0.9995588212921972,0.9342007323450584,0.9075909233632263,171317,29,65704,24104
18,8,vg giraffe,High,125,0.6,157745,259,157745,22302,0,60358,26,223,0.9998352041883489,0.8748738256075782,0.9995710066493969,0.9331897762935663,0.9062441628305654,157745,26,60581,22561
18,8,SAFARI,High,125,0.6,158068,259,158068,21979,0,60358,26,223,0.9998355408807419,0.8766652246736104,0.9995710066493969,0.9342080378250591,0.907584895792257,158068,26,60581,22238
18,8,vg giraffe,High,125,0.75,197034,328,197034,27898,0,75413,31,276,0.9998426914977292,0.8746959069519666,0.9995905969360803,0.9330918131770556,0.9061166854940528,197034,31,75689,28226
18,8,SAFARI,High,125,0.75,197436,328,197436,27496,0,75413,31,276,0.9998430117437344,0.8764805114090385,0.9995905969360803,0.9341064091009091,0.9074523224134494,197436,31,75689,27824
18,8,vg giraffe,High,125,0.7,184012,306,184012,26099,0,70489,31,264,0.9998315611025684,0.874511089883422,0.999562047920434,0.9329817979009278,0.9059889545200764,184012,31,70753,26405
18,8,SAFARI,High,125,0.7,184387,306,184387,25724,0,70489,31,264,0.9998319036102766,0.8762932652779956,0.999562047920434,0.9339952131903199,0.9073225201901842,184387,31,70753,26030
18,8,vg giraffe,High,125,0.85,223359,379,223359,31545,0,85287,36,308,0.9998388504666622,0.8749466278600612,0.9995795915030772,0.9332327786110914,0.9062520166376271,223359,36,85595,31924
18,8,SAFARI,High,125,0.85,223866,379,223866,31038,0,85287,36,308,0.9998392153710105,0.876932659048977,0.9995795915030772,0.9343614679090539,0.9077391952222554,223866,36,85595,31417
18,8,vg giraffe,High,125,0.8,210069,351,210069,29715,0,80297,35,295,0.9998334158321593,0.8747954275719908,0.9995659022411847,0.933144396642672,0.9061578366514736,210069,35,80592,30066
18,8,SAFARI,High,125,0.8,210527,351,210527,29257,0,80297,35,295,0.9998337781745994,0.8767026880712933,0.9995659022411847,0.9342285393512715,0.9075856865838223,210527,35,80592,29608
18,8,vg giraffe,High,125,0.95,249424,416,249424,35324,0,95215,37,342,0.9998516802225599,0.8746686117462232,0.9996129464192314,0.9330801963993454,0.9060374305989631,249424,37,95557,35740
18,8,SAFARI,High,125,0.95,249974,416,249974,34774,0,95215,37,342,0.9998520065117135,0.8765973264507442,0.9996129464192314,0.9341766711823236,0.9074819176484802,249974,37,95557,35190
18,8,vg giraffe,High,125,0.9,236358,401,236358,33404,0,90235,36,324,0.9998477118708596,0.8748718366319592,0.9996026270765495,0.9331940926687421,0.906194734420304,236358,36,90559,33805
18,8,SAFARI,High,125,0.9,236890,401,236890,32872,0,90235,36,324,0.9998480538227126,0.8768410182001236,0.9996026270765495,0.9343133059482654,0.9076694071926333,236890,36,90559,33273
18,8,vg giraffe,Mid,125,0.15,44488,60,44488,350,0,14956,9,51,0.9997977391734274,0.9908681901198272,0.9994006393180608,0.9953129369651545,0.9930066428547585,44488,9,15007,410
18,8,SAFARI,Mid,125,0.15,44492,60,44492,346,0,14956,9,51,0.9997977573537673,0.9909572809479265,0.9994006393180608,0.9953578899092831,0.9930734052141402,44492,9,15007,406
18,8,vg giraffe,Mid,125,0.1,29652,44,29652,229,0,10014,7,29,0.9997639839509087,0.9908771929824561,0.9993034825870647,0.9953007518796991,0.9929956222639149,29652,7,10043,273
18,8,SAFARI,Mid,125,0.1,29654,44,29654,227,0,10014,7,29,0.9997639998651427,0.9909440267335005,0.9993034825870647,0.9953344745409995,0.9930456535334584,29654,7,10043,271
18,8,vg giraffe,Mid,125,0.25,74207,102,74207,572,0,24986,17,94,0.9997709635697348,0.9909990518289019,0.999322628202574,0.9953656819020154,0.9930884794654824,74207,17,25080,674
18,8,SAFARI,Mid,125,0.25,74211,102,74211,568,0,24986,17,94,0.9997709759120548,0.991052469918938,0.999322628202574,0.9953926322354788,0.9931284882674188,74211,17,25080,670
18,8,vg giraffe,Mid,125,0.2,59360,80,59360,461,0,19910,14,66,0.9997642065550578,0.9909684312448874,0.9992996498249125,0.9953468874449801,0.9930530347598603,59360,14,19976,541
18,8,SAFARI,Mid,125,0.2,59364,80,59364,457,0,19910,14,66,0.9997642224392873,0.991035208093354,0.9992996498249125,0.9953805783080005,0.9931031029778072,59364,14,19976,537
18,8,vg giraffe,Mid,125,0.35,103803,156,103803,828,0,35010,20,119,0.999807364456816,0.990609522173552,0.9994309937693818,0.9951871914098077,0.9928252915618568,103803,20,35129,984
18,8,SAFARI,Mid,125,0.35,103808,156,103808,823,0,35010,20,119,0.9998073737334823,0.9906572380161661,0.9994309937693818,0.9952112743570692,0.9928610221815687,103808,20,35129,979
18,8,vg giraffe,Mid,125,0.3,88838,131,88838,688,0,29885,19,110,0.9997861732896677,0.9908651862096657,0.9993669620843606,0.9953056903100037,0.9929974680582597,88838,19,29995,819
18,8,SAFARI,Mid,125,0.3,88843,131,88843,683,0,29885,19,110,0.9997861853210597,0.9909209543036238,0.9993669620843606,0.9953338300124918,0.9930392492750959,88843,19,29995,814
18,8,vg giraffe,Mid,125,0.45,133876,205,133876,1063,1,45256,25,159,0.9998058281429703,0.9906174154975433,0.999427829493189,0.9951904135352319,0.9928343993133427,133876,26,45415,1268
18,8,SAFARI,Mid,125,0.45,133882,205,133882,1057,1,45256,25,159,0.9998058368432058,0.9906618125850944,0.999427829493189,0.9952128213133521,0.9928676246642855,133882,26,45415,1262
18,8,vg giraffe,Mid,125,0.4,118646,176,118646,951,1,40041,22,136,0.9998061835862778,0.9905905337596954,0.9994278606965175,0.9951770241819813,0.9928112869046651,118646,23,40177,1127
18,8,SAFARI,Mid,125,0.4,118652,176,118652,945,1,40041,22,136,0.999806193385296,0.990640628522288,0.9994278606965175,0.9952023082600818,0.9928487932338582,118652,23,40177,1121
18,8,vg giraffe,Mid,125,0.55,163642,250,163642,1312,1,55339,28,191,0.9998228152818764,0.9905450231229268,0.9994780323619935,0.995162295705055,0.9927931763927832,163642,29,55530,1562
18,8,SAFARI,Mid,125,0.55,163651,250,163651,1303,1,55339,28,191,0.999822825024438,0.9905995012227307,0.9994780323619935,0.9951897933617934,0.9928339440938926,163651,29,55530,1553
18,8,vg giraffe,Mid,125,0.5,148845,229,148845,1186,1,50382,27,172,0.9998119202273078,0.9905829894848929,0.9994464433988375,0.9951760588099607,0.9928152478067337,148845,28,50554,1415
18,8,SAFARI,Mid,125,0.5,148851,229,148851,1180,1,50382,27,172,0.9998119278071455,0.9906229202715293,0.9994464433988375,0.9951962131316879,0.9928451220362274,148851,28,50554,1409
18,8,vg giraffe,Mid,125,0.65,193599,298,193599,1528,1,65461,34,237,0.9998192466199118,0.990656261993092,0.9994675429388588,0.9952166637964937,0.9928740455969184,193599,35,65698,1826
18,8,SAFARI,Mid,125,0.65,193608,298,193608,1519,1,65461,34,237,0.9998192550208373,0.9907023154662914,0.9994675429388588,0.9952399066487092,0.992908507493548,193608,35,65698,1817
18,8,vg giraffe,Mid,125,0.6,178614,272,178614,1422,1,60359,32,213,0.9998152781742766,0.9906049648379439,0.9994554904710833,0.995188811968074,0.9928314370747946,178614,33,60572,1694
18,8,SAFARI,Mid,125,0.6,178623,272,178623,1413,1,60359,32,213,0.9998152874798495,0.9906548794285334,0.9994554904710833,0.9952140047469941,0.9928687949591761,178623,33,60572,1685
18,8,vg giraffe,Mid,125,0.75,223155,340,223155,1771,1,75412,38,270,0.9998252641200033,0.9906288565518099,0.9994849513345043,0.995205815457343,0.9928568343483274,223155,39,75682,2111
18,8,SAFARI,Mid,125,0.75,223166,340,223166,1760,1,75412,38,270,0.9998252727313456,0.9906776877114167,0.9994849513345043,0.9952304608324729,0.9928933807772429,223166,39,75682,2100
18,8,vg giraffe,Mid,125,0.7,208457,320,208457,1646,1,70488,36,260,0.9998225368595739,0.9906569148809778,0.9994772903863813,0.9952186232595001,0.9928771585445649,208457,37,70748,1966
18,8,SAFARI,Mid,125,0.7,208466,320,208466,1637,1,70488,36,260,0.9998225445197432,0.9906996858708411,0.9994772903863813,0.9952402094880719,0.9929091633239453,208466,37,70748,1957
18,8,vg giraffe,Mid,125,0.85,252862,401,252862,2026,1,85286,41,305,0.999833929079809,0.9904931273967934,0.9995095348755737,0.9951416095853347,0.9927578742351623,252862,42,85591,2427
18,8,SAFARI,Mid,125,0.85,252874,401,252874,2014,1,85286,41,305,0.9998339369593067,0.9905401329473655,0.9995095348755737,0.9951653368227389,0.9927930729023061,252874,42,85591,2415
18,8,vg giraffe,Mid,125,0.8,237868,376,237868,1897,1,80296,40,288,0.9998276651997192,0.9905347275142521,0.999491472868217,0.9951595021441272,0.9927860184682915,237868,41,80584,2273
18,8,SAFARI,Mid,125,0.8,237880,376,237880,1885,1,80296,40,288,0.999827673891754,0.9905846981564997,0.999491472868217,0.9951847249938293,0.9928234289170299,237880,41,80584,2261
18,8,vg giraffe,Mid,125,0.95,282441,445,282441,2283,1,95212,46,336,0.9998336212511681,0.9904337427981302,0.9995083424865318,0.9951114845760731,0.9927120210944312,282441,47,95548,2728
18,8,SAFARI,Mid,125,0.95,282454,445,282454,2270,1,95212,46,336,0.9998336289075083,0.990479329800925,0.9995083424865318,0.9951344971550372,0.9927461629775924,282454,47,95548,2715
18,8,vg giraffe,Mid,125,0.9,267599,419,267599,2150,1,90234,42,320,0.9998393376226452,0.9904911018329335,0.9995253705972604,0.9951432662092561,0.9927598298061064,267599,43,90554,2569
18,8,SAFARI,Mid,125,0.9,267611,419,267611,2138,1,90234,42,320,0.9998393448257825,0.9905355186402535,0.9995253705972604,0.9951656867885657,0.9927930924563081,267611,43,90554,2557
18,8,vg giraffe,None,125,0.15,44811,72,44811,17,0,14958,9,49,0.9997991967871486,0.9980178173719376,0.9994006393180608,0.9989077128845295,0.9983643767941786,44811,9,15007,89
18,8,SAFARI,None,125,0.15,44811,72,44811,17,0,14958,9,49,0.9997991967871486,0.9980178173719376,0.9994006393180608,0.9989077128845295,0.9983643767941786,44811,9,15007,89
18,8,vg giraffe,None,125,0.1,29868,46,29868,11,0,10014,6,31,0.9997991564571199,0.9980952380952381,0.9994030444731867,0.9989464706767672,0.9984240544326596,29868,6,10045,57
18,8,SAFARI,None,125,0.1,29868,46,29868,11,0,10014,6,31,0.9997991564571199,0.9980952380952381,0.9994030444731867,0.9989464706767672,0.9984240544326596,29868,6,10045,57
18,8,vg giraffe,None,125,0.25,74740,111,74740,32,0,24988,17,97,0.9997725965461428,0.9980903542860196,0.9993227631264441,0.9989307671745523,0.9983997599639945,74740,17,25085,143
18,8,SAFARI,None,125,0.25,74740,111,74740,32,0,24988,17,97,0.9997725965461428,0.9980903542860196,0.9993227631264441,0.9989307671745523,0.9983997599639945,74740,17,25085,143
18,8,vg giraffe,None,125,0.2,59791,91,59791,21,0,19912,14,68,0.999765905860714,0.9981303106689148,0.9992997899369811,0.998947438767668,0.9984229695733257,59791,14,19980,112
18,8,SAFARI,None,125,0.2,59791,91,59791,21,0,19912,14,68,0.999765905860714,0.9981303106689148,0.9992997899369811,0.998947438767668,0.9984229695733257,59791,14,19980,112
18,8,vg giraffe,None,125,0.35,104580,154,104580,52,0,35012,21,128,0.9997992371009837,0.998034088523276,0.9994027473621342,0.9989158830299875,0.9983779573695756,104580,21,35140,206
18,8,SAFARI,None,125,0.35,104580,154,104580,52,0,35012,21,128,0.9997992371009837,0.998034088523276,0.9994027473621342,0.9989158830299875,0.9983779573695756,104580,21,35140,206
18,8,vg giraffe,None,125,0.3,89481,132,89481,44,0,29887,20,115,0.9997765388096223,0.9980369630926754,0.9993338218639665,0.9989059935922481,0.9983622857811312,89481,20,30002,176
18,8,SAFARI,None,125,0.3,89481,132,89481,44,0,29887,20,115,0.9997765388096223,0.9980369630926754,0.9993338218639665,0.9989059935922481,0.9983622857811312,89481,20,30002,176
18,8,vg giraffe,None,125,0.45,134877,204,134877,62,1,45256,26,169,0.99979985767657,0.9980317145542129,0.9994059667341371,0.9989150036845438,0.9983775852044631,134877,27,45425,266
18,8,SAFARI,None,125,0.45,134877,204,134877,62,1,45256,26,169,0.99979985767657,0.9980317145542129,0.9994059667341371,0.9989150036845438,0.9983775852044631,134877,27,45425,266
18,8,vg giraffe,None,125,0.4,119537,178,119537,57,0,40044,24,143,0.9997992656468246,0.9980379387502922,0.999403148392231,0.9989178257908436,0.9983810779895363,119537,24,40187,235
18,8,SAFARI,None,125,0.4,119537,178,119537,57,0,40044,24,143,0.9997992656468246,0.9980379387502922,0.999403148392231,0.9989178257908436,0.9983810779895363,119537,24,40187,235
18,8,vg giraffe,None,125,0.55,164876,250,164876,77,1,55339,29,197,0.999818078177871,0.9980206170590122,0.9994601015009178,0.998918539028018,0.9983829251389461,164876,30,55536,327
18,8,SAFARI,None,125,0.55,164876,250,164876,77,1,55339,29,197,0.999818078177871,0.9980206170590122,0.9994601015009178,0.998918539028018,0.9983829251389461,164876,30,55536,327
18,8,vg giraffe,None,125,0.5,149961,229,149961,69,1,50382,28,180,0.9998066537769185,0.99801675773165,0.9994267755134313,0.9989109039497217,0.9983719193427931,149961,29,50562,298
18,8,SAFARI,None,125,0.5,149961,229,149961,69,1,50382,28,180,0.9998066537769185,0.99801675773165,0.9994267755134313,0.9989109039497217,0.9983719193427931,149961,29,50562,298
18,8,vg giraffe,None,125,0.65,195032,302,195032,93,1,65463,35,236,0.9998154489716407,0.9979787849171302,0.9994523465429376,0.9988962726795477,0.9983496833383111,195032,36,65699,395
18,8,SAFARI,None,125,0.65,195032,302,195032,93,1,65463,35,236,0.9998154489716407,0.9979787849171302,0.9994523465429376,0.9988962726795477,0.9983496833383111,195032,36,65699,395
18,8,vg giraffe,None,125,0.6,179942,279,179942,86,1,60359,32,217,0.9998166412001667,0.997975674821277,0.9994555264069692,0.9988953097851128,0.9983479719072208,179942,33,60576,365
18,8,SAFARI,None,125,0.6,179942,279,179942,86,1,60359,32,217,0.9998166412001667,0.997975674821277,0.9994555264069692,0.9988953097851128,0.9983479719072208,179942,33,60576,365
18,8,vg giraffe,None,125,0.75,224815,349,224815,108,1,75414,38,269,0.999826554119562,0.9979713413118364,0.9994849581363409,0.99889808631361,0.9983521266204642,224815,39,75683,457
18,8,SAFARI,None,125,0.75,224815,349,224815,108,1,75414,38,269,0.999826554119562,0.9979713413118364,0.9994849581363409,0.99889808631361,0.9983521266204642,224815,39,75683,457
18,8,vg giraffe,None,125,0.7,210008,322,210008,99,1,70490,37,258,0.9998190872475553,0.9979993251880682,0.9994631706834685,0.9989083774302873,0.9983677968813897,210008,38,70748,421
18,8,SAFARI,None,125,0.7,210008,322,210008,99,1,70490,37,258,0.9998190872475553,0.9979993251880682,0.9994631706834685,0.9989083774302873,0.9983677968813897,210008,38,70748,421
18,8,vg giraffe,None,125,0.85,254771,402,254771,122,1,85290,44,300,0.9998234019841769,0.997947472531777,0.999474513925381,0.9988845564984875,0.9983310356964773,254771,45,85590,524
18,8,SAFARI,None,125,0.85,254771,402,254771,122,1,85290,44,300,0.9998234019841769,0.997947472531777,0.999474513925381,0.9988845564984875,0.9983310356964773,254771,45,85590,524
18,8,vg giraffe,None,125,0.8,239654,376,239654,117,1,80298,43,287,0.999816435681566,0.9979470907402549,0.9994542906398443,0.9988808886202837,0.9983259346085742,239654,44,80585,493
18,8,SAFARI,None,125,0.8,239654,376,239654,117,1,80298,43,287,0.999816435681566,0.9979470907402549,0.9994542906398443,0.9988808886202837,0.9983259346085742,239654,44,80585,493
18,8,vg giraffe,None,125,0.95,284583,453,284583,138,1,95217,50,329,0.9998208225299858,0.9979275810557765,0.9994665104553491,0.9988733046921069,0.9983139472281239,284583,51,95546,591
18,8,SAFARI,None,125,0.95,284583,453,284583,138,1,95217,50,329,0.9998208225299858,0.9979275810557765,0.9994665104553491,0.9988733046921069,0.9983139472281239,284583,51,95546,591
18,8,vg giraffe,None,125,0.9,269614,432,269614,127,1,90237,46,314,0.9998257070914963,0.9979309553508308,0.9994812247510982,0.998877432692272,0.9983202641010502,269614,47,90551,559
18,8,SAFARI,None,125,0.9,269614,432,269614,127,1,90237,46,314,0.9998257070914963,0.9979309553508308,0.9994812247510982,0.998877432692272,0.9983202641010502,269614,47,90551,559
18,8,vg giraffe,Single-stranded,125,0.15,44756,66,44756,78,0,14958,6,51,0.9998659577320048,0.996792873051225,0.9996003996003996,0.9983270504784636,0.9974964533088542,44756,6,15009,144
18,8,SAFARI,Single-stranded,125,0.15,44756,66,44756,78,0,14958,6,51,0.9998659577320048,0.996792873051225,0.9996003996003996,0.9983270504784636,0.9974964533088542,44756,6,15009,144
18,8,vg giraffe,Single-stranded,125,0.1,29827,41,29827,57,0,10014,3,27,0.9998994301039222,0.9967251461988305,0.9997013142174432,0.9983097648732323,0.9974730416072456,29827,3,10041,98
18,8,SAFARI,Single-stranded,125,0.1,29827,41,29827,57,0,10014,3,27,0.9998994301039222,0.9967251461988305,0.9997013142174432,0.9983097648732323,0.9974730416072456,29827,3,10041,98
18,8,vg giraffe,Single-stranded,125,0.25,74646,120,74646,116,0,24987,15,95,0.9997990918953671,0.9968483747763147,0.9994023190022712,0.9983215529981343,0.9974894727892858,74646,15,25082,236
18,8,SAFARI,Single-stranded,125,0.25,74646,120,74646,116,0,24987,15,95,0.9997990918953671,0.9968483747763147,0.9994023190022712,0.9983215529981343,0.9974894727892858,74646,15,25082,236
18,8,vg giraffe,Single-stranded,125,0.2,59705,98,59705,100,0,19911,11,65,0.9998157947618729,0.9966946563611171,0.9994496422674739,0.9982527859286568,0.9973839028664414,59705,11,19976,198
18,8,SAFARI,Single-stranded,125,0.2,59705,98,59705,100,0,19911,11,65,0.9998157947618729,0.9966946563611171,0.9994496422674739,0.9982527859286568,0.9973839028664414,59705,11,19976,198
18,8,vg giraffe,Single-stranded,125,0.35,104456,161,104456,168,0,35010,19,119,0.9998181383106006,0.9968602376294317,0.9994594287014908,0.9983369970371787,0.9975130955528717,104456,19,35129,329
18,8,SAFARI,Single-stranded,125,0.35,104456,161,104456,168,0,35010,19,119,0.9998181383106006,0.9968602376294317,0.9994594287014908,0.9983369970371787,0.9975130955528717,104456,19,35129,329
18,8,vg giraffe,Single-stranded,125,0.3,89375,137,89375,144,0,29885,18,108,0.9997986419518307,0.9968657981618632,0.9994002199193629,0.9983300660712989,0.9975013997175496,89375,18,29993,281
18,8,SAFARI,Single-stranded,125,0.3,89375,137,89375,144,0,29885,18,108,0.9997986419518307,0.9968657981618632,0.9994002199193629,0.9983300660712989,0.9975013997175496,89375,18,29993,281
18,8,vg giraffe,Single-stranded,125,0.45,134711,211,134711,224,0,45255,23,158,0.999829293274155,0.9967812587867936,0.9994937934677348,0.998302949459019,0.9974637560775714,134711,23,45413,435
18,8,SAFARI,Single-stranded,125,0.45,134711,211,134711,224,0,45255,23,158,0.999829293274155,0.9967812587867936,0.9994937934677348,0.998302949459019,0.9974637560775714,134711,23,45413,435
18,8,vg giraffe,Single-stranded,125,0.4,119389,186,119389,200,0,40042,21,136,0.9998241353320493,0.9967772907534962,0.9994775989452473,0.9982983882768568,0.9974558365734432,119389,21,40178,386
18,8,SAFARI,Single-stranded,125,0.4,119389,186,119389,200,0,40042,21,136,0.9998241353320493,0.9967772907534962,0.9994775989452473,0.9982983882768568,0.9974558365734432,119389,21,40178,386
18,8,vg giraffe,Single-stranded,125,0.55,164682,252,164682,271,0,55339,25,189,0.9998482153156818,0.9968342362519295,0.9995499792990478,0.9983389509929922,0.9975176437546998,164682,25,55528,523
18,8,SAFARI,Single-stranded,125,0.55,164682,252,164682,271,0,55339,25,189,0.9998482153156818,0.9968342362519295,0.9995499792990478,0.9983389509929922,0.9975176437546998,164682,25,55528,523
18,8,vg giraffe,Single-stranded,125,0.5,149783,233,149783,245,0,50381,24,175,0.9998397938681103,0.9968188685021396,0.9995255041518387,0.998327045869603,0.9975005103539616,149783,24,50556,478
18,8,SAFARI,Single-stranded,125,0.5,149783,233,149783,245,0,50381,24,175,0.9998397938681103,0.9968188685021396,0.9995255041518387,0.998327045869603,0.9975005103539616,149783,24,50556,478
18,8,vg giraffe,Single-stranded,125,0.65,194817,293,194817,321,0,65463,33,234,0.9998306389530408,0.9968582261770139,0.9994979461433136,0.9983422200927025,0.9975226010009152,194817,33,65697,614
18,8,SAFARI,Single-stranded,125,0.65,194817,293,194817,321,0,65463,33,234,0.9998306389530408,0.9968582261770139,0.9994979461433136,0.9983422200927025,0.9975226010009152,194817,33,65697,614
18,8,vg giraffe,Single-stranded,125,0.6,179744,269,179744,296,0,60359,30,214,0.9998331238110072,0.9968664903027581,0.9995049750012376,0.9983476031914865,0.9975302185030218,179744,30,60573,565
18,8,SAFARI,Single-stranded,125,0.6,179744,269,179744,296,0,60359,30,214,0.9998331238110072,0.9968664903027581,0.9995049750012376,0.9983476031914865,0.9975302185030218,179744,30,60573,565
18,8,vg giraffe,Single-stranded,125,0.75,224540,349,224540,387,0,75414,41,268,0.999817437806404,0.996732896535805,0.999458552883536,0.9982727844626181,0.99741859607507,224540,41,75682,736
18,8,SAFARI,Single-stranded,125,0.75,224540,349,224540,387,0,75414,41,268,0.999817437806404,0.996732896535805,0.999458552883536,0.9982727844626181,0.99741859607507,224540,41,75682,736
18,8,vg giraffe,Single-stranded,125,0.7,209744,327,209744,362,0,70490,38,255,0.9998188595780382,0.9967257987102783,0.9994631479310003,0.9982699332484561,0.997414798588985,209744,38,70745,689
18,8,SAFARI,Single-stranded,125,0.7,209744,327,209744,362,0,70490,38,255,0.9998188595780382,0.9967257987102783,0.9994631479310003,0.9982699332484561,0.997414798588985,209744,38,70745,689
18,8,vg giraffe,Single-stranded,125,0.85,254451,399,254451,448,0,85292,46,301,0.9998192513074811,0.9966823085178889,0.9994628615467253,0.9982483154993674,0.9973807477627832,254451,46,85593,847
18,8,SAFARI,Single-stranded,125,0.85,254451,399,254451,448,0,85292,46,301,0.9998192513074811,0.9966823085178889,0.9994628615467253,0.9982483154993674,0.9973807477627832,254451,46,85593,847
18,8,vg giraffe,Single-stranded,125,0.8,239351,375,239351,425,0,80300,44,286,0.9998162033459346,0.9966687625702162,0.9994542974079127,0.9982400020018934,0.9973689214760226,239351,44,80586,800
18,8,SAFARI,Single-stranded,125,0.8,239351,375,239351,425,0,80300,44,286,0.9998162033459346,0.9966687625702162,0.9994542974079127,0.9982400020018934,0.9973689214760226,239351,44,80586,800
18,8,vg giraffe,Single-stranded,125,0.95,284239,449,284239,489,1,95218,49,338,0.9998241226357686,0.9967108146870189,0.9994770202706943,0.9982650412842909,0.9974053463521219,284239,50,95556,938
18,8,SAFARI,Single-stranded,125,0.95,284239,449,284239,489,1,95218,49,338,0.9998241226357686,0.9967108146870189,0.9994770202706943,0.9982650412842909,0.9974053463521219,284239,50,95556,938
18,8,vg giraffe,Single-stranded,125,0.9,269284,421,269284,471,0,90239,47,317,0.9998254935376916,0.9966984484188085,0.9994812533801309,0.9982595221192682,0.9973972986232569,269284,47,90556,892
18,8,SAFARI,Single-stranded,125,0.9,269284,421,269284,471,0,90239,47,317,0.9998254935376916,0.9966984484188085,0.9994812533801309,0.9982595221192682,0.9973972986232569,269284,47,90556,892
20,15,vg giraffe,High,125,0.15,32450,50,32450,12396,0,14956,4,54,0.9998767486288285,0.7227815395580898,0.9997335819901425,0.8390433096315448,0.7921882824236355,32450,4,15010,12446
20,15,SAFARI,High,125,0.15,32471,50,32471,12375,0,14956,4,54,0.9998768283294842,0.7232492872416251,0.9997335819901425,0.8393584159439582,0.7925388082123185,32471,4,15010,12425
20,15,vg giraffe,High,125,0.1,21634,32,21634,8257,0,10014,4,33,0.9998151400314262,0.7229890051131237,0.9996020296487912,0.8391613816644363,0.7925401510982139,21634,4,10047,8289
20,15,SAFARI,High,125,0.1,21646,32,21646,8245,0,10014,4,33,0.9998152424942264,0.7233900344216824,0.9996020296487912,0.8394314854672019,0.7928403462250463,21646,4,10047,8277
20,15,vg giraffe,High,125,0.25,53915,82,53915,20883,0,24986,8,106,0.999851640301912,0.7200186965811965,0.9996812749003984,0.8371699416939047,0.7902280456091219,53915,8,25092,20965
20,15,SAFARI,High,125,0.25,53952,82,53952,20846,0,24986,8,106,0.9998517420311341,0.7205128205128205,0.9996812749003984,0.8375038807823658,0.7905981196239248,53952,8,25092,20928
20,15,vg giraffe,High,125,0.2,43290,65,43290,16545,0,19910,7,75,0.9998383259810149,0.7227045075125209,0.9996498599439776,0.8389778772638741,0.7920067090572273,43290,7,19985,16610
20,15,SAFARI,High,125,0.2,43320,65,43320,16515,0,19910,7,75,0.9998384379255429,0.7232053422370618,0.9996498599439776,0.8393152954168966,0.7923822159915886,43320,7,19985,16580
20,15,vg giraffe,High,125,0.35,75419,115,75419,29252,0,35010,8,141,0.9998939371842974,0.7197430954516825,0.9997724622429535,0.8369984407340204,0.7900961091857516,75419,8,35151,29367
20,15,SAFARI,High,125,0.35,75497,115,75497,29174,0,35010,8,141,0.9998940467518708,0.7204874697001508,0.9997724622429535,0.837501594644214,0.7906534710064669,75497,8,35151,29289
20,15,vg giraffe,High,125,0.3,64496,92,64496,25068,0,29885,8,127,0.9998759766836165,0.7193718211831891,0.9997335109926716,0.8367410482615464,0.7896988535713092,64496,8,30012,25160
20,15,SAFARI,High,125,0.3,64548,92,64548,25016,0,29885,8,127,0.9998760765846707,0.7199518158293924,0.9997335109926716,0.8371332970196872,0.7901333600721949,64548,8,30012,25108
20,15,vg giraffe,High,125,0.45,97140,144,97140,37861,0,45255,9,186,0.9999073587993701,0.7187835288023974,0.9998019801980198,0.8363539307945964,0.7895069077216977,97140,9,45441,38005
20,15,SAFARI,High,125,0.45,97238,144,97238,37763,0,45255,9,186,0.9999074521579072,0.7195086758666618,0.9998019801980198,0.8368446418121106,0.790049558404164,97238,9,45441,37907
20,15,vg giraffe,High,125,0.4,86132,126,86132,33515,0,40042,8,159,0.9999071279312747,0.7191270152705534,0.9998010395682558,0.8365863252927207,0.789670087884887,86132,8,40201,33641
20,15,SAFARI,High,125,0.4,86221,126,86221,33426,0,40042,8,159,0.9999072237878208,0.7198700875823433,0.9998010395682558,0.8370889603013564,0.7902264004700529,86221,8,40201,33552
20,15,vg giraffe,High,125,0.55,118694,169,118694,46341,0,55338,10,216,0.9999157568405446,0.718469286457955,0.999820027355842,0.836144103019288,0.7892810552253949,118694,10,55554,46510
20,15,SAFARI,High,125,0.55,118813,169,118813,46222,0,55338,10,216,0.9999158412091935,0.7191896079998062,0.999820027355842,0.8366317286736824,0.7898200826206697,118813,10,55554,46391
20,15,vg giraffe,High,125,0.5,107993,154,107993,42115,0,50381,10,198,0.9999074099793525,0.7186980074802678,0.9998023285694518,0.8362960525042107,0.7895006746294517,107993,10,50579,42269
20,15,SAFARI,High,125,0.5,108098,154,108098,42010,0,50381,10,198,0.9999074999074999,0.7193967869454686,0.9998023285694518,0.8367689747261678,0.7900234502193169,108098,10,50579,42164
20,15,vg giraffe,High,125,0.65,140456,204,140456,54761,0,65462,12,259,0.9999145712902583,0.7187354480838805,0.999817443293323,0.8363239046232535,0.7894843655467655,140456,12,65721,54965
20,15,SAFARI,High,125,0.65,140606,204,140606,54611,0,65462,12,259,0.9999146624187515,0.7195030216813956,0.999817443293323,0.8368433425882114,0.7900587392879297,140606,12,65721,54815
20,15,vg giraffe,High,125,0.6,129573,188,129573,50545,0,60358,11,238,0.9999151129769107,0.718628331835879,0.9998185028132064,0.8362515731388558,0.7893679461050255,129573,11,60596,50733
20,15,SAFARI,High,125,0.6,129708,188,129708,50410,0,60358,11,238,0.9999152013197758,0.7193770589997005,0.9998185028132064,0.8367583259414563,0.789928314370748,129708,11,60596,50598
20,15,vg giraffe,High,125,0.75,161769,236,161769,63255,0,75413,13,294,0.9999196449543213,0.7181434786468969,0.9998283148441627,0.8359247833568451,0.7890092364941192,161769,13,75707,63491
20,15,SAFARI,High,125,0.75,161948,236,161948,63076,0,75413,13,294,0.9999197337630664,0.7189381159548965,0.9998283148441627,0.8364628984481729,0.7896039603960396,161948,13,75707,63312
20,15,vg giraffe,High,125,0.7,151133,221,151133,59063,0,70489,13,282,0.9999139904463235,0.7182547037549247,0.999816342676311,0.8359981524658221,0.7891294838923048,151133,13,70771,59284
20,15,SAFARI,High,125,0.7,151299,221,151299,58897,0,70489,13,282,0.9999140848049064,0.719043613396256,0.999816342676311,0.8365323211575516,0.7897198089622726,151299,13,70771,59118
20,15,vg giraffe,High,125,0.85,183348,270,183348,71665,0,85287,14,330,0.9999236483022654,0.7182146872294669,0.9998365078067523,0.8359744212290121,0.7889526390819972,183348,14,85617,71935
20,15,SAFARI,High,125,0.85,183556,270,183556,71457,0,85287,14,330,0.9999237348150569,0.7190294692556888,0.9998365078067523,0.8365261260604349,0.789562763629537,183556,14,85617,71727
20,15,vg giraffe,High,125,0.8,172481,253,172481,67401,0,80297,14,316,0.999918838227195,0.7182668082536906,0.9998263608964739,0.8360080459491553,0.7890398488599023,172481,14,80613,67654
20,15,SAFARI,High,125,0.8,172675,253,172675,67207,0,80297,14,316,0.9999189294048839,0.7190746871551419,0.9998263608964739,0.8365550452493071,0.7896446586565741,172675,14,80613,67460
20,15,vg giraffe,High,125,0.95,204838,300,204838,80026,0,95215,16,363,0.9999218955939352,0.7183164775357338,0.9998326254785865,0.8360427576129856,0.7889945844867343,204838,16,95578,80326
20,15,SAFARI,High,125,0.95,205050,300,205050,79814,0,95215,16,363,0.9999219763393249,0.7190599093854765,0.9998326254785865,0.8365461110091181,0.7895513685858209,205050,16,95578,80114
20,15,vg giraffe,High,125,0.9,194051,289,194051,75823,0,90235,14,346,0.9999278592224254,0.7182737828644189,0.9998454660853248,0.8360159232101467,0.7889831964918311,194051,14,90581,76112
20,15,SAFARI,High,125,0.9,194248,289,194248,75626,0,90235,14,346,0.9999279323799817,0.7190029722796978,0.9998454660853248,0.8365096624858697,0.7895292689282012,194248,14,90581,75915
20,15,vg giraffe,Mid,125,0.15,43482,53,43482,1363,0,14956,4,56,0.9999080163730856,0.9684618468528665,0.9997336174746937,0.9839337436640117,0.9762993624194679,43482,4,15012,1416
20,15,SAFARI,Mid,125,0.15,43483,53,43483,1362,0,14956,4,56,0.9999080184882838,0.9684841195598913,0.9997336174746937,0.9839452395768512,0.9763160530093133,43483,4,15012,1415
20,15,vg giraffe,Mid,125,0.1,28992,39,28992,894,0,10014,4,32,0.9998620499379225,0.9688220551378446,0.9996019900497513,0.9840973506899068,0.9765603502188868,28992,4,10046,933
20,15,SAFARI,Mid,125,0.1,28993,39,28993,893,0,10014,4,32,0.9998620546953133,0.9688554720133667,0.9996019900497513,0.9841145921727029,0.9765853658536585,28993,4,10046,932
20,15,vg giraffe,Mid,125,0.25,72520,87,72520,2274,0,24986,11,100,0.9998483407094897,0.9684699723561384,0.9995617006016655,0.9839090440398339,0.9762747804516994,72520,11,25086,2361
20,15,SAFARI,Mid,125,0.25,72521,87,72521,2273,0,24986,11,100,0.9998483428004191,0.9684833268786475,0.9995617006016655,0.9839159368576721,0.9762847826521834,72521,11,25086,2360
20,15,vg giraffe,Mid,125,0.2,58008,69,58008,1824,0,19910,8,72,0.9998621070049641,0.9683978564631642,0.99959979989995,0.9838784908028528,0.9762050794207107,58008,8,19982,1893
20,15,SAFARI,Mid,125,0.2,58009,69,58009,1823,0,19910,8,72,0.9998621093817329,0.9684145506752809,0.99959979989995,0.9838871079902983,0.9762175964751975,58009,8,19982,1892
20,15,vg giraffe,Mid,125,0.35,101464,130,101464,3193,0,35010,13,126,0.9998718921529016,0.9682880509986926,0.9996301459500981,0.983826552379475,0.9761605305282415,101464,13,35136,3323
20,15,SAFARI,Mid,125,0.35,101467,130,101467,3190,0,35010,13,126,0.9998718959400867,0.968316680504261,0.9996301459500981,0.9838413318659794,0.9761819689000686,101467,13,35136,3320
20,15,vg giraffe,Mid,125,0.3,86842,112,86842,2703,0,29885,12,117,0.9998618371059479,0.9686025631015983,0.9996001865795962,0.983984000997105,0.9763769000008357,86842,12,30002,2815
20,15,SAFARI,Mid,125,0.3,86844,112,86844,2701,0,29885,12,117,0.9998618402873722,0.9686248703391815,0.9996001865795962,0.9839955130783569,0.9763936124875701,86844,12,30002,2813
20,15,vg giraffe,Mid,125,0.45,130915,171,130915,4058,0,45257,15,169,0.9998854349652486,0.9687074527910969,0.9996699016306859,0.9840495501251533,0.9764986017664812,130915,15,45426,4229
20,15,SAFARI,Mid,125,0.45,130918,171,130918,4055,0,45257,15,169,0.9998854375902179,0.9687296513348724,0.9996699016306859,0.9840610048970787,0.9765152144419526,130918,15,45426,4226
20,15,vg giraffe,Mid,125,0.4,116002,148,116002,3623,0,40042,14,144,0.9998793269893808,0.9685154417105691,0.9996517412935323,0.9839475123945561,0.9763397573340501,116002,14,40186,3771
20,15,SAFARI,Mid,125,0.4,116005,148,116005,3620,0,40042,14,144,0.9998793301097234,0.9685404890918654,0.9996517412935323,0.9839604397095746,0.9763585104986466,116005,14,40186,3768
20,15,vg giraffe,Mid,125,0.55,160001,206,160001,4997,0,55340,16,203,0.9999000106238712,0.9685056051911576,0.9997120178548929,0.9839524507949978,0.9763592631011537,160001,16,55543,5203
20,15,SAFARI,Mid,125,0.55,160006,206,160006,4992,0,55340,16,203,0.9999000137481097,0.9685358708021597,0.9997120178548929,0.9839680714334033,0.9763819118239923,160006,16,55543,5198
20,15,vg giraffe,Mid,125,0.5,145549,190,145549,4521,0,50383,16,183,0.9998900834678666,0.968647677359244,0.9996836819421929,0.9840209583368545,0.9764640861971101,145549,16,50566,4711
20,15,SAFARI,Mid,125,0.5,145553,190,145553,4517,0,50383,16,183,0.9998900864881946,0.9686742978836683,0.9996836819421929,0.9840346957194864,0.976484002350106,145553,16,50566,4707
20,15,vg giraffe,Mid,125,0.65,189293,247,189293,5885,0,65462,19,252,0.9998996365787695,0.9686222335934501,0.9997109518810947,0.9840124552616463,0.9764472082034631,189293,19,65714,6132
20,15,SAFARI,Mid,125,0.65,189298,247,189298,5880,0,65462,19,252,0.9998996392294406,0.9686478188563388,0.9997109518810947,0.9840256587531385,0.9764663537015906,189298,19,65714,6127
20,15,vg giraffe,Mid,125,0.6,174653,224,174653,5431,0,60360,18,227,0.9998969491214913,0.9686369989129712,0.9997029948024091,0.984018772941498,0.9764520802115286,174653,18,60587,5655
20,15,SAFARI,Mid,125,0.6,174658,224,174658,5426,0,60360,18,227,0.9998969520712634,0.9686647292410764,0.9997029948024091,0.9840330831812139,0.9764728345917406,174658,18,60587,5650
20,15,vg giraffe,Mid,125,0.75,218204,280,218204,6782,0,75413,21,287,0.9999037690457097,0.9686503955323928,0.9997226661031946,0.9840289881869081,0.9764674221810244,218204,21,75700,7062
20,15,SAFARI,Mid,125,0.75,218209,280,218209,6777,0,75413,21,287,0.9999037712505155,0.9686725915140323,0.9997226661031946,0.9840404423038764,0.9764840341941678,218209,21,75700,7057
20,15,vg giraffe,Mid,125,0.7,203834,265,203834,6324,0,70489,20,276,0.9999018905687403,0.9686868830878754,0.9997174542629088,0.9840469058142257,0.9764978236750022,203834,20,70765,6589
20,15,SAFARI,Mid,125,0.7,203839,265,203839,6319,0,70489,20,276,0.9999018929750465,0.9687106447489106,0.9997174542629088,0.9840591674270183,0.9765156041079912,203839,20,70765,6584
20,15,vg giraffe,Mid,125,0.85,247235,331,247235,7723,0,85287,21,325,0.9999150677839972,0.9684514413076944,0.9997547674377868,0.9839317872031361,0.9763142302344818,247235,21,85612,8054
20,15,SAFARI,Mid,125,0.85,247240,331,247240,7718,0,85287,21,325,0.9999150695014579,0.9684710269537661,0.9997547674377868,0.9839418963287234,0.9763288963457917,247240,21,85612,8049
20,15,vg giraffe,Mid,125,0.8,232585,310,232585,7246,0,80297,21,307,0.9999097185799163,0.9685351522647111,0.9997395348837209,0.9839723996133237,0.9763784191591378,232585,21,80604,7556
20,15,SAFARI,Mid,125,0.8,232590,310,232590,7241,0,80297,21,307,0.9999097205205257,0.9685559733656477,0.9997395348837209,0.9839831454970047,0.9763940068461121,232590,21,80604,7551
20,15,vg giraffe,Mid,125,0.95,276175,367,276175,8627,0,95213,23,359,0.9999167264064186,0.9684608074510203,0.9997594016423453,0.9839374241806161,0.9763186645796347,276175,23,95572,8994
20,15,SAFARI,Mid,125,0.95,276181,367,276181,8621,0,95213,23,359,0.999916728215377,0.9684818476061563,0.9997594016423453,0.9839482839395554,0.9763344223718629,276181,23,95572,8988
20,15,vg giraffe,Mid,125,0.9,261635,344,261635,8189,0,90235,21,341,0.9999197419512642,0.9684159485949483,0.9997682042451737,0.9839157315202023,0.9762892741812538,261635,21,90576,8533
20,15,SAFARI,Mid,125,0.9,261641,344,261641,8183,0,90235,21,341,0.999919743791609,0.9684381569986082,0.9997682042451737,0.9839271947802869,0.9763059055063545,261641,21,90576,8527
20,15,vg giraffe,None,125,0.15,44736,56,44736,108,0,14958,5,53,0.9998882456806956,0.996347438752784,0.9996670218433671,0.9981147019778895,0.9971793844715936,44736,5,15011,164
20,15,SAFARI,None,125,0.15,44736,56,44736,108,0,14958,5,53,0.9998882456806956,0.996347438752784,0.9996670218433671,0.9981147019778895,0.9971793844715936,44736,5,15011,164
20,15,vg giraffe,None,125,0.1,29821,37,29821,67,0,10014,4,33,0.9998658843252305,0.9965246449456976,0.9996020296487912,0.9981924686192468,0.9972983790274165,29821,4,10047,104
20,15,SAFARI,None,125,0.1,29821,37,29821,67,0,10014,4,33,0.9998658843252305,0.9965246449456976,0.9996020296487912,0.9981924686192468,0.9972983790274165,29821,4,10047,104
20,15,vg giraffe,None,125,0.25,74620,90,74620,173,0,24988,12,102,0.9998392110622789,0.9964878543861758,0.9995219504421958,0.9981607196602348,0.9972495874381158,74620,12,25090,263
20,15,SAFARI,None,125,0.25,74620,90,74620,173,0,24988,12,102,0.9998392110622789,0.9964878543861758,0.9995219504421958,0.9981607196602348,0.9972495874381158,74620,12,25090,263
20,15,vg giraffe,None,125,0.2,59690,71,59690,142,0,19912,9,73,0.9998492437059248,0.9964442515399896,0.9995498649594878,0.9981438437484322,0.9972214225815738,59690,9,19985,213
20,15,SAFARI,None,125,0.2,59690,71,59690,142,0,19912,9,73,0.9998492437059248,0.9964442515399896,0.9995498649594878,0.9981438437484322,0.9972214225815738,59690,9,19985,213
20,15,vg giraffe,None,125,0.35,104416,129,104416,241,0,35012,13,136,0.9998755135067845,0.9964689939495734,0.9996302721765593,0.9981693473221328,0.9972632496587994,104416,13,35148,370
20,15,SAFARI,None,125,0.35,104416,129,104416,241,0,35012,13,136,0.9998755135067845,0.9964689939495734,0.9996302721765593,0.9981693473221328,0.9972632496587994,104416,13,35148,370
20,15,vg giraffe,None,125,0.3,89334,110,89334,213,0,29887,13,122,0.9998544998712884,0.9963973811303077,0.9995669842115782,0.998122946973252,0.9971924899105106,89334,13,30009,323
20,15,SAFARI,None,125,0.3,89334,110,89334,213,0,29887,13,122,0.9998544998712884,0.9963973811303077,0.9995669842115782,0.998122946973252,0.9971924899105106,89334,13,30009,323
20,15,vg giraffe,None,125,0.45,134665,171,134665,307,0,45257,15,180,0.9998886248886248,0.9964630058530594,0.999669981518965,0.9981728762929772,0.9972701348320828,134665,15,45437,478
20,15,SAFARI,None,125,0.45,134665,171,134665,307,0,45257,15,180,0.9998886248886248,0.9964630058530594,0.999669981518965,0.9981728762929772,0.9972701348320828,134665,15,45437,478
20,15,vg giraffe,None,125,0.4,119348,150,119348,274,0,40044,14,153,0.9998827097401183,0.9964599405537188,0.9996518365621347,0.9981683909439896,0.9972622091097179,119348,14,40197,424
20,15,SAFARI,None,125,0.4,119348,150,119348,274,0,40044,14,153,0.9998827097401183,0.9964599405537188,0.9996518365621347,0.9981683909439896,0.9972622091097179,119348,14,40197,424
20,15,vg giraffe,None,125,0.55,164602,210,164602,391,0,55340,16,210,0.999902805282533,0.9963620515365944,0.9997120541338228,0.9981292883109324,0.9972052235594672,164602,16,55550,601
20,15,SAFARI,None,125,0.55,164602,210,164602,391,0,55340,16,210,0.999902805282533,0.9963620515365944,0.9997120541338228,0.9981292883109324,0.9972052235594672,164602,16,55550,601
20,15,vg giraffe,None,125,0.5,149715,191,149715,353,0,50383,16,192,0.9998931417007834,0.9963795845839517,0.9996837382143069,0.9981332711090369,0.9972118496390341,149715,16,50575,544
20,15,SAFARI,None,125,0.5,149715,191,149715,353,0,50383,16,192,0.9998931417007834,0.9963795845839517,0.9996837382143069,0.9981332711090369,0.9972118496390341,149715,16,50575,544
20,15,vg giraffe,None,125,0.65,194719,254,194719,454,0,65464,18,253,0.9999075676425128,0.9963771638514637,0.9997261732714687,0.9981392440102111,0.9972201162496841,194719,18,65717,708
20,15,SAFARI,None,125,0.65,194719,254,194719,454,0,65464,18,253,0.9999075676425128,0.9963771638514637,0.9997261732714687,0.9981392440102111,0.9972201162496841,194719,18,65717,708
20,15,vg giraffe,None,125,0.6,179646,235,179646,426,0,60360,17,232,0.9999053784028987,0.9963340302927784,0.9997195136035902,0.9981165097091423,0.9971857410881801,179646,17,60592,661
20,15,SAFARI,None,125,0.6,179646,235,179646,426,0,60360,17,232,0.9999053784028987,0.9963340302927784,0.9997195136035902,0.9981165097091423,0.9971857410881801,179646,17,60592,661
20,15,vg giraffe,None,125,0.75,224461,292,224461,519,0,75415,19,288,0.9999153599429793,0.9963999076671757,0.9997490821689865,0.9981545385012184,0.9972424699495671,224461,19,75703,811
20,15,SAFARI,None,125,0.75,224461,292,224461,519,0,75415,19,288,0.9999153599429793,0.9963999076671757,0.9997490821689865,0.9981545385012184,0.9972424699495671,224461,19,75703,811
20,15,vg giraffe,None,125,0.7,209673,269,209673,487,0,70491,19,276,0.9999093909162009,0.996407339292588,0.9997315853417342,0.9981552933559618,0.9972441014881852,209673,19,70767,756
20,15,SAFARI,None,125,0.7,209673,269,209673,487,0,70491,19,276,0.9999093909162009,0.996407339292588,0.9997315853417342,0.9981552933559618,0.9972441014881852,209673,19,70767,756
20,15,vg giraffe,None,125,0.85,254366,337,254366,592,0,85291,21,323,0.9999174486117608,0.9963610724847726,0.9997547731651778,0.9981360927009391,0.9972135042384067,254366,21,85614,929
20,15,SAFARI,None,125,0.85,254366,337,254366,592,0,85291,21,323,0.9999174486117608,0.9963610724847726,0.9997547731651778,0.9981360927009391,0.9972135042384067,254366,21,85614,929
20,15,vg giraffe,None,125,0.8,239275,315,239275,557,0,80299,21,309,0.9999122425782295,0.9963688907211,0.9997395478053802,0.9981374219667406,0.9972161258947053,239275,21,80608,872
20,15,SAFARI,None,125,0.8,239275,315,239275,557,0,80299,21,309,0.9999122425782295,0.9963688907211,0.9997395478053802,0.9981374219667406,0.9972161258947053,239275,21,80608,872
20,15,vg giraffe,None,125,0.95,284139,380,284139,655,0,95218,24,355,0.9999155414322062,0.9963706368743294,0.9997489460966348,0.9981399417216869,0.9972188008015316,284139,24,95573,1035
20,15,SAFARI,None,125,0.95,284139,380,284139,655,0,95218,24,355,0.9999155414322062,0.9963706368743294,0.9997489460966348,0.9981399417216869,0.9972188008015316,284139,24,95573,1035
20,15,vg giraffe,None,125,0.9,269186,363,269186,624,0,90238,22,338,0.9999182788030073,0.9963467852079964,0.999757169032429,0.998129337147582,0.9972032120098345,269186,22,90576,987
20,15,SAFARI,None,125,0.9,269186,363,269186,624,0,90238,22,338,0.9999182788030073,0.9963467852079964,0.999757169032429,0.998129337147582,0.9972032120098345,269186,22,90576,987
20,15,vg giraffe,Single-stranded,125,0.15,44512,55,44512,333,0,14958,3,54,0.9999326069864091,0.991358574610245,0.9998001998001999,0.99562713191299,0.9934740882917467,44512,3,15012,388
20,15,SAFARI,Single-stranded,125,0.15,44512,55,44512,333,0,14958,3,54,0.9999326069864091,0.991358574610245,0.9998001998001999,0.99562713191299,0.9934740882917467,44512,3,15012,388
20,15,vg giraffe,Single-stranded,125,0.1,29668,35,29668,222,0,10014,2,28,0.999932591843613,0.9914118629908104,0.9998008761449622,0.995653997818609,0.9935199779829368,29668,2,10042,257
20,15,SAFARI,Single-stranded,125,0.1,29668,35,29668,222,0,10014,2,28,0.999932591843613,0.9914118629908104,0.9998008761449622,0.995653997818609,0.9935199779829368,29668,2,10042,257
20,15,vg giraffe,Single-stranded,125,0.25,74254,98,74254,530,0,24987,10,100,0.9998653452547668,0.9916134718623968,0.9996015460015141,0.995722312365065,0.9936186599185829,74254,10,25087,628
20,15,SAFARI,Single-stranded,125,0.25,74254,98,74254,530,0,24987,10,100,0.9998653452547668,0.9916134718623968,0.9996015460015141,0.995722312365065,0.9936186599185829,74254,10,25087,628
20,15,vg giraffe,Single-stranded,125,0.2,59385,81,59385,437,0,19911,8,68,0.999865303992053,0.9913526868437307,0.9995997398308901,0.9955907993562232,0.9934159469270246,59385,8,19979,518
20,15,SAFARI,Single-stranded,125,0.2,59385,81,59385,437,0,19911,8,68,0.999865303992053,0.9913526868437307,0.9995997398308901,0.9955907993562232,0.9934159469270246,59385,8,19979,518
20,15,vg giraffe,Single-stranded,125,0.35,103925,131,103925,729,0,35010,11,127,0.9998941656403941,0.9917927184234385,0.9996870376692841,0.9958269651831873,0.9937755926050325,103925,11,35137,860
20,15,SAFARI,Single-stranded,125,0.35,103925,131,103925,729,0,35010,11,127,0.9998941656403941,0.9917927184234385,0.9996870376692841,0.9958269651831873,0.9937755926050325,103925,11,35137,860
20,15,vg giraffe,Single-stranded,125,0.3,88923,112,88923,621,0,29885,10,116,0.999887555800434,0.9918243062371732,0.9996667888440905,0.9958396093824369,0.9937911036459508,88923,10,30001,733
20,15,SAFARI,Single-stranded,125,0.3,88923,112,88923,621,0,29885,10,116,0.999887555800434,0.9918243062371732,0.9996667888440905,0.9958396093824369,0.9937911036459508,88923,10,30001,733
20,15,vg giraffe,Single-stranded,125,0.45,134005,170,134005,971,0,45255,13,168,0.9999029981047322,0.991557278794785,0.9997138832643718,0.995712651023168,0.9936095513395576,134005,13,45423,1141
20,15,SAFARI,Single-stranded,125,0.45,134005,170,134005,971,0,45255,13,168,0.9999029981047322,0.991557278794785,0.9997138832643718,0.995712651023168,0.9936095513395576,134005,13,45423,1141
20,15,vg giraffe,Single-stranded,125,0.4,118780,151,118780,844,0,40042,12,145,0.9998989830965048,0.9916927572531831,0.99970148511157,0.995778963561599,0.9937052270994037,118780,12,40187,995
20,15,SAFARI,Single-stranded,125,0.4,118780,151,118780,844,0,40042,12,145,0.9998989830965048,0.9916927572531831,0.99970148511157,0.995778963561599,0.9937052270994037,118780,12,40187,995
20,15,vg giraffe,Single-stranded,125,0.55,163832,206,163832,1167,0,55339,13,201,0.9999206567182398,0.9916891135256197,0.9997659892355049,0.9957878741832549,0.993721631832142,163832,13,55540,1373
20,15,SAFARI,Single-stranded,125,0.55,163832,206,163832,1167,0,55339,13,201,0.9999206567182398,0.9916891135256197,0.9997659892355049,0.9957878741832549,0.993721631832142,163832,13,55540,1373
20,15,vg giraffe,Single-stranded,125,0.5,149006,191,149006,1064,0,50381,13,186,0.9999127628020588,0.9916478660464125,0.9997429814155793,0.9957631649291633,0.993686548065385,149006,13,50567,1255
20,15,SAFARI,Single-stranded,125,0.5,149006,191,149006,1064,0,50381,13,186,0.9999127628020588,0.9916478660464125,0.9997429814155793,0.9957631649291633,0.993686548065385,149006,13,50567,1255
20,15,vg giraffe,Single-stranded,125,0.65,193839,238,193839,1354,0,65463,17,250,0.9999123060415979,0.9918539024003357,0.9997413661950403,0.9958668026417528,0.9938390494752279,193839,17,65713,1592
20,15,SAFARI,Single-stranded,125,0.65,193839,238,193839,1354,0,65463,17,250,0.9999123060415979,0.9918539024003357,0.9997413661950403,0.9958668026417528,0.9938390494752279,193839,17,65713,1592
20,15,vg giraffe,Single-stranded,125,0.6,178814,220,178814,1275,0,60359,16,228,0.9999105295532069,0.9917086778807491,0.9997359866673267,0.9957927153553359,0.9937280002656572,178814,16,60587,1495
20,15,SAFARI,Single-stranded,125,0.6,178814,220,178814,1275,0,60359,16,228,0.9999105295532069,0.9917086778807491,0.9997359866673267,0.9957927153553359,0.9937280002656572,178814,16,60587,1495
20,15,vg giraffe,Single-stranded,125,0.75,223419,286,223419,1571,0,75414,21,288,0.999906015037594,0.9917567783518884,0.9997226734281526,0.9958147246810901,0.9937607766138757,223419,21,75702,1857
20,15,SAFARI,Single-stranded,125,0.75,223419,286,223419,1571,0,75414,21,288,0.999906015037594,0.9917567783518884,0.9997226734281526,0.9958147246810901,0.9937607766138757,223419,21,75702,1857
20,15,vg giraffe,Single-stranded,125,0.7,208697,268,208697,1468,0,70490,20,273,0.9999041764686154,0.9917503433396854,0.9997174462794739,0.9958105690087081,0.9937556895766955,208697,20,70763,1736
20,15,SAFARI,Single-stranded,125,0.7,208697,268,208697,1468,0,70490,20,273,0.9999041764686154,0.9917503433396854,0.9997174462794739,0.9958105690087081,0.9937556895766955,208697,20,70763,1736
20,15,vg giraffe,Single-stranded,125,0.85,253181,329,253181,1788,0,85292,23,324,0.9999091641522251,0.9917077297902843,0.9997314307733626,0.995791560308514,0.993723180528954,253181,23,85616,2117
20,15,SAFARI,Single-stranded,125,0.85,253181,329,253181,1788,0,85292,23,324,0.9999091641522251,0.9917077297902843,0.9997314307733626,0.995791560308514,0.993723180528954,253181,23,85616,2117
20,15,vg giraffe,Single-stranded,125,0.8,238153,309,238153,1689,0,80300,22,308,0.9999076309436339,0.991680234519115,0.9997271487039563,0.9957769387405242,0.9937028689355043,238153,22,80608,1998
20,15,SAFARI,Single-stranded,125,0.8,238153,309,238153,1689,0,80300,22,308,0.9999076309436339,0.991680234519115,0.9997271487039563,0.9957769387405242,0.9937028689355043,238153,22,80608,1998
20,15,vg giraffe,Single-stranded,125,0.95,282814,369,282814,1994,0,95219,23,364,0.9999186810777939,0.9917139180228419,0.9997594293245193,0.9957993993105804,0.9937339639637274,282814,23,95583,2363
20,15,SAFARI,Single-stranded,125,0.95,282814,369,282814,1994,0,95219,23,364,0.9999186810777939,0.9917139180228419,0.9997594293245193,0.9957993993105804,0.9937339639637274,282814,23,95583,2363
20,15,vg giraffe,Single-stranded,125,0.9,267937,347,267937,1892,0,90239,23,341,0.9999141662934766,0.9917128094279285,0.9997461452711279,0.9957966016025689,0.9937302337442036,267937,23,90580,2239
20,15,SAFARI,Single-stranded,125,0.9,267937,347,267937,1892,0,90239,23,341,0.9999141662934766,0.9917128094279285,0.9997461452711279,0.9957966016025689,0.9937302337442036,267937,23,90580,2239
20,5,vg giraffe,High,125,0.15,38784,60,38784,6052,0,14956,6,52,0.99984532095901,0.8638631503920171,0.9996003729852138,0.9268933871854312,0.8978801535636789,38784,6,15008,6112
20,5,SAFARI,High,125,0.15,38865,60,38865,5971,0,14956,6,52,0.9998456432816238,0.8656673200285103,0.9996003729852138,0.9279310468322848,0.8992321816057419,38865,6,15008,6031
20,5,vg giraffe,High,125,0.1,25837,38,25837,4048,0,10014,5,32,0.9998065165234888,0.8634495204357852,0.9995025370609889,0.9266385725813682,0.897658478010707,25837,5,10046,4086
20,5,SAFARI,High,125,0.1,25881,38,25881,4004,0,10014,5,32,0.9998068453990574,0.8649199612338335,0.9995025370609889,0.9274848142772671,0.8987591934757593,25881,5,10046,4042
20,5,vg giraffe,High,125,0.25,64654,103,64654,10123,0,24986,12,102,0.9998144310766091,0.863434829059829,0.9995219123505976,0.9266335115302481,0.8975995199039808,64654,12,25088,10226
20,5,SAFARI,High,125,0.25,64797,103,64797,9980,0,24986,12,102,0.9998148405314077,0.8653445512820512,0.9995219123505976,0.9277323196529433,0.8990298059611922,64797,12,25088,10083
20,5,vg giraffe,High,125,0.2,51781,79,51781,8040,0,19910,9,73,0.9998262212782391,0.864457429048414,0.9995498199279712,0.927227146566389,0.8982626545836879,51781,9,19983,8119
20,5,SAFARI,High,125,0.2,51883,79,51883,7938,0,19910,9,73,0.9998265628613273,0.8661602671118531,0.9995498199279712,0.9282059539144125,0.8995393781605167,51883,9,19983,8017
20,5,vg giraffe,High,125,0.35,90432,151,90432,14203,0,35010,14,135,0.9998452115074188,0.8630160517626401,0.9996018089251685,0.9264055072938863,0.897331094358498,90432,14,35145,14354
20,5,SAFARI,High,125,0.35,90684,151,90684,13951,0,35010,15,134,0.9998346178017398,0.8654209531807684,0.9995733667055376,0.9277847405171751,0.8991246561149023,90684,15,35144,14102
20,5,vg giraffe,High,125,0.3,77347,121,77347,12188,0,29885,14,121,0.9998190302607257,0.8627085749977692,0.9995336442371752,0.9262170916733027,0.8970303151843311,77347,14,30006,12309
20,5,SAFARI,High,125,0.3,77541,121,77541,11994,0,29885,14,121,0.9998194829475856,0.8648724011778353,0.9995336442371752,0.9274629061485189,0.8986513586684047,77541,14,30006,12115
20,5,vg giraffe,High,125,0.45,116568,192,116568,18385,0,45255,18,177,0.9998456075343524,0.8625402345628769,0.9996039603960396,0.9261314657312766,0.897034801627952,116568,18,45432,18577
20,5,SAFARI,High,125,0.45,116880,192,116880,18073,0,45255,19,176,0.999837466530937,0.8648488660327797,0.9995819581958196,0.9274571106632176,0.8987568869570033,116880,19,45431,18265
20,5,vg giraffe,High,125,0.4,103332,169,103332,16272,0,40042,17,150,0.9998355088099546,0.8627320013692569,0.9995772090825437,0.92623766369968,0.8971259266667501,103332,17,40192,16441
20,5,SAFARI,High,125,0.4,103618,169,103618,15986,0,40042,18,149,0.9998263151800533,0.8651198517195027,0.9995523390285757,0.9276081088944491,0.8989073770799215,103618,18,40191,16155
20,5,vg giraffe,High,125,0.55,142487,227,142487,22490,0,55338,19,207,0.9998666722804653,0.8624912229728093,0.9996580519760996,0.9261122485457086,0.8970140600086969,142487,19,55545,22717
20,5,SAFARI,High,125,0.55,142864,227,142864,22113,0,55338,20,206,0.9998600263150528,0.8647732500423718,0.9996400547116838,0.9274233335929994,0.8987172053920858,142864,20,55544,22340
20,5,vg giraffe,High,125,0.5,129616,205,129616,20441,0,50381,19,189,0.9998534346434219,0.862599992013949,0.9996244242819585,0.9261692694098186,0.8971127850994021,129616,19,50570,20646
20,5,SAFARI,High,125,0.5,129939,205,129939,20118,0,50381,19,189,0.999853798919651,0.8647495707497571,0.9996244242819585,0.9274070373278138,0.89872094239013,129939,19,50570,20323
20,5,vg giraffe,High,125,0.65,168596,268,168596,26557,0,65462,22,249,0.9998695275711964,0.8627322549777148,0.9996653127044255,0.9262524070223246,0.8971985878064284,168596,22,65711,26825
20,5,SAFARI,High,125,0.65,169045,268,169045,26108,0,65462,23,248,0.9998639600634064,0.8650298586129433,0.9996500996455358,0.927572574206629,0.8989140507133722,169045,23,65710,26376
20,5,vg giraffe,High,125,0.6,155538,248,155538,24520,0,60358,21,228,0.9998650029892195,0.8626335230108815,0.9996535053706668,0.9261935599124649,0.8971039337852253,155538,21,60586,24768
20,5,SAFARI,High,125,0.6,155948,248,155948,24110,0,60358,22,227,0.9998589472334424,0.8649074351380431,0.9996370056264128,0.9275000297374776,0.8988016420865623,155948,22,60585,24358
20,5,vg giraffe,High,125,0.75,194321,311,194321,30628,0,75413,24,283,0.9998765082713731,0.8626520465240167,0.9996830427892235,0.9262091729126202,0.897126054887368,194321,24,75696,30939
20,5,SAFARI,High,125,0.75,194827,311,194827,30122,0,75413,25,282,0.9998716974934823,0.8648983396963509,0.9996698362387745,0.9275002856381157,0.8988039072363612,194827,25,75695,30433
20,5,vg giraffe,High,125,0.7,181475,291,181475,28651,0,70489,24,271,0.9998677678664897,0.8624540792806665,0.9996609403254972,0.9260913052797028,0.8969918314657487,181475,24,70760,28942
20,5,SAFARI,High,125,0.7,181953,291,181953,28173,0,70489,25,270,0.9998626207563551,0.864725758850283,0.9996468128390597,0.9273971380878961,0.898688126998126,181953,25,70759,28464
20,5,vg giraffe,High,125,0.85,220272,358,220272,34653,0,85287,28,316,0.9998729005901044,0.8628541657689701,0.9996730156135044,0.9263241116692564,0.897220413359381,220272,28,85603,35011
20,5,SAFARI,High,125,0.85,220837,358,220837,34088,0,85287,29,315,0.9998686986679707,0.8650673957921209,0.999661337599701,0.9275961936284651,0.898874789536364,220837,29,85602,34446
20,5,vg giraffe,High,125,0.8,207215,333,207215,32587,0,80297,27,303,0.9998697175283002,0.8629104462073417,0.9996651245860568,0.9263551769536655,0.8972852145827748,207215,27,80600,32920
20,5,SAFARI,High,125,0.8,207750,333,207750,32052,0,80297,28,302,0.9998652407858387,0.8651383596726842,0.9996527217929477,0.9276355006440983,0.8989500003117576,207750,28,80599,32385
20,5,vg giraffe,High,125,0.95,246018,395,246018,38751,0,95215,31,348,0.9998740088356385,0.8627246075942265,0.9996757118647613,0.9262499223475329,0.8971078742928579,246018,31,95563,39146
20,5,SAFARI,High,125,0.95,246657,395,246657,38112,0,95215,32,347,0.9998702820150067,0.864965423405479,0.9996652509571731,0.9275382483505781,0.8987834792702977,246657,32,95562,38507
20,5,vg giraffe,High,125,0.9,233095,381,233095,36687,0,90235,28,332,0.9998798917309747,0.8627939429159434,0.9996909321706496,0.9262924063057586,0.8971720654843413,233095,28,90567,37068
20,5,SAFARI,High,125,0.9,233688,381,233688,36094,0,90235,29,331,0.9998759183114622,0.8649889141000063,0.9996798940338871,0.9275541795665635,0.8988130547347529,233688,29,90566,36475
20,5,vg giraffe,Mid,125,0.15,44434,59,44434,405,0,14956,7,53,0.9998424877928039,0.9896654639404874,0.9995338305807139,0.9947279463616113,0.9921387321827954,44434,7,15009,464
20,5,SAFARI,Mid,125,0.15,44434,59,44434,405,0,14956,7,53,0.9998424877928039,0.9896654639404874,0.9995338305807139,0.9947279463616113,0.9921387321827954,44434,7,15009,464
20,5,vg giraffe,Mid,125,0.1,29620,44,29620,261,0,10014,6,30,0.9997974751907108,0.9898078529657477,0.9994029850746269,0.9947775855988984,0.9922201375859913,29620,6,10044,305
20,5,SAFARI,Mid,125,0.1,29620,44,29620,261,0,10014,6,30,0.9997974751907108,0.9898078529657477,0.9994029850746269,0.9947775855988984,0.9922201375859913,29620,6,10044,305
20,5,vg giraffe,Mid,125,0.25,74112,99,74112,670,0,24986,15,96,0.9997976445829455,0.9897303721905423,0.9994023190022712,0.9947385375281863,0.9921582748204605,74112,15,25082,769
20,5,SAFARI,Mid,125,0.25,74112,99,74112,670,0,24986,15,96,0.9997976445829455,0.9897303721905423,0.9994023190022712,0.9947385375281863,0.9921582748204605,74112,15,25082,769
20,5,vg giraffe,Mid,125,0.2,59286,77,59286,538,0,19910,11,69,0.9998144931446785,0.9897330595482546,0.9994497248624312,0.9947482340307724,0.9921643238913019,59286,11,19979,615
20,5,SAFARI,Mid,125,0.2,59286,77,59286,538,0,19910,11,69,0.9998144931446785,0.9897330595482546,0.9994497248624312,0.9947482340307724,0.9921643238913019,59286,11,19979,615
20,5,vg giraffe,Mid,125,0.35,103667,150,103667,970,0,35010,18,121,0.9998263972609346,0.9893116512544495,0.9994878943924436,0.9945412333550788,0.9918677109535787,103667,18,35131,1120
20,5,SAFARI,Mid,125,0.35,103668,150,103668,969,0,35010,18,121,0.9998263989352468,0.9893211944229723,0.9994878943924436,0.9945460563238405,0.9918748570775211,103668,18,35131,1119
20,5,vg giraffe,Mid,125,0.3,88723,128,88723,806,0,29885,17,112,0.999808429118774,0.9895825200486298,0.999433597654428,0.9946691928675931,0.9920532125577626,88723,17,29997,934
20,5,SAFARI,Mid,125,0.3,88723,128,88723,806,0,29885,17,112,0.999808429118774,0.9895825200486298,0.999433597654428,0.9946691928675931,0.9920532125577626,88723,17,29997,934
20,5,vg giraffe,Mid,125,0.45,133709,198,133709,1237,0,45257,21,163,0.9998429671726613,0.9893816965607056,0.9995378622829604,0.9945848241183602,0.9919373148378879,133709,21,45420,1435
20,5,SAFARI,Mid,125,0.45,133712,198,133712,1234,0,45257,21,163,0.9998429706953407,0.9894038951044811,0.9995378622829604,0.994596042056405,0.9919539275133593,133712,21,45420,1432
20,5,vg giraffe,Mid,125,0.4,118496,170,118496,1107,0,40042,20,138,0.9998312464139864,0.9893381646948811,0.9995024875621891,0.9945570294894015,0.9918923818394354,118496,20,40180,1277
20,5,SAFARI,Mid,125,0.4,118497,170,118497,1106,0,40042,20,138,0.9998312478378629,0.9893465138219799,0.9995024875621891,0.994561248898401,0.9918986328943009,118497,20,40180,1276
20,5,vg giraffe,Mid,125,0.55,163458,241,163458,1505,0,55340,24,195,0.9998531948471391,0.9894312486380475,0.9995680267823395,0.9946149212318139,0.9919823521151643,163458,24,55535,1746
20,5,SAFARI,Mid,125,0.55,163462,241,163462,1501,0,55340,24,195,0.9998531984390101,0.9894554611268492,0.9995680267823395,0.994627156287079,0.992000471093435,163462,24,55535,1742
20,5,vg giraffe,Mid,125,0.5,148668,222,148668,1370,0,50383,24,175,0.999838592526834,0.9894050312791162,0.9995255229132893,0.9945944499451417,0.9919538741896615,148668,24,50558,1592
20,5,SAFARI,Mid,125,0.5,148671,222,148671,1367,0,50383,24,175,0.9998385957833148,0.9894249966724344,0.9995255229132893,0.9946045391446874,0.9919688113044084,148671,24,50558,1589
20,5,vg giraffe,Mid,125,0.65,193385,289,193385,1751,0,65462,28,243,0.9998552320681651,0.9895612127414609,0.9995740343510869,0.9946815897623176,0.9920814219744369,193385,28,65705,2040
20,5,SAFARI,Mid,125,0.65,193390,289,193390,1746,0,65462,28,243,0.9998552358105244,0.9895867980043495,0.9995740343510869,0.9946945168101263,0.9921005674725645,193390,28,65705,2035
20,5,vg giraffe,Mid,125,0.6,178406,263,178406,1639,0,60360,27,218,0.9998486826988281,0.9894513831887659,0.9995544922036136,0.994622861618828,0.9919929601142321,178406,27,60578,1902
20,5,SAFARI,Mid,125,0.6,178411,263,178411,1634,0,60360,27,218,0.9998486869388807,0.9894791135168711,0.9995544922036136,0.9946368739999889,0.9920137144944441,178411,27,60578,1897
20,5,vg giraffe,Mid,125,0.75,222904,330,222904,2032,0,75413,32,276,0.9998564610471167,0.9895146182735077,0.9995773959667728,0.9946586583727872,0.9920461681069283,222904,32,75689,2362
20,5,SAFARI,Mid,125,0.75,222909,330,222909,2027,0,75413,32,276,0.9998564642663306,0.9895368142551473,0.9995773959667728,0.9946698735182627,0.9920627801200717,222909,32,75689,2357
20,5,vg giraffe,Mid,125,0.7,208224,311,208224,1888,0,70489,31,265,0.9998511440301553,0.9895496214767397,0.9995620541075086,0.9946737110619617,0.9920699268868596,208224,31,70754,2199
20,5,SAFARI,Mid,125,0.7,208229,311,208229,1883,0,70489,31,265,0.9998511476039565,0.9895733831377749,0.9995620541075086,0.9946857168788796,0.9920877073198486,208229,31,70754,2194
20,5,vg giraffe,Mid,125,0.85,252576,391,252576,2322,0,85287,35,311,0.9998614470470407,0.9893728284414918,0.9995912790629781,0.9945894861193147,0.9919395052240688,252576,35,85598,2713
20,5,SAFARI,Mid,125,0.85,252582,391,252582,2316,0,85287,35,311,0.9998614503378632,0.9893963312167778,0.9995912790629781,0.9946013632443799,0.9919571045576407,252582,35,85598,2707
20,5,vg giraffe,Mid,125,0.8,237598,365,237598,2178,0,80297,34,294,0.9998569216267169,0.9894103880636792,0.9995782945736434,0.9946062251320188,0.991966106133443,237598,34,80591,2543
20,5,SAFARI,Mid,125,0.8,237603,365,237603,2173,0,80297,34,294,0.9998569246371567,0.9894312091646158,0.9995782945736434,0.9946167466898853,0.9919816938204173,237603,34,80591,2538
20,5,vg giraffe,Mid,125,0.95,282158,435,282158,2576,0,95213,39,343,0.9998617986725585,0.989441348814212,0.9995920288718029,0.9946242813281023,0.991989788950636,282158,39,95556,3011
20,5,SAFARI,Mid,125,0.95,282167,435,282167,2567,0,95213,39,343,0.9998618030800196,0.9894729090469161,0.9995920288718029,0.9946402291253582,0.9920134256389784,282167,39,95556,3002
20,5,vg giraffe,Mid,125,0.9,267312,409,267312,2447,0,90235,35,327,0.9998690839994464,0.9894287998578662,0.9996136737419561,0.9946215454452433,0.991986473188918,267312,35,90562,2856
20,5,SAFARI,Mid,125,0.9,267320,409,267320,2439,0,90235,35,327,0.9998690879168147,0.9894584110627461,0.9996136737419561,0.9946365085773073,0.9920086482890524,267320,35,90562,2848
20,5,vg giraffe,None,125,0.15,44806,71,44806,23,0,14958,7,51,0.9998437953272488,0.9979064587973274,0.9995338305807139,0.9988741876874032,0.9983143066960412,44806,7,15009,94
20,5,SAFARI,None,125,0.15,44806,71,44806,23,0,14958,7,51,0.9998437953272488,0.9979064587973274,0.9995338305807139,0.9988741876874032,0.9983143066960412,44806,7,15009,94
20,5,vg giraffe,None,125,0.1,29865,45,29865,15,0,10014,5,32,0.9998326079678608,0.9979949874686717,0.9995025370609889,0.9989129525880089,0.9983740244146488,29865,5,10046,60
20,5,SAFARI,None,125,0.1,29865,45,29865,15,0,10014,5,32,0.9998326079678608,0.9979949874686717,0.9995025370609889,0.9989129525880089,0.9983740244146488,29865,5,10046,60
20,5,vg giraffe,None,125,0.25,74736,109,74736,38,0,24988,15,99,0.9997993337881768,0.9980369376226914,0.9994024380527448,0.9989173583543847,0.9983797569635445,74736,15,25087,147
20,5,SAFARI,None,125,0.25,74736,109,74736,38,0,24988,15,99,0.9997993337881768,0.9980369376226914,0.9994024380527448,0.9989173583543847,0.9983797569635445,74736,15,25087,147
20,5,vg giraffe,None,125,0.2,59784,89,59784,30,0,19912,11,71,0.9998160381302784,0.9980134550857219,0.9994498349504851,0.9989139333990542,0.9983729051153359,59784,11,19983,119
20,5,SAFARI,None,125,0.2,59784,89,59784,30,0,19912,11,71,0.9998160381302784,0.9980134550857219,0.9994498349504851,0.9989139333990542,0.9983729051153359,59784,11,19983,119
20,5,vg giraffe,None,125,0.35,104571,151,104571,64,0,35012,18,131,0.9998278977712761,0.9979481991869142,0.9994880691675436,0.9988871641791045,0.9983350839960843,104571,18,35143,215
20,5,SAFARI,None,125,0.35,104571,151,104571,64,0,35012,18,131,0.9998278977712761,0.9979481991869142,0.9994880691675436,0.9988871641791045,0.9983350839960843,104571,18,35143,215
20,5,vg giraffe,None,125,0.3,89473,129,89473,55,0,29887,18,117,0.9997988624554425,0.9979477341423425,0.9994004396775698,0.9988724406635854,0.9983121516723903,89473,18,30004,184
20,5,SAFARI,None,125,0.3,89473,129,89473,55,0,29887,18,117,0.9997988624554425,0.9979477341423425,0.9994004396775698,0.9988724406635854,0.9983121516723903,89473,18,30004,184
20,5,vg giraffe,None,125,0.45,134862,201,134862,80,0,45257,22,173,0.9998368968891789,0.997920721014037,0.9995159728944821,0.998877889988779,0.998322212685844,134862,22,45430,281
20,5,SAFARI,None,125,0.45,134862,201,134862,80,0,45257,22,173,0.9998368968891789,0.997920721014037,0.9995159728944821,0.998877889988779,0.998322212685844,134862,22,45430,281
20,5,vg giraffe,None,125,0.4,119526,175,119526,71,0,40044,21,146,0.9998243368716906,0.9979460975854123,0.9994777548432021,0.9988843342985723,0.9983310726764719,119526,21,40190,246
20,5,SAFARI,None,125,0.4,119526,175,119526,71,0,40044,21,146,0.9998243368716906,0.9979460975854123,0.9994777548432021,0.9988843342985723,0.9983310726764719,119526,21,40190,246
20,5,vg giraffe,None,125,0.55,164854,245,164854,104,0,55340,25,201,0.9998483736558325,0.9978874475645115,0.9995500845840982,0.9988669482128683,0.998305921574134,164854,25,55541,349
20,5,SAFARI,None,125,0.55,164854,245,164854,104,0,55340,25,201,0.9998483736558325,0.9978874475645115,0.9995500845840982,0.9988669482128683,0.998305921574134,164854,25,55541,349
20,5,vg giraffe,None,125,0.5,149942,225,149942,92,0,50383,25,183,0.9998332966585982,0.9978903093991042,0.9995058409598545,0.9988608581535243,0.9982972367438386,149942,25,50566,317
20,5,SAFARI,None,125,0.5,149942,225,149942,92,0,50383,25,183,0.9998332966585982,0.9978903093991042,0.9995058409598545,0.9988608581535243,0.9982972367438386,149942,25,50566,317
20,5,vg giraffe,None,125,0.65,195008,296,195008,123,0,65464,28,243,0.9998564367603929,0.997855976912095,0.9995740473111736,0.9988552052307133,0.9982884186826567,195008,28,65707,419
20,5,SAFARI,None,125,0.65,195008,296,195008,123,0,65464,28,243,0.9998564367603929,0.997855976912095,0.9995740473111736,0.9988552052307133,0.9982884186826567,195008,28,65707,419
20,5,vg giraffe,None,125,0.6,179919,273,179919,115,0,60360,27,222,0.999849954986496,0.9978481146045356,0.9995545216057021,0.998848031799874,0.9982774078932076,179919,27,60582,388
20,5,SAFARI,None,125,0.6,179919,273,179919,115,0,60360,27,222,0.999849954986496,0.9978481146045356,0.9995545216057021,0.998848031799874,0.9982774078932076,179919,27,60582,388
20,5,vg giraffe,None,125,0.75,224790,340,224790,142,0,75415,29,278,0.9998710073436854,0.9978603643595299,0.9996170201526637,0.9988646740325845,0.9983022917400347,224790,29,75693,482
20,5,SAFARI,None,125,0.75,224790,340,224790,142,0,75415,29,278,0.9998710073436854,0.9978603643595299,0.9996170201526637,0.9988646740325845,0.9983022917400347,224790,29,75693,482
20,5,vg giraffe,None,125,0.7,209980,314,209980,135,0,70491,29,266,0.9998619106800185,0.9978662636803862,0.9995903144689627,0.9988630903962059,0.9983002329178742,209980,29,70757,449
20,5,SAFARI,None,125,0.7,209980,314,209980,135,0,70491,29,266,0.9998619106800185,0.9978662636803862,0.9995903144689627,0.9988630903962059,0.9983002329178742,209980,29,70757,449
20,5,vg giraffe,None,125,0.85,254746,393,254746,156,0,85291,35,309,0.9998626271189767,0.9978495466029496,0.9995912886086297,0.9988550725774199,0.9982870383949785,254746,35,85600,549
20,5,SAFARI,None,125,0.85,254746,393,254746,156,0,85291,35,309,0.9998626271189767,0.9978495466029496,0.9995912886086297,0.9988550725774199,0.9982870383949785,254746,35,85600,549
20,5,vg giraffe,None,125,0.8,239628,367,239628,152,0,80299,34,296,0.9998581335380661,0.9978388237204712,0.9995783154944251,0.9988474580510162,0.9982760555652542,239628,34,80595,519
20,5,SAFARI,None,125,0.8,239628,367,239628,152,0,80299,34,296,0.9998581335380661,0.9978388237204712,0.9995783154944251,0.9988474580510162,0.9982760555652542,239628,34,80595,519
20,5,vg giraffe,None,125,0.95,284556,444,284556,174,0,95218,40,339,0.9998594498868572,0.9978329020177155,0.9995815768277247,0.9988451480421925,0.9982719272213483,284556,40,95557,618
20,5,SAFARI,None,125,0.95,284556,444,284556,174,0,95218,40,339,0.9998594498868572,0.9978329020177155,0.9995815768277247,0.9988451480421925,0.9982719272213483,284556,40,95557,618
20,5,vg giraffe,None,125,0.9,269588,423,269588,162,0,90238,36,324,0.9998664807287185,0.9978347207159857,0.9996026402348838,0.9988495675226058,0.9982786864797891,269588,36,90562,585
20,5,SAFARI,None,125,0.9,269588,423,269588,162,0,90238,36,324,0.9998664807287185,0.9978347207159857,0.9996026402348838,0.9988495675226058,0.9982786864797891,269588,36,90562,585
20,5,vg giraffe,Single-stranded,125,0.15,44732,64,44732,104,0,14958,5,52,0.9998882356885799,0.9962583518930958,0.9996669996669997,0.9980699934178965,0.9971125761495452,44732,5,15010,168
20,5,SAFARI,Single-stranded,125,0.15,44732,64,44732,104,0,14958,5,52,0.9998882356885799,0.9962583518930958,0.9996669996669997,0.9980699934178965,0.9971125761495452,44732,5,15010,168
20,5,vg giraffe,Single-stranded,125,0.1,29810,41,29810,74,0,10014,3,27,0.999899372756851,0.996157059314954,0.9997013142174432,0.9980247078911245,0.997047711976782,29810,3,10041,115
20,5,SAFARI,Single-stranded,125,0.1,29810,41,29810,74,0,10014,3,27,0.999899372756851,0.996157059314954,0.9997013142174432,0.9980247078911245,0.997047711976782,29810,3,10041,115
20,5,vg giraffe,Single-stranded,125,0.25,74616,117,74616,149,0,24987,13,97,0.9998258049819775,0.99644774445127,0.9994820098019683,0.9981339165680116,0.9972094139769352,74616,13,25084,266
20,5,SAFARI,Single-stranded,125,0.25,74616,117,74616,149,0,24987,13,97,0.9998258049819775,0.99644774445127,0.9994820098019683,0.9981339165680116,0.9972094139769352,74616,13,25084,266
20,5,vg giraffe,Single-stranded,125,0.2,59682,95,59682,126,0,19911,10,66,0.9998324733632648,0.996310702302055,0.9994996747886126,0.9980684811237929,0.9971085242208036,59682,10,19977,221
20,5,SAFARI,Single-stranded,125,0.2,59682,95,59682,126,0,19911,10,66,0.9998324733632648,0.996310702302055,0.9994996747886126,0.9980684811237929,0.9971085242208036,59682,10,19977,221
20,5,vg giraffe,Single-stranded,125,0.35,104431,156,104431,198,0,35010,17,121,0.9998372395833334,0.9966216538626712,0.9995163309434392,0.998226857140126,0.9973487311784925,104431,17,35131,354
20,5,SAFARI,Single-stranded,125,0.35,104431,156,104431,198,0,35010,17,121,0.9998372395833334,0.9966216538626712,0.9995163309434392,0.998226857140126,0.9973487311784925,104431,17,35131,354
20,5,vg giraffe,Single-stranded,125,0.3,89349,132,89349,175,0,29885,16,110,0.9998209589884183,0.9965758008387615,0.9994668621505448,0.9981957423989365,0.9973008431731388,89349,16,29995,307
20,5,SAFARI,Single-stranded,125,0.3,89349,132,89349,175,0,29885,16,110,0.9998209589884183,0.9965758008387615,0.9994668621505448,0.9981957423989365,0.9973008431731388,89349,16,29995,307
20,5,vg giraffe,Single-stranded,125,0.45,134677,204,134677,265,0,45255,20,161,0.9998515185935841,0.9965296790138073,0.999559820406726,0.9981878351485864,0.9972920889125162,134677,20,45416,469
20,5,SAFARI,Single-stranded,125,0.45,134677,204,134677,265,0,45255,20,161,0.9998515185935841,0.9965296790138073,0.999559820406726,0.9981878351485864,0.9972920889125162,134677,20,45416,469
20,5,vg giraffe,Single-stranded,125,0.4,119364,180,119364,231,0,40042,19,138,0.9998408483619946,0.996568566061365,0.9995273514266524,0.9982020254392494,0.9973120632102717,119364,19,40180,411
20,5,SAFARI,Single-stranded,125,0.4,119364,180,119364,231,0,40042,19,138,0.9998408483619946,0.996568566061365,0.9995273514266524,0.9982020254392494,0.9973120632102717,119364,19,40180,411
20,5,vg giraffe,Single-stranded,125,0.55,164646,245,164646,314,0,55339,22,192,0.9998663978429324,0.9966163251717564,0.999603981783162,0.9982387161119582,0.9973681587983222,164646,22,55531,559
20,5,SAFARI,Single-stranded,125,0.55,164646,245,164646,314,0,55339,22,192,0.9998663978429324,0.9966163251717564,0.999603981783162,0.9982387161119582,0.9973681587983222,164646,22,55531,559
20,5,vg giraffe,Single-stranded,125,0.5,149751,226,149751,284,0,50381,22,177,0.999853111041376,0.9966059057240402,0.9995650454725188,0.9982268676216696,0.9973511384627641,149751,22,50558,510
20,5,SAFARI,Single-stranded,125,0.5,149751,226,149751,284,0,50381,22,177,0.999853111041376,0.9966059057240402,0.9995650454725188,0.9982268676216696,0.9973511384627641,149751,22,50558,510
20,5,vg giraffe,Single-stranded,125,0.65,194782,285,194782,364,0,65463,27,240,0.9998614027072671,0.9966791348353127,0.999589228662711,0.9982677326773267,0.997411558387355,194782,27,65703,649
20,5,SAFARI,Single-stranded,125,0.65,194782,285,194782,364,0,65463,27,240,0.9998614027072671,0.9966791348353127,0.999589228662711,0.9982677326773267,0.997411558387355,194782,27,65703,649
20,5,vg giraffe,Single-stranded,125,0.6,179704,262,179704,343,0,60359,26,218,0.9998553385634007,0.996644648908263,0.9995709783344059,0.998247412085913,0.9973807863452215,179704,26,60577,605
20,5,SAFARI,Single-stranded,125,0.6,179704,262,179704,343,0,60359,26,218,0.9998553385634007,0.996644648908263,0.9995709783344059,0.998247412085913,0.9973807863452215,179704,26,60577,605
20,5,vg giraffe,Single-stranded,125,0.75,224507,341,224507,428,0,75414,33,276,0.9998530328671952,0.9965864095598288,0.9995642011013827,0.9982170487488217,0.9973355393207286,224507,33,75690,769
20,5,SAFARI,Single-stranded,125,0.75,224507,341,224507,428,0,75414,33,276,0.9998530328671952,0.9965864095598288,0.9995642011013827,0.9982170487488217,0.9973355393207286,224507,33,75690,769
20,5,vg giraffe,Single-stranded,125,0.7,209711,319,209711,403,0,70490,32,261,0.9998474323338562,0.9965689792000304,0.9995479140471583,0.998205513879898,0.9973187869822485,209711,32,70751,722
20,5,SAFARI,Single-stranded,125,0.7,209711,319,209711,403,0,70490,32,261,0.9998474323338562,0.9965689792000304,0.9995479140471583,0.998205513879898,0.9973187869822485,209711,32,70751,722
20,5,vg giraffe,Single-stranded,125,0.85,254414,390,254414,494,0,85292,37,310,0.999854588899238,0.9965373798462973,0.9995679538528007,0.9981932284320322,0.9972986211528816,254414,37,85602,884
20,5,SAFARI,Single-stranded,125,0.85,254414,390,254414,494,0,85292,37,310,0.999854588899238,0.9965373798462973,0.9995679538528007,0.9981932284320322,0.9972986211528816,254414,37,85602,884
20,5,vg giraffe,Single-stranded,125,0.8,239318,367,239318,466,0,80300,35,295,0.9998537724615943,0.9965313490262376,0.9995659183926578,0.9981897961226601,0.9972941040772365,239318,35,80595,833
20,5,SAFARI,Single-stranded,125,0.8,239318,367,239318,466,0,80300,35,295,0.9998537724615943,0.9965313490262376,0.9995659183926578,0.9981897961226601,0.9972941040772365,239318,35,80595,833
20,5,vg giraffe,Single-stranded,125,0.95,284192,439,284192,546,0,95219,39,348,0.9998627876621481,0.9965460047619549,0.9995920758111415,0.9982016410025851,0.9973108043163692,284192,39,95567,985
20,5,SAFARI,Single-stranded,125,0.95,284192,439,284192,546,0,95219,39,348,0.9998627876621481,0.9965460047619549,0.9995920758111415,0.9982016410025851,0.9973108043163692,284192,39,95567,985
20,5,vg giraffe,Single-stranded,125,0.9,269243,411,269243,522,0,90239,37,327,0.9998625965537731,0.996546695487386,0.9995916250013797,0.9982018922766638,0.997311373444685,269243,37,90566,933
20,5,SAFARI,Single-stranded,125,0.9,269243,411,269243,522,0,90239,37,327,0.9998625965537731,0.996546695487386,0.9995916250013797,0.9982018922766638,0.997311373444685,269243,37,90566,933
30,10,vg giraffe,High,125,0.15,20260,37,20260,24599,0,14956,2,56,0.9999012930609021,0.45126514611546686,0.9998667909950713,0.6218729856656129,0.5887497913536972,20260,2,15012,24636
30,10,SAFARI,High,125,0.15,23182,41,23182,21673,0,14956,2,56,0.9999137336093857,0.5163488952245189,0.9998667909950713,0.6810223266745006,0.6375229510933066,23182,2,15012,21714
30,10,vg giraffe,High,125,0.1,13519,25,13519,16379,0,10014,2,35,0.9998520819466016,0.4517929352003476,0.9998010148243955,0.6223644231654544,0.5895832290989143,13519,2,10049,16404
30,10,SAFARI,High,125,0.1,15421,29,15421,14473,0,10014,2,35,0.9998703235427608,0.515356080606891,0.9998010148243955,0.6801481938870022,0.6371641567018562,15421,2,10049,14502
30,10,vg giraffe,High,125,0.25,33532,59,33532,41289,0,24986,4,110,0.9998807251908397,0.4478098290598291,0.9998406374501992,0.6185802833530106,0.5863972794558912,33532,4,25096,41348
30,10,SAFARI,High,125,0.25,38372,64,38372,36444,0,24986,4,110,0.9998957681884512,0.5124465811965812,0.9998406374501992,0.6776153139789503,0.6348069613922784,38372,4,25096,36508
30,10,vg giraffe,High,125,0.2,26969,48,26969,32883,0,19910,4,78,0.9998517035554073,0.4502337228714524,0.9997999199679872,0.6208833584658064,0.5877559705602563,26969,4,19988,32931
30,10,SAFARI,High,125,0.2,30885,52,30885,28963,0,19910,4,78,0.999870504062935,0.5156093489148581,0.9997999199679872,0.6803687671413938,0.6367721423922295,30885,4,19988,29015
30,10,vg giraffe,High,125,0.35,46874,83,46874,57829,0,35010,4,145,0.9999146721276505,0.4473307502910694,0.9998862311214767,0.6181295495305412,0.5861517024545357,46874,4,35155,57912
30,10,SAFARI,High,125,0.35,53617,89,53617,51080,0,35010,5,144,0.999906754690239,0.511680949745195,0.9998577889018458,0.6769481339326295,0.6343277716245668,53617,5,35154,51169
30,10,vg giraffe,High,125,0.3,40142,69,40142,49445,0,29885,4,131,0.999900363672595,0.4477335593825288,0.9998667554963357,0.6185112710127734,0.5862328286373207,40142,4,30016,49514
30,10,SAFARI,High,125,0.3,45927,74,45927,43655,0,29885,5,130,0.9998911434294174,0.5122579637726421,0.9998334443704198,0.6774493317992742,0.6345633209666098,45927,5,30015,43729
30,10,vg giraffe,High,125,0.45,60559,103,60559,74483,0,45255,4,191,0.9999339530736588,0.4481038884161456,0.9999119911991199,0.6188709710384859,0.586976383620809,60559,4,45446,74586
30,10,SAFARI,High,125,0.45,69178,110,69178,65857,0,45255,5,190,0.9999277279100357,0.5118798327722076,0.9998899889988999,0.6771269723190164,0.6346964201666713,69178,5,45445,65967
30,10,vg giraffe,High,125,0.4,53631,91,53631,66051,0,40042,4,163,0.9999254218327585,0.4477720354336954,0.999900519784128,0.6185527772651781,0.5865409858609093,53631,4,40205,66142
30,10,SAFARI,High,125,0.4,61294,98,61294,58381,0,40042,5,162,0.9999184326008581,0.5117513963915072,0.99987564973016,0.6770124591322789,0.6344338738108037,61294,5,40204,58479
30,10,vg giraffe,High,125,0.55,73854,122,73854,91228,0,55338,4,222,0.9999458420211758,0.4470472869906298,0.9999280109423367,0.6178648216780583,0.5861990868241774,73854,4,55560,91350
30,10,SAFARI,High,125,0.55,84342,130,84342,80732,0,55338,5,221,0.9999407210689177,0.5105324326287499,0.999910013677921,0.6759500062111552,0.6337014422380055,84342,5,55559,80862
30,10,vg giraffe,High,125,0.5,67323,111,67323,82828,0,50381,4,204,0.9999405884711928,0.4480374279591647,0.9999209314277807,0.6188088552270565,0.5870421357125432,67323,4,50585,82939
30,10,SAFARI,High,125,0.5,76862,118,76862,73282,0,50381,5,203,0.9999349525804311,0.5115198786120243,0.999901164284726,0.6768136169313473,0.6345300745328627,76862,5,50584,73400
30,10,vg giraffe,High,125,0.65,87329,150,87329,107942,0,65462,5,266,0.9999427485286372,0.44687623131597937,0.9999239347055513,0.6177008364131492,0.5860794780091441,87329,5,65728,108092
30,10,SAFARI,High,125,0.65,99753,159,99753,95509,0,65462,6,265,0.9999398550506721,0.5104517938194973,0.9999087216466614,0.6758791246019377,0.6336491112523644,99753,6,65727,95668
30,10,vg giraffe,High,125,0.6,80502,137,80502,99667,0,60358,5,244,0.9999378935993144,0.44647432697747164,0.9999175012787301,0.6173158546544842,0.5857052130852216,80502,5,60602,99804
30,10,SAFARI,High,125,0.6,91976,145,91976,88185,0,60358,6,243,0.9999347698462743,0.51011058977516,0.9999010015344763,0.6755787989187918,0.6333282139195477,91976,6,60601,88330
30,10,vg giraffe,High,125,0.75,100592,175,100592,124493,0,75413,5,302,0.9999502967285306,0.44655953120838143,0.9999339672477549,0.6173996569047159,0.5857764635523955,100592,5,75715,124668
30,10,SAFARI,High,125,0.75,114991,184,114991,110085,0,75413,6,301,0.9999478247258624,0.5104812216993696,0.9999207606973058,0.6759067410810065,0.6336135291381487,114991,6,75714,110269
30,10,vg giraffe,High,125,0.7,93991,162,93991,116264,0,70489,5,290,0.9999468062470743,0.4466891933636541,0.999929362567812,0.6175229047379711,0.5859509745697917,93991,5,70779,116426
30,10,SAFARI,High,125,0.7,107393,171,107393,102853,0,70489,6,289,0.9999441335580406,0.5103817657318562,0.9999152350813744,0.6758187127142748,0.6336072773567661,107393,6,70778,103024
30,10,vg giraffe,High,125,0.85,114136,197,114136,140950,0,85287,5,339,0.9999561945313253,0.4470959680041366,0.9999416099309829,0.6179132920438304,0.585960095507958,114136,5,85626,141147
30,10,SAFARI,High,125,0.85,130429,210,130429,124644,0,85287,6,338,0.9999540000766666,0.5109192543177572,0.9999299319171795,0.6762920060769786,0.6337492740104542,130429,6,85625,124854
30,10,vg giraffe,High,125,0.8,107349,187,107349,132599,0,80297,5,325,0.999953425116903,0.4470360422262477,0.9999379860344549,0.6178555292397745,0.5860139293307811,107349,5,80622,132786
30,10,SAFARI,High,125,0.8,122661,198,122661,117276,0,80297,6,324,0.9999510870894373,0.5108001749016179,0.999925583241346,0.6761870110969621,0.6337471396237709,122661,6,80621,117474
30,10,vg giraffe,High,125,0.95,127403,222,127403,157539,0,95215,6,373,0.9999529075653997,0.4467709809092312,0.9999372345544699,0.6176022182740993,0.5856502030160889,127403,6,95588,157761
30,10,SAFARI,High,125,0.95,145654,236,145654,139274,0,95215,7,372,0.9999519432106054,0.5107727483132514,0.9999267736468817,0.6761631753031974,0.6335809096591536,145654,7,95587,139510
30,10,vg giraffe,High,125,0.9,120769,213,120769,149181,0,90235,5,355,0.9999586003610048,0.44702272331888526,0.9999448093161875,0.6178437958034159,0.5858747415164737,120769,5,90590,149394
30,10,SAFARI,High,125,0.9,138022,226,138022,131915,0,90235,6,354,0.999956530559017,0.510884169927044,0.999933771179425,0.6762618480074278,0.6336962728477262,138022,6,90589,132141
30,10,vg giraffe,Mid,125,0.15,35097,47,35097,9754,0,14956,1,59,0.999971508348054,0.7817051984498196,0.9999334043686734,0.8774688734436722,0.8363988383349468,35097,1,15015,9801
30,10,SAFARI,Mid,125,0.15,35498,47,35498,9353,0,14956,1,59,0.9999718301923998,0.7906365539667691,0.9999334043686734,0.883067776160802,0.8430917648629702,35498,1,15015,9400
30,10,vg giraffe,Mid,125,0.1,23368,34,23368,6523,0,10014,1,35,0.9999572082673628,0.7808855472013366,0.9999004975124378,0.8769467482268173,0.8359474671669793,23368,1,10049,6557
30,10,SAFARI,Mid,125,0.1,23635,34,23635,6256,0,10014,1,35,0.9999576916567947,0.7898078529657477,0.9999004975124378,0.8825451354530348,0.8426266416510318,23635,1,10049,6290
30,10,vg giraffe,Mid,125,0.25,58520,82,58520,16279,0,24986,4,107,0.9999316519718406,0.7815066572294708,0.9998406184006057,0.8773284359656685,0.836313989077597,58520,4,25093,16361
30,10,SAFARI,Mid,125,0.25,59179,83,59179,15619,0,24986,4,107,0.9999324130240103,0.7903072875629332,0.9998406184006057,0.8828469984485022,0.8429054391966233,59179,4,25093,15702
30,10,vg giraffe,Mid,125,0.2,46816,63,46816,13022,0,19910,3,77,0.9999359234498815,0.781556234453515,0.9998499249624813,0.8773613193403298,0.8361767908775707,46816,3,19987,13085
30,10,SAFARI,Mid,125,0.2,47349,63,47349,12489,0,19910,3,77,0.9999366447034972,0.7904542495116943,0.9998499249624813,0.8829403373332214,0.8428483809190022,47349,3,19987,12552
30,10,vg giraffe,Mid,125,0.35,81890,118,81890,22779,0,35010,6,133,0.9999267363485396,0.781490070333152,0.9998292981308146,0.8773160919848084,0.8363323233478162,81890,6,35143,22897
30,10,SAFARI,Mid,125,0.35,82789,119,82789,21879,0,35010,6,133,0.9999275318557884,0.7900693788351608,0.9998292981308146,0.8826966340053949,0.84275668877201,82789,6,35143,21998
30,10,vg giraffe,Mid,125,0.3,70126,101,70126,19430,0,29885,5,124,0.9999287048523477,0.7821586713809295,0.9998334110748317,0.8777380028537813,0.836752429577759,70126,5,30009,19531
30,10,SAFARI,Mid,125,0.3,70903,102,70903,18652,0,29885,5,124,0.9999294860946578,0.7908250331820159,0.9998334110748317,0.8831688101391958,0.8432452306740982,70903,5,30009,18754
30,10,vg giraffe,Mid,125,0.45,105725,150,105725,29269,0,45257,7,177,0.9999337948776151,0.7823136802225774,0.9998459540943201,0.8778375595742208,0.8370518038596783,105725,7,45434,29419
30,10,SAFARI,Mid,125,0.45,106906,151,106906,28087,0,45257,7,177,0.9999345262035487,0.7910525069555437,0.9998459540943201,0.8833126081873278,0.8435916604369134,106906,7,45434,28238
30,10,vg giraffe,Mid,125,0.4,93675,131,93675,25967,0,40042,7,151,0.9999252791357999,0.7821044809765139,0.9998258706467662,0.8777025602586026,0.8368162127358992,93675,7,40193,26098
30,10,SAFARI,Mid,125,0.4,94711,132,94711,24930,0,40042,7,151,0.9999260964125087,0.7907541766508311,0.9998258706467662,0.8831233012107733,0.8432923055765661,94711,7,40193,25062
30,10,vg giraffe,Mid,125,0.55,129218,183,129218,35803,0,55340,7,212,0.9999458309150706,0.7821723444952907,0.9998740078115157,0.8777532104514162,0.8369609037746362,129218,7,55552,35986
30,10,SAFARI,Mid,125,0.55,130645,184,130645,34375,0,55340,7,212,0.999946422557634,0.7908101498753057,0.9998740078115157,0.8831661348764264,0.8434248492727495,130645,7,55552,34559
30,10,vg giraffe,Mid,125,0.5,117450,168,117450,32642,0,50383,7,192,0.9999404037222133,0.7816451484094237,0.9998616108497094,0.8774190656551507,0.8366029017834915,117450,7,50575,32810
30,10,SAFARI,Mid,125,0.5,118766,169,118766,31325,0,50383,7,192,0.9999410640465426,0.7904033009450286,0.9998616108497094,0.8829102749476829,0.8431553161191384,118766,7,50575,31494
30,10,vg giraffe,Mid,125,0.65,152741,219,152741,42465,0,65462,9,262,0.9999410801963994,0.7815837277728028,0.9998630824699922,0.8773806275579809,0.8365242496879284,152741,9,65724,42684
30,10,SAFARI,Mid,125,0.65,154408,220,154408,40797,0,65462,9,262,0.9999417162618105,0.7901138544198542,0.9998630824699922,0.8827299180773034,0.8429073587636603,154408,9,65724,41017
30,10,vg giraffe,Mid,125,0.6,141014,199,141014,39095,0,60360,8,237,0.9999432712626398,0.7820728974865231,0.9998679976899596,0.8776896025892384,0.8368622697820375,141014,8,60597,39294
30,10,SAFARI,Mid,125,0.6,142553,200,142553,37555,0,60360,8,237,0.9999438836708496,0.7906082924773166,0.9998679976899596,0.8830392512133404,0.8432504680112738,142553,8,60597,37755
30,10,vg giraffe,Mid,125,0.75,176095,251,176095,48920,0,75413,10,298,0.9999432156951819,0.7817202773609866,0.9998679362396165,0.877467480211575,0.836600916318645,176095,10,75711,49171
30,10,SAFARI,Mid,125,0.75,178007,252,178007,47007,0,75413,10,298,0.9999438255896909,0.7902080207399252,0.9998679362396165,0.8827895051365915,0.8429533501446906,178007,10,75711,47259
30,10,vg giraffe,Mid,125,0.7,164490,237,164490,45696,0,70489,10,286,0.9999392097264438,0.7817111247344635,0.9998587271314544,0.8774601718219475,0.8366227134363176,164490,10,70775,45933
30,10,SAFARI,Mid,125,0.7,166278,238,166278,43907,0,70489,10,286,0.9999398633695756,0.7902082947206341,0.9998587271314544,0.8827881320163202,0.8429809962732212,166278,10,70775,44145
30,10,vg giraffe,Mid,125,0.85,199633,296,199633,55360,0,85287,10,336,0.9999499105904038,0.7819882564466154,0.9998832225894223,0.8776388559169283,0.8367192495644165,199633,10,85623,55656
30,10,SAFARI,Mid,125,0.85,201795,297,201795,53197,0,85287,10,336,0.9999504472138946,0.7904570898080215,0.9998832225894223,0.8829474900129952,0.8430608760948252,201795,10,85623,53494
30,10,vg giraffe,Mid,125,0.8,187765,277,187765,52099,0,80297,10,318,0.999946744774331,0.7818948034696283,0.9998759689922481,0.8775787771431777,0.836684686032809,187765,10,80615,52376
30,10,SAFARI,Mid,125,0.8,189797,278,189797,50066,0,80297,10,318,0.9999473149040868,0.7903564988902353,0.9998759689922481,0.8828835114944134,0.8430195220191666,189797,10,80615,50344
30,10,vg giraffe,Mid,125,0.95,222917,326,222917,61926,0,95213,11,371,0.9999506567142754,0.7817013770781537,0.9998849312202521,0.877458438054151,0.8364787637486737,222917,11,95584,62252
30,10,SAFARI,Mid,125,0.95,225366,327,225366,59476,0,95213,11,371,0.9999511928901352,0.7902892670661958,0.9998849312202521,0.8828430738856049,0.8429105692765072,225366,11,95584,59803
30,10,vg giraffe,Mid,125,0.9,211221,307,211221,58640,0,90235,10,352,0.9999526584639565,0.7818135382428711,0.9998896210691304,0.8775298660778273,0.836577827671753,211221,10,90587,58947
30,10,SAFARI,Mid,125,0.9,213532,308,213532,56328,0,90235,10,352,0.9999531708048065,0.7903674750525599,0.9998896210691304,0.882892642285667,0.8429836597230884,213532,10,90587,56636
30,10,vg giraffe,None,125,0.15,37241,51,37241,7608,0,14958,4,54,0.9998926030339643,0.8294209354120268,0.9997336174746937,0.9067137379024895,0.8721042793243875,37241,4,15012,7659
30,10,SAFARI,None,125,0.15,37241,51,37241,7608,0,14958,4,54,0.9998926030339643,0.8294209354120268,0.9997336174746937,0.9067137379024895,0.8721042793243875,37241,4,15012,7659
30,10,vg giraffe,None,125,0.1,24863,33,24863,5029,0,10014,3,34,0.9998793533338696,0.830843776106934,0.9997015222365934,0.9075578105893304,0.8732989793876326,24863,3,10048,5062
30,10,SAFARI,None,125,0.1,24863,33,24863,5029,0,10014,3,34,0.9998793533338696,0.830843776106934,0.9997015222365934,0.9075578105893304,0.8732989793876326,24863,3,10048,5062
30,10,vg giraffe,None,125,0.25,62119,80,62119,12684,0,24988,7,107,0.9998873257573319,0.8295474273199525,0.9997211377579476,0.9067871453700123,0.872270840626094,62119,7,25095,12764
30,10,SAFARI,None,125,0.25,62119,80,62119,12684,0,24988,7,107,0.9998873257573319,0.8295474273199525,0.9997211377579476,0.9067871453700123,0.872270840626094,62119,7,25095,12764
30,10,vg giraffe,None,125,0.2,49700,65,49700,10138,0,19912,6,76,0.999879290226532,0.8296746406690817,0.9996999099729919,0.9068598381519766,0.872222987095886,49700,6,19988,10203
30,10,SAFARI,None,125,0.2,49700,65,49700,10138,0,19912,6,76,0.999879290226532,0.8296746406690817,0.9996999099729919,0.9068598381519766,0.872222987095886,49700,6,19988,10203
30,10,vg giraffe,None,125,0.35,86964,114,86964,17708,0,35012,8,141,0.9999080163730856,0.8299200274845876,0.9997724751855749,0.9070182208825708,0.8725946251080766,86964,8,35153,17822
30,10,SAFARI,None,125,0.35,86964,114,86964,17708,0,35012,8,141,0.9999080163730856,0.8299200274845876,0.9997724751855749,0.9070182208825708,0.8725946251080766,86964,8,35153,17822
30,10,vg giraffe,None,125,0.3,74423,98,74423,15136,0,29887,8,127,0.9998925179024869,0.8300857713285076,0.9997335287455865,0.9071108185851495,0.8726426524285797,74423,8,30014,15234
30,10,SAFARI,None,125,0.3,74423,98,74423,15136,0,29887,8,127,0.9998925179024869,0.8300857713285076,0.9997335287455865,0.9071108185851495,0.8726426524285797,74423,8,30014,15234
30,10,vg giraffe,None,125,0.45,112190,152,112190,22801,0,45257,10,185,0.9999108734402852,0.8301576848227433,0.9997799876793101,0.9071613104070056,0.8728480854951688,112190,10,45442,22953
30,10,SAFARI,None,125,0.45,112190,152,112190,22801,0,45257,10,185,0.9999108734402852,0.8301576848227433,0.9997799876793101,0.9071613104070056,0.8728480854951688,112190,10,45442,22953
30,10,vg giraffe,None,125,0.4,99396,133,99396,20243,0,40044,9,158,0.9999094612947035,0.8298767658551247,0.9997761806470866,0.9069929782778302,0.8725802116474876,99396,9,40202,20376
30,10,SAFARI,None,125,0.4,99396,133,99396,20243,0,40044,9,158,0.9999094612947035,0.8298767658551247,0.9997761806470866,0.9069929782778302,0.8725802116474876,99396,9,40202,20376
30,10,vg giraffe,None,125,0.55,137083,188,137083,27932,0,55340,10,216,0.9999270568154465,0.829785173392735,0.9998200338336393,0.906945510360706,0.8725817483432909,137083,10,55556,28120
30,10,SAFARI,None,125,0.55,137083,188,137083,27932,0,55340,10,216,0.9999270568154465,0.829785173392735,0.9998200338336393,0.906945510360706,0.8725817483432909,137083,10,55556,28120
30,10,vg giraffe,None,125,0.5,124688,171,124688,25400,0,50383,10,198,0.9999198062519046,0.8298205099195389,0.9998023363839418,0.9069636343137291,0.8726362957430919,124688,10,50581,25571
30,10,SAFARI,None,125,0.5,124688,171,124688,25400,0,50383,10,198,0.9999198062519046,0.8298205099195389,0.9998023363839418,0.9069636343137291,0.8726362957430919,124688,10,50581,25571
30,10,vg giraffe,None,125,0.65,162040,227,162040,33160,0,65464,12,259,0.9999259496951596,0.8291587139955072,0.9998174488476459,0.9065707356236311,0.8721138603625336,162040,12,65723,33387
30,10,SAFARI,None,125,0.65,162040,227,162040,33160,0,65464,12,259,0.9999259496951596,0.8291587139955072,0.9998174488476459,0.9065707356236311,0.8721138603625336,162040,12,65723,33387
30,10,vg giraffe,None,125,0.6,149519,209,149519,30579,0,60360,11,238,0.9999264361666556,0.8292467846506236,0.999818508802323,0.9066235746747636,0.872158760729881,149519,11,60598,30788
30,10,SAFARI,None,125,0.6,149519,209,149519,30579,0,60360,11,238,0.9999264361666556,0.8292467846506236,0.999818508802323,0.9066235746747636,0.872158760729881,149519,11,60598,30788
30,10,vg giraffe,None,125,0.75,186651,259,186651,38362,0,75415,12,295,0.9999357130229344,0.828558364998757,0.9998415255804126,0.9062157864711665,0.8716486042911155,186651,12,75710,38621
30,10,SAFARI,None,125,0.75,186651,259,186651,38362,0,75415,12,295,0.9999357130229344,0.828558364998757,0.9998415255804126,0.9062157864711665,0.8716486042911155,186651,12,75710,38621
30,10,vg giraffe,None,125,0.7,174399,240,174399,35790,0,70491,12,283,0.9999311970001892,0.8287783527935788,0.9998304749526743,0.9063454942313689,0.8718347172092527,174399,12,70774,36030
30,10,SAFARI,None,125,0.7,174399,240,174399,35790,0,70491,12,283,0.9999311970001892,0.8287783527935788,0.9998304749526743,0.9063454942313689,0.8718347172092527,174399,12,70774,36030
30,10,vg giraffe,None,125,0.85,211689,298,211689,43308,0,85291,13,331,0.9999385929277947,0.8291936779020349,0.9998481929117767,0.9065968303864907,0.8720587803948024,211689,13,85622,43606
30,10,SAFARI,None,125,0.85,211689,298,211689,43308,0,85291,13,331,0.9999385929277947,0.8291936779020349,0.9998481929117767,0.9065968303864907,0.8720587803948024,211689,13,85622,43606
30,10,vg giraffe,None,125,0.8,199076,278,199076,40793,0,80299,13,317,0.9999347025702073,0.8289755857870388,0.9998387676890449,0.9064648617144314,0.8719230865152007,199076,13,80616,41071
30,10,SAFARI,None,125,0.8,199076,278,199076,40793,0,80299,13,317,0.9999347025702073,0.8289755857870388,0.9998387676890449,0.9064648617144314,0.8719230865152007,199076,13,80616,41071
30,10,vg giraffe,None,125,0.95,236378,335,236378,48461,0,95218,14,365,0.9999407763376087,0.8288904318065462,0.9998535518897037,0.9064164458572836,0.8718127168298005,236378,14,95583,48796
30,10,SAFARI,None,125,0.95,236378,335,236378,48461,0,95218,14,365,0.9999407763376087,0.8288904318065462,0.9998535518897037,0.9064164458572836,0.8718127168298005,236378,14,95583,48796
30,10,vg giraffe,None,125,0.9,224011,322,224011,45840,0,90238,13,347,0.9999419705031604,0.8291391071646685,0.999856508973708,0.906565600357752,0.8720102225511474,224011,13,90585,46162
30,10,SAFARI,None,125,0.9,224011,322,224011,45840,0,90238,13,347,0.9999419705031604,0.8291391071646685,0.999856508973708,0.906565600357752,0.8720102225511474,224011,13,90585,46162
30,10,vg giraffe,Single-stranded,125,0.15,36930,49,36930,7921,0,14958,2,55,0.9999458464204484,0.8224944320712695,0.9998667998667998,0.9025808974484308,0.8669448385212384,36930,2,15013,7970
30,10,SAFARI,Single-stranded,125,0.15,37003,49,37003,7848,0,14958,2,55,0.9999459532495608,0.8241202672605791,0.9998667998667998,0.9035590012819731,0.8681632312442628,37003,2,15013,7897
30,10,vg giraffe,Single-stranded,125,0.1,24582,32,24582,5311,0,10014,1,29,0.9999593214823251,0.821453634085213,0.9999004380724811,0.9019593454171865,0.8662963796942631,24582,1,10043,5343
30,10,SAFARI,Single-stranded,125,0.1,24633,32,24633,5260,0,10014,1,29,0.9999594056994398,0.8231578947368421,0.9999004380724811,0.90298575853663,0.8675723685856539,24633,1,10043,5292
30,10,vg giraffe,Single-stranded,125,0.25,61556,87,61556,13239,0,24987,4,106,0.9999350227420403,0.8220400096151278,0.9998406184006057,0.9023028099851951,0.8666720011202352,61556,4,25093,13326
30,10,SAFARI,Single-stranded,125,0.25,61679,87,61679,13116,0,24987,4,106,0.9999351523110095,0.8236825939478112,0.9998406184006057,0.9032914729249808,0.8679022594744896,61679,4,25093,13203
30,10,vg giraffe,Single-stranded,125,0.2,49226,72,49226,10605,0,19911,4,72,0.999918748730449,0.821761848321453,0.999799869915445,0.9021285953836146,0.8663036675428715,49226,4,19983,10677
30,10,SAFARI,Single-stranded,125,0.2,49322,72,49322,10509,0,19911,4,72,0.9999189068645339,0.8233644391766689,0.999799869915445,0.9030935008102243,0.8675053198147453,49322,4,19983,10581
30,10,vg giraffe,Single-stranded,125,0.35,86071,115,86071,18599,0,35010,5,133,0.9999419117988754,0.821405735553753,0.9998577443951292,0.9019233892728217,0.8662288380867987,86071,5,35143,18714
30,10,SAFARI,Single-stranded,125,0.35,86251,116,86251,18418,0,35010,5,133,0.999942033017993,0.8231235386744286,0.9998577443951292,0.9029580037792934,0.8675151679732443,86251,5,35143,18534
30,10,vg giraffe,Single-stranded,125,0.3,73722,100,73722,15834,0,29885,4,122,0.9999457450560182,0.8222762559114839,0.9998667155376362,0.9024494742382883,0.8668137414659012,73722,4,30007,15934
30,10,SAFARI,Single-stranded,125,0.3,73869,100,73869,15687,0,29885,4,122,0.9999458530180174,0.8239158561613278,0.9998667155376362,0.9034360877887103,0.868042150300417,73869,4,30007,15787
30,10,vg giraffe,Single-stranded,125,0.45,110906,150,110906,24090,0,45255,7,174,0.9999368874703597,0.820638420670978,0.999845937142354,0.9014585932642172,0.8657285886743973,110906,7,45429,24240
30,10,SAFARI,Single-stranded,125,0.45,111147,151,111147,23848,0,45255,7,174,0.9999370243086169,0.8224216772971453,0.999845937142354,0.9025334957369062,0.8670631624414393,111147,7,45429,23999
30,10,vg giraffe,Single-stranded,125,0.4,98351,134,98351,21290,0,40042,6,151,0.9999389977327491,0.8211312878313505,0.999850742555785,0.901756734454367,0.8660407316188881,98351,6,40193,21424
30,10,SAFARI,Single-stranded,125,0.4,98563,135,98563,21077,0,40042,6,151,0.9999391289350608,0.822901273220622,0.999850742555785,0.9028230681859818,0.867365946966382,98563,6,40193,21212
30,10,vg giraffe,Single-stranded,125,0.55,135659,184,135659,29362,0,55339,7,207,0.9999484026948535,0.8211555340334735,0.9998739942037334,0.9017751793958207,0.86612942679314,135659,7,55546,29546
30,10,SAFARI,Single-stranded,125,0.55,135864,184,135864,29157,0,55339,7,207,0.9999484805440455,0.8223964165733483,0.9998739942037334,0.9025229510156904,0.8670580454615461,135864,7,55546,29341
30,10,vg giraffe,Single-stranded,125,0.5,123395,169,123395,26697,0,50381,7,192,0.9999432748253675,0.8212044376118887,0.9998616053776196,0.901802582007798,0.8661976389283065,123395,7,50573,26866
30,10,SAFARI,Single-stranded,125,0.5,123655,171,123655,26435,0,50381,7,192,0.999943394090343,0.8229347601839466,0.9998616053776196,0.9028449600800226,0.8674921953186849,123655,7,50573,26606
30,10,vg giraffe,Single-stranded,125,0.65,160421,210,160421,34800,0,65463,9,258,0.9999439007666895,0.8208574893440652,0.9998630762209036,0.9015935997482163,0.8659103005425772,160421,9,65721,35010
30,10,SAFARI,Single-stranded,125,0.65,160678,213,160678,34540,0,65463,9,258,0.99994399049083,0.8221725314816994,0.9998630762209036,0.9023862876911585,0.8668943678420591,160678,9,65721,34753
30,10,vg giraffe,Single-stranded,125,0.6,148050,194,148050,32065,0,60359,8,236,0.9999459671209932,0.8210904613746401,0.9998679933336634,0.9017349490052289,0.8660631267848841,148050,8,60595,32259
30,10,SAFARI,Single-stranded,125,0.6,148085,194,148085,32030,0,60359,8,236,0.9999459798910144,0.8212845725948233,0.9998679933336634,0.9018519984652955,0.8662084080494122,148085,8,60595,32224
30,10,vg giraffe,Single-stranded,125,0.75,184910,252,184910,40114,0,75414,12,297,0.99993510777517,0.8208153553862817,0.9998415276732301,0.9015646102613859,0.865853374928156,184910,12,75711,40366
30,10,SAFARI,Single-stranded,125,0.75,185061,252,185061,39963,0,75414,12,297,0.9999351607203644,0.8214856442763543,0.9998415276732301,0.9019688119137612,0.8663550377243778,185061,12,75711,40215
30,10,vg giraffe,Single-stranded,125,0.7,172671,236,172671,37526,0,70490,12,281,0.9999305085040219,0.8205509592126711,0.9998304677676844,0.9014032303532089,0.8656762061902594,172671,12,70771,37762
30,10,SAFARI,Single-stranded,125,0.7,172953,239,172953,37241,0,70490,12,281,0.9999306218020987,0.8218910532093351,0.9998304677676844,0.9022112791407363,0.8666789940828402,172953,12,70771,37480
30,10,vg giraffe,Single-stranded,125,0.85,209504,291,209504,45503,0,85292,13,334,0.9999379525289117,0.820625308463051,0.9998482000023354,0.9014511149597153,0.8656437992942978,209504,13,85626,45794
30,10,SAFARI,Single-stranded,125,0.85,209555,291,209555,45452,0,85292,13,334,0.9999379676286456,0.82082507501038,0.9998482000023354,0.9015716356971687,0.865793387048047,209555,13,85626,45743
30,10,vg giraffe,Single-stranded,125,0.8,197043,273,197043,42835,0,80300,13,317,0.9999340289054888,0.820496271096102,0.9998387696887014,0.9013716614784302,0.865574956122713,197043,13,80617,43108
30,10,SAFARI,Single-stranded,125,0.8,197332,274,197332,42545,0,80300,13,317,0.999934125516228,0.8216996806176114,0.9998387696887014,0.9020973906047141,0.8664758822997621,197332,13,80617,42819
30,10,vg giraffe,Single-stranded,125,0.95,233975,324,233975,50878,0,95219,13,374,0.9999444415952955,0.820455366316358,0.9998640252703805,0.9013512081900745,0.8655008233035614,233975,13,95593,51202
30,10,SAFARI,Single-stranded,125,0.95,234034,324,234034,50819,0,95219,13,374,0.9999444556007981,0.8206622553712256,0.9998640252703805,0.9014760488729335,0.8656557671954893,234034,13,95593,51143
30,10,vg giraffe,Single-stranded,125,0.9,221624,305,221624,48247,0,90239,13,351,0.9999413455334624,0.820294918867701,0.9998565168923766,0.9012531185633564,0.865388506537243,221624,13,90590,48552
30,10,SAFARI,Single-stranded,125,0.9,221679,305,221679,48192,0,90239,13,351,0.9999413600851632,0.8204984898732678,0.9998565168923766,0.9013759789211739,0.8655409544347094,221679,13,90590,48497
30,2,vg giraffe,High,125,0.15,27833,41,27833,17022,0,14956,3,55,0.9998922258945251,0.6199438702779758,0.9998001864926069,0.7653577517461365,0.7151393757302621,27833,3,15011,17063
30,2,SAFARI,High,125,0.15,41272,50,41272,3574,0,14956,5,53,0.9998788671657339,0.91928011404134,0.9996669774876782,0.9578870411845938,0.9394258053747288,41272,5,15009,3624
30,2,vg giraffe,High,125,0.1,18554,28,18554,11341,0,10014,3,34,0.999838335937921,0.620058149249741,0.9997015222365934,0.7654290429042905,0.7155150848051234,18554,3,10048,11369
30,2,SAFARI,High,125,0.1,27447,35,27447,2441,0,10014,5,32,0.9998178639079119,0.9172542860007352,0.9995025370609889,0.9567581699346405,0.9379346575273928,27447,5,10046,2476
30,2,vg giraffe,High,125,0.25,46116,67,46116,28697,0,24986,5,109,0.9998915895145378,0.6158653846153846,0.999800796812749,0.7622416343666581,0.712252450490098,46116,5,25095,28764
30,2,SAFARI,High,125,0.25,68823,89,68823,5968,0,24986,12,102,0.9998256700806276,0.919110576923077,0.9995219123505976,0.9577705876213339,0.9392978595719144,68823,12,25088,6057
30,2,vg giraffe,High,125,0.2,37066,54,37066,22780,0,19910,5,77,0.999865123681584,0.6187979966611018,0.999749899959984,0.7644759773540543,0.7141265708706754,37066,5,19987,22834
30,2,SAFARI,High,125,0.2,55071,65,55071,4764,0,19910,9,73,0.9998366013071895,0.9193823038397329,0.9995498199279712,0.9579231170638371,0.9394432483853202,55071,9,19983,4829
30,2,vg giraffe,High,125,0.35,64480,99,64480,40207,0,35010,5,144,0.9999224625881988,0.6153493787338004,0.9998577889018458,0.7618552498656002,0.7119511236557219,64480,5,35154,40306
30,2,SAFARI,High,125,0.35,96176,129,96176,8481,0,35010,13,136,0.9998648494110554,0.9178325348806138,0.9996302511447993,0.9570941659410375,0.9383829361534889,96176,13,35146,8610
30,2,vg giraffe,High,125,0.3,55160,77,55160,34419,0,29885,5,130,0.999909362820629,0.6152404747033104,0.9998334443704198,0.7617679756388922,0.7117132925565695,55160,5,30015,34496
30,2,SAFARI,High,125,0.3,82311,102,82311,7243,0,29885,13,122,0.9998420873621301,0.9180757562237887,0.9995669553630913,0.9572159553436446,0.93851733012467,82311,13,30007,7345
30,2,vg giraffe,High,125,0.45,83124,121,83124,51900,0,45255,5,190,0.999939852518375,0.6150726996929224,0.9998899889988999,0.7616482036339647,0.7119189346327418,83124,5,45445,52021
30,2,SAFARI,High,125,0.45,124036,161,124036,10948,0,45255,15,180,0.9998790819904717,0.917799400643753,0.9996699669966996,0.957082671028874,0.938403610288214,124036,15,45435,11109
30,2,vg giraffe,High,125,0.4,73712,108,73712,45953,0,40042,5,162,0.99993217304014,0.6154308567039316,0.99987564973016,0.7619205126879942,0.7120551061994475,73712,5,40204,46061
30,2,SAFARI,High,125,0.4,109951,143,109951,9679,0,40042,15,152,0.9998635942018442,0.9179948736359613,0.9996269491904798,0.9571818454855291,0.9385118325811653,109951,15,40194,9822
30,2,vg giraffe,High,125,0.55,101498,142,101498,63564,0,55338,5,221,0.9999507403722058,0.6143797970993439,0.999910013677921,0.7611198806180565,0.711411979997101,101498,5,55559,63706
30,2,SAFARI,High,125,0.55,151675,188,151675,13341,0,55338,16,210,0.9998945224172825,0.9181073097503692,0.9997120437693471,0.9572571356442986,0.9386459994202059,151675,16,55548,13529
30,2,vg giraffe,High,125,0.5,92431,129,92431,57702,0,50381,5,203,0.9999459085204898,0.6151322356949861,0.999901164284726,0.7616956052377851,0.7120452474720066,92431,5,50584,57831
30,2,SAFARI,High,125,0.5,137978,174,137978,12110,0,50381,16,192,0.9998840529298375,0.9182494576140342,0.999683725711123,0.9573295959147425,0.938760573758657,137978,16,50573,12284
30,2,vg giraffe,High,125,0.65,120137,172,120137,75112,0,65462,6,265,0.9999500595124143,0.6147599285644838,0.9999087216466614,0.7614113143451091,0.7117026735183072,120137,6,65727,75284
30,2,SAFARI,High,125,0.65,179373,224,179373,15824,0,65462,18,253,0.9998996605180862,0.917879859380517,0.9997261649399845,0.9571358441031771,0.9384807431630379,179373,18,65715,16048
30,2,vg giraffe,High,125,0.6,110793,157,110793,69356,0,60358,6,243,0.9999458478867138,0.6144720641575987,0.9999010015344763,0.7611892616066367,0.7114352484091767,110793,6,60601,69513
30,2,SAFARI,High,125,0.6,165495,208,165495,14603,0,60358,17,232,0.9998972884141332,0.917856310938072,0.9997195043476826,0.9571219543227941,0.9384508100434596,165495,17,60590,14811
30,2,vg giraffe,High,125,0.75,138371,200,138371,86689,0,75413,6,301,0.9999566401930957,0.6142723963420048,0.9999207606973058,0.7610391681814557,0.7112931091766895,138371,6,75714,86889
30,2,SAFARI,High,125,0.75,206781,260,206781,18219,0,75413,19,288,0.9999081237911025,0.9179659060641037,0.9997490755414685,0.9571865018747396,0.9385407668283607,206781,19,75701,18479
30,2,vg giraffe,High,125,0.7,129283,186,129283,80948,0,70489,6,289,0.9999535923396422,0.6144132840977677,0.9999152350813744,0.7611464030661808,0.7114519507398622,129283,6,70778,81134
30,2,SAFARI,High,125,0.7,193125,244,193125,17048,0,70489,19,276,0.9999016278010189,0.9178203282054207,0.9997315777576854,0.9571043782724297,0.938439052492701,193125,19,70765,17292
30,2,vg giraffe,High,125,0.85,156911,229,156911,98143,0,85287,6,338,0.9999617632251445,0.6146551082524101,0.9999299319171795,0.7613343037360506,0.7114286887602151,156911,6,85625,98372
30,2,SAFARI,High,125,0.85,234340,299,234340,20644,0,85287,23,321,0.9999018616419827,0.9179616347347845,0.9997314056825215,0.9571813105794797,0.9385006189244208,234340,23,85608,20943
30,2,vg giraffe,High,125,0.8,147602,215,147602,92318,0,80297,6,324,0.9999593517966506,0.6146625856289171,0.999925583241346,0.7613393407488982,0.7115026094113392,147602,6,80621,92533
30,2,SAFARI,High,125,0.8,220451,278,220451,19406,0,80297,21,309,0.9999047498094996,0.9180294417723364,0.9997395413447109,0.9572194951444507,0.9385681595700239,220451,21,80606,19684
30,2,vg giraffe,High,125,0.95,175220,256,175220,109688,0,95215,7,372,0.9999600518184983,0.6144534373202789,0.9999267736468817,0.7611790847344974,0.7112312807610083,175220,7,95587,109944
30,2,SAFARI,High,125,0.95,261795,332,261795,23037,0,95215,25,354,0.9999045145519823,0.9180506655819107,0.9997384773102914,0.9572309244877364,0.9385593999338162,261795,25,95569,23369
30,2,vg giraffe,High,125,0.9,166057,246,166057,103860,0,90235,6,354,0.9999638691340034,0.6146548565125498,0.999933771179425,0.7613347209932466,0.7114076472316623,166057,6,90589,104106
30,2,SAFARI,High,125,0.9,247983,321,247983,21859,0,90235,23,337,0.9999072603082183,0.9179014150716419,0.9997461228544622,0.9571510453153315,0.9384545872856597,247983,23,90572,22180
30,2,vg giraffe,Mid,125,0.15,42815,50,42815,2033,0,14956,3,57,0.9999299360082209,0.9536059512673171,0.9998002131060203,0.976218705823339,0.9651834295824014,42815,3,15013,2083
30,2,SAFARI,Mid,125,0.15,44487,50,44487,361,0,14956,7,53,0.9998426754169102,0.9908459174128024,0.9995338305807139,0.9953239663504565,0.9930233334446039,44487,7,15009,411
30,2,vg giraffe,Mid,125,0.1,28527,36,28527,1362,0,10014,3,33,0.9998948475289169,0.9532832080200502,0.9997014925373134,0.9760328457788042,0.964953095684803,28527,3,10047,1398
30,2,SAFARI,Mid,125,0.1,29641,36,29641,248,0,10014,7,29,0.9997638963842418,0.9905096073517126,0.9993034825870647,0.9951152367683346,0.9927204502814259,29641,7,10043,284
30,2,vg giraffe,Mid,125,0.25,71380,85,71380,3416,0,24986,8,103,0.9998879363478456,0.9532458166958241,0.9996812368012113,0.9760099542623523,0.9649022785012703,71380,8,25089,3501
30,2,SAFARI,Mid,125,0.25,74206,85,74206,590,0,24986,14,97,0.9998113715979521,0.9909856973063929,0.9994421644021197,0.9953789713013327,0.9931084838664506,74206,14,25083,675
30,2,vg giraffe,Mid,125,0.2,57092,66,57092,2743,0,19910,6,74,0.9998949175102455,0.9531059581643044,0.9996998499249625,0.9759399652988487,0.964764491619832,57092,6,19984,2809
30,2,SAFARI,Mid,125,0.2,59361,66,59361,474,0,19910,11,69,0.9998147274809674,0.990985125457004,0.9994497248624312,0.9953803459290871,0.9931031029778072,59361,11,19979,540
30,2,vg giraffe,Mid,125,0.35,99863,125,99863,4799,0,35010,10,129,0.9998998728385049,0.953009438193669,0.9997154968846909,0.9758917228574221,0.9647410244683284,99863,10,35139,4924
30,2,SAFARI,Mid,125,0.35,103801,125,103801,861,0,35010,16,123,0.9998458826589094,0.9905904358365064,0.9995447950155054,0.9951966405246304,0.9928395838097416,103801,16,35133,986
30,2,vg giraffe,Mid,125,0.3,85477,107,85477,4073,0,29885,9,120,0.9998947196032099,0.9533778734510412,0.9997001399346972,0.9760824012378456,0.9649956965346659,85477,9,30005,4180
30,2,SAFARI,Mid,125,0.3,88836,107,88836,714,0,29885,15,114,0.9998311780396394,0.9908428789720825,0.9995002332244952,0.9953167365048065,0.9930141805449942,88836,15,29999,821
30,2,vg giraffe,Mid,125,0.45,128910,161,128910,6073,0,45257,11,173,0.9999146764297515,0.9538714260344522,0.9997579278625031,0.9763505197583928,0.9654179472270676,128910,11,45430,6234
30,2,SAFARI,Mid,125,0.45,133891,161,133891,1092,0,45257,18,166,0.9998655803568095,0.990728408216421,0.9996038819568231,0.9952760236830663,0.9929617631586234,133891,18,45423,1253
30,2,vg giraffe,Mid,125,0.4,114210,139,114210,5424,0,40042,11,147,0.9999036954675585,0.9535538059495879,0.999726368159204,0.9761788763814457,0.9651566201796553,114210,11,40189,5563
30,2,SAFARI,Mid,125,0.4,118669,139,118669,965,0,40042,17,141,0.9998567649090878,0.9907825636829669,0.9995771144278607,0.9952989822149719,0.9929925674957649,118669,17,40183,1104
30,2,vg giraffe,Mid,125,0.55,157526,194,157526,7484,0,55340,11,208,0.9999301751334607,0.9535241277450909,0.9998020122752389,0.9761759429387651,0.9651707940189252,157526,11,55548,7678
30,2,SAFARI,Mid,125,0.55,163651,195,163651,1358,0,55340,19,200,0.9998839127512678,0.9905995012227307,0.9996580212026854,0.9952200538808175,0.9928792415395696,163651,19,55540,1553
30,2,vg giraffe,Mid,125,0.5,143286,179,143286,6795,0,50383,11,188,0.9999232363552621,0.9535871156661786,0.9997825313352576,0.9762056431970623,0.9652214178309317,143286,11,50571,6974
30,2,SAFARI,Mid,125,0.5,148855,180,148855,1225,0,50383,19,180,0.9998723752972312,0.9906495407959537,0.999624372306354,0.9952395916211464,0.9929098495334641,148855,19,50563,1405
30,2,vg giraffe,Mid,125,0.65,186359,234,186359,8832,0,65462,13,258,0.9999302470328161,0.9536088013304337,0.9998022302344333,0.976220347462133,0.9652356044999579,186359,13,65720,9066
30,2,SAFARI,Mid,125,0.65,193623,235,193623,1567,0,65462,21,250,0.9998915535725351,0.9907790712549571,0.9996805257633152,0.9953144557906181,0.9930195513826878,193623,21,65712,1802
30,2,vg giraffe,Mid,125,0.6,171948,212,171948,8148,0,60360,12,233,0.999930216329379,0.9536348914080351,0.9998019965349394,0.9762340036563072,0.9652488657731214,171948,12,60593,8360
30,2,SAFARI,Mid,125,0.6,178638,213,178638,1457,0,60360,20,225,0.9998880542712892,0.9907380704128491,0.9996699942248989,0.9952920332287737,0.992985019488363,178638,20,60585,1670
30,2,vg giraffe,Mid,125,0.75,214836,267,214836,10163,0,75413,15,293,0.9999301841741486,0.9536991823000364,0.9998019043594247,0.9762676742775216,0.9652975045433856,214836,15,75706,10430
30,2,SAFARI,Mid,125,0.75,223212,269,223212,1785,0,75413,24,284,0.9998924904585282,0.9908818907425,0.9996830469750796,0.9953667988102618,0.9930960473375926,223212,24,75697,2054
30,2,vg giraffe,Mid,125,0.7,200666,252,200666,9505,0,70489,15,281,0.9999252545083989,0.9536314946560024,0.9997880906971816,0.9762298591110764,0.9652499217660948,200666,15,70770,9757
30,2,SAFARI,Mid,125,0.7,208490,253,208490,1680,0,70489,24,272,0.9998848998148805,0.9908137418438099,0.9996609451154905,0.9953286532342572,0.9930407385280646,208490,24,70761,1933
30,2,vg giraffe,Mid,125,0.85,243411,314,243411,11564,0,85287,15,331,0.9999383796307707,0.9534723391920529,0.9998248338841335,0.9761527124710505,0.9651151876382281,243411,15,85618,11878
30,2,SAFARI,Mid,125,0.85,252928,316,252928,2045,0,85287,26,320,0.9998972145133107,0.99075165792494,0.999696378732498,0.9953034276910847,0.992998398460645,252928,26,85607,2361
30,2,vg giraffe,Mid,125,0.8,229002,294,229002,10845,0,80297,15,313,0.9999345026788404,0.9536147513335915,0.9998139534883721,0.976225493330605,0.9652269878977199,229002,15,80610,11139
30,2,SAFARI,Mid,125,0.8,237922,296,237922,1923,0,80297,25,303,0.9998949345862734,0.9907595954043666,0.9996899224806202,0.9953063034420442,0.9930042460859319,237922,25,80600,2219
30,2,vg giraffe,Mid,125,0.95,271871,347,271871,12951,0,95213,18,364,0.9999337965125474,0.9533680028334076,0.9998117056331398,0.9760958463930148,0.9650282064480886,271871,18,95577,13298
30,2,SAFARI,Mid,125,0.95,282552,350,282552,2267,0,95213,29,353,0.9998973745580914,0.9908229856681476,0.9996966368533919,0.995339498018494,0.9930508136273387,282552,29,95566,2617
30,2,vg giraffe,Mid,125,0.9,257596,327,257596,12245,0,90235,15,347,0.9999417726727508,0.9534659915311954,0.9998344316036955,0.9761510025976781,0.9651102518259809,257596,15,90582,12572
30,2,SAFARI,Mid,125,0.9,267689,329,267689,2150,0,90235,26,336,0.9999028817959397,0.9908242278878328,0.9997130147797388,0.9953428533714581,0.9930564217704045,267689,26,90571,2479
30,2,vg giraffe,None,125,0.15,44693,51,44693,156,0,14958,5,53,0.9998881381717303,0.9953897550111359,0.9996670218433671,0.9976338757561554,0.9964617130649576,44693,5,15011,207
30,2,SAFARI,None,125,0.15,44693,51,44693,156,0,14958,5,53,0.9998881381717303,0.9953897550111359,0.9996670218433671,0.9976338757561554,0.9964617130649576,44693,5,15011,207
30,2,vg giraffe,None,125,0.1,29792,33,29792,100,0,10014,4,33,0.9998657537924553,0.9955555555555555,0.9996020296487912,0.9977059995646422,0.9965729437662597,29792,4,10047,133
30,2,SAFARI,None,125,0.1,29792,33,29792,100,0,10014,4,33,0.9998657537924553,0.9955555555555555,0.9996020296487912,0.9977059995646422,0.9965729437662597,29792,4,10047,133
30,2,vg giraffe,None,125,0.25,74541,83,74541,259,0,24988,10,104,0.9998658636369734,0.9954328752854453,0.9996016253684965,0.9976444450392815,0.9964794719207881,74541,10,25092,342
30,2,SAFARI,None,125,0.25,74541,83,74541,259,0,24988,10,104,0.9998658636369734,0.9954328752854453,0.9996016253684965,0.9976444450392815,0.9964794719207881,74541,10,25092,342
30,2,vg giraffe,None,125,0.2,59629,66,59629,208,0,19912,8,74,0.999865855089961,0.9954259386007379,0.9995998799639892,0.9976409570018404,0.9964704557117289,59629,8,19986,274
30,2,SAFARI,None,125,0.2,59629,66,59629,208,0,19912,8,74,0.999865855089961,0.9954259386007379,0.9995998799639892,0.9976409570018404,0.9964704557117289,59629,8,19986,274
30,2,vg giraffe,None,125,0.35,104305,120,104305,361,0,35012,11,138,0.9998945511714407,0.9954096921344454,0.9996871533801656,0.9976470813287295,0.9964843833737057,104305,11,35150,481
30,2,SAFARI,None,125,0.35,104305,120,104305,361,0,35012,11,138,0.9998945511714407,0.9954096921344454,0.9996871533801656,0.9976470813287295,0.9964843833737057,104305,11,35150,481
30,2,vg giraffe,None,125,0.3,89238,102,89238,317,0,29887,11,124,0.9998767493193201,0.9953266337263125,0.9996336020251816,0.9975965031916202,0.9964070555402368,89238,11,30011,419
30,2,SAFARI,None,125,0.3,89238,102,89238,317,0,29887,11,124,0.9998767493193201,0.9953266337263125,0.9996336020251816,0.9975965031916202,0.9964070555402368,89238,11,30011,419
30,2,vg giraffe,None,125,0.45,134520,160,134520,463,0,45257,14,181,0.9998959370865358,0.995390068298025,0.9996919827510341,0.9976379149871883,0.9964727705639691,134520,14,45438,623
30,2,SAFARI,None,125,0.45,134520,160,134520,463,0,45257,14,181,0.9998959370865358,0.995390068298025,0.9996919827510341,0.9976379149871883,0.9964727705639691,134520,14,45438,623
30,2,vg giraffe,None,125,0.4,119224,139,119224,409,0,40044,13,154,0.9998909734394525,0.9954246401496176,0.9996767053791251,0.9976528080532532,0.996493377421351,119224,13,40198,548
30,2,SAFARI,None,125,0.4,119224,139,119224,409,0,40044,13,154,0.9998909734394525,0.9954246401496176,0.9996767053791251,0.9976528080532532,0.996493377421351,119224,13,40198,548
30,2,vg giraffe,None,125,0.55,164431,198,164431,574,0,55340,14,212,0.9999148651524826,0.9953269613747935,0.999748047367095,0.9976156384992477,0.9964397175328058,164431,14,55552,772
30,2,SAFARI,None,125,0.55,164431,198,164431,574,0,55340,14,212,0.9999148651524826,0.9953269613747935,0.999748047367095,0.9976156384992477,0.9964397175328058,164431,14,55552,772
30,2,vg giraffe,None,125,0.5,149556,180,149556,523,0,50383,14,194,0.9999063983419135,0.9953214116958052,0.9997232709375186,0.9976086369230461,0.9964301717699776,149556,14,50577,703
30,2,SAFARI,None,125,0.5,149556,180,149556,523,0,50383,14,194,0.9999063983419135,0.9953214116958052,0.9997232709375186,0.9976086369230461,0.9964301717699776,149556,14,50577,703
30,2,vg giraffe,None,125,0.65,194523,239,194523,665,0,65464,16,255,0.9999177542806327,0.9953742318103435,0.9997565984635278,0.9976408199689203,0.9964772822998752,194523,16,65719,904
30,2,SAFARI,None,125,0.65,194523,239,194523,665,0,65464,16,255,0.9999177542806327,0.9953742318103435,0.9997565984635278,0.9976408199689203,0.9964772822998752,194523,16,65719,904
30,2,vg giraffe,None,125,0.6,179467,222,179467,618,0,60360,15,234,0.9999164261597263,0.9953412790407472,0.9997525120031678,0.9976236071697578,0.9964510451775722,179467,15,60594,840
30,2,SAFARI,None,125,0.6,179467,222,179467,618,0,60360,15,234,0.9999164261597263,0.9953412790407472,0.9997525120031678,0.9976236071697578,0.9964510451775722,179467,15,60594,840
30,2,vg giraffe,None,125,0.75,224239,273,224239,760,0,75415,17,290,0.9999241937785388,0.9954144323306936,0.9997754945722511,0.9976642166895054,0.9965115583699343,224239,17,75705,1033
30,2,SAFARI,None,125,0.75,224239,273,224239,760,0,75415,17,290,0.9999241937785388,0.9954144323306936,0.9997754945722511,0.9976642166895054,0.9965115583699343,224239,17,75705,1033
30,2,vg giraffe,None,125,0.7,209462,252,209462,715,0,70491,17,278,0.9999188462805341,0.9954046257882706,0.9997598395162886,0.9976566295474246,0.9965008978895151,209462,17,70769,967
30,2,SAFARI,None,125,0.7,209462,252,209462,715,0,70491,17,278,0.9999188462805341,0.9954046257882706,0.9997598395162886,0.9976566295474246,0.9965008978895151,209462,17,70769,967
30,2,vg giraffe,None,125,0.85,254120,315,254120,860,0,85291,19,325,0.9999252377635861,0.9953974813451105,0.9997781281018275,0.9976562223958354,0.9964978148006922,254120,19,85616,1175
30,2,SAFARI,None,125,0.85,254120,315,254120,860,0,85291,19,325,0.9999252377635861,0.9953974813451105,0.9997781281018275,0.9976562223958354,0.9964978148006922,254120,19,85616,1175
30,2,vg giraffe,None,125,0.8,239038,294,239038,815,0,80299,19,311,0.9999205210472816,0.99538199519461,0.9997643527762964,0.9976460964432684,0.9964835274459436,239038,19,80610,1109
30,2,SAFARI,None,125,0.8,239038,294,239038,815,0,80299,19,311,0.9999205210472816,0.99538199519461,0.9997643527762964,0.9976460964432684,0.9964835274459436,239038,19,80610,1109
30,2,vg giraffe,None,125,0.95,283859,355,283859,960,0,95218,23,356,0.9999189804214427,0.9953887801833267,0.9997594066759418,0.9976487375583423,0.9964860769333799,283859,23,95574,1315
30,2,SAFARI,None,125,0.95,283859,355,283859,960,0,95218,23,356,0.9999189804214427,0.9953887801833267,0.9997594066759418,0.9976487375583423,0.9964860769333799,283859,23,95574,1315
30,2,vg giraffe,None,125,0.9,268923,340,268923,910,0,90238,20,340,0.999925634799939,0.9953733348632172,0.9997792445749354,0.9976442917665215,0.9964797613998908,268923,20,90578,1250
30,2,SAFARI,None,125,0.9,268923,340,268923,910,0,90238,20,340,0.999925634799939,0.9953733348632172,0.9997792445749354,0.9976442917665215,0.9964797613998908,268923,20,90578,1250
30,2,vg giraffe,Single-stranded,125,0.15,44361,52,44361,487,0,14958,3,54,0.9999323776034623,0.9879955456570156,0.9998001998001999,0.9939281233195915,0.9909538512893266,44361,3,15012,539
30,2,SAFARI,Single-stranded,125,0.15,44672,52,44672,176,0,14958,6,51,0.99986570571646,0.9949220489977728,0.9996003996003996,0.9973877514568309,0.9960944671618126,44672,6,15009,228
30,2,vg giraffe,Single-stranded,125,0.1,29560,34,29560,331,0,10014,2,28,0.9999323455787835,0.9878028404344193,0.9998008761449622,0.9938305848336612,0.9908178838599915,29560,2,10042,365
30,2,SAFARI,Single-stranded,125,0.1,29772,34,29772,119,0,10014,5,25,0.9998320851664037,0.9948872180451128,0.9995021903624054,0.9973535224950589,0.9960469363756912,29772,5,10039,153
30,2,vg giraffe,Single-stranded,125,0.25,74013,93,74013,776,0,24987,8,102,0.999891922562516,0.9883950749178708,0.9996812368012113,0.9941102596992674,0.9912281579131618,74013,8,25089,869
30,2,SAFARI,Single-stranded,125,0.25,74507,93,74507,282,0,24987,11,99,0.9998523846587402,0.9949921209369408,0.9995617006016655,0.9974163319946452,0.9961391892297382,74507,11,25086,375
30,2,vg giraffe,Single-stranded,125,0.2,59198,77,59198,628,0,19911,7,69,0.9998817667426737,0.988230973407008,0.9996497723520288,0.9940222319239682,0.9910877456502691,59198,7,19980,705
30,2,SAFARI,Single-stranded,125,0.2,59603,77,59603,223,0,19911,10,66,0.9998322513545703,0.9949919035774503,0.9994996747886126,0.997406205026942,0.9961196645387408,59603,10,19977,300
30,2,vg giraffe,Single-stranded,125,0.35,103567,123,103567,1095,0,35010,9,129,0.9999131072835405,0.988376198883428,0.9997439399112324,0.9941111820350257,0.9912315179407287,103567,9,35139,1218
30,2,SAFARI,Single-stranded,125,0.35,104284,125,104284,376,0,35010,12,126,0.9998849428549513,0.9952187813141193,0.99965858654831,0.9975464054600848,0.9963339598236299,104284,12,35136,501
30,2,vg giraffe,Single-stranded,125,0.3,88633,106,88633,917,0,29885,8,118,0.9999097483106012,0.9885897207102704,0.9997334310752723,0.9942175134747081,0.9913844251130219,88633,8,30003,1023
30,2,SAFARI,Single-stranded,125,0.3,89226,107,89226,323,0,29885,11,115,0.9998767327453859,0.9952038904256268,0.9996334677284996,0.9975348392614579,0.9963147734964527,89226,11,30000,430
30,2,vg giraffe,Single-stranded,125,0.45,133529,159,133529,1458,0,45255,11,170,0.9999176276771005,0.9880351619729774,0.9997579012236992,0.9939408826660117,0.9909847050093586,133529,11,45425,1617
30,2,SAFARI,Single-stranded,125,0.45,134474,161,134474,511,0,45255,14,167,0.9998959014930701,0.9950275997809777,0.9996918742847082,0.9974558104690062,0.9962011717668428,134474,14,45422,672
30,2,vg giraffe,Single-stranded,125,0.4,118362,142,118362,1271,0,40042,10,147,0.9999155205622952,0.9882028804007514,0.9997512375929749,0.9940246990304308,0.9911048045307362,118362,10,40189,1413
30,2,SAFARI,Single-stranded,125,0.4,119183,144,119183,448,0,40042,13,144,0.9998909359374476,0.9950573992903361,0.9996766088708674,0.9974683120546008,0.9962181354470101,119183,13,40186,592
30,2,vg giraffe,Single-stranded,125,0.55,163260,194,163260,1751,0,55339,11,203,0.9999326273496212,0.9882267485850913,0.9998019908915811,0.9940452270485516,0.9911396189492566,163260,11,55542,1945
30,2,SAFARI,Single-stranded,125,0.55,164216,194,164216,795,0,55339,15,199,0.9999086652337257,0.9940134983807997,0.9997299875794287,0.9969523670758508,0.9954520334483915,164216,15,55538,989
30,2,vg giraffe,Single-stranded,125,0.5,148483,179,148483,1599,0,50381,11,188,0.9999259229329132,0.9881672556418498,0.9997825227362593,0.9940118157018292,0.9910924562215883,148483,11,50569,1778
30,2,SAFARI,Single-stranded,125,0.5,149516,182,149516,563,0,50381,15,184,0.9998996863526627,0.9950419603223724,0.9997034400948992,0.9974649090035758,0.996215912089663,149516,15,50565,745
30,2,vg giraffe,Single-stranded,125,0.65,193164,222,193164,2045,0,65463,13,254,0.9999327042039167,0.9883999979532418,0.999802221207972,0.9941329051383401,0.9912697531407829,193164,13,65717,2267
30,2,SAFARI,Single-stranded,125,0.65,194338,225,194338,868,0,65463,17,250,0.9999125311929201,0.9944072332434465,0.9997413661950403,0.997152283560723,0.9957497482395916,194338,17,65713,1093
30,2,vg giraffe,Single-stranded,125,0.6,178200,205,178200,1904,0,60359,12,232,0.9999326644670392,0.9883034124752508,0.9998019900004951,0.9940840285506288,0.9911959553695955,178200,12,60591,2109
30,2,SAFARI,Single-stranded,125,0.6,178367,205,178367,1737,0,60359,12,232,0.9999327275071617,0.9892296002972675,0.9998019900004951,0.994552368632349,0.9918891545460583,178367,12,60591,1942
30,2,vg giraffe,Single-stranded,125,0.75,222627,267,222627,2382,0,75414,17,292,0.9999236449219382,0.9882410909284611,0.999775497537076,0.9940480442936239,0.9911428277170357,222627,17,75706,2649
30,2,SAFARI,Single-stranded,125,0.75,223282,267,223282,1727,0,75414,20,289,0.9999104351953856,0.9911486354516238,0.9997358794553834,0.9955102568561097,0.9933089478702587,223282,20,75703,1994
30,2,vg giraffe,Single-stranded,125,0.7,207969,250,207969,2214,0,70490,17,276,0.9999182637292895,0.9882908099014889,0.9997598293375528,0.994070536949804,0.9911776001365499,207969,17,70766,2464
30,2,SAFARI,Single-stranded,125,0.7,209257,253,209257,923,0,70490,21,272,0.9998996550043483,0.9944115229075288,0.9997033185934476,0.9971480375782384,0.9957434854346836,209257,21,70762,1176
30,2,vg giraffe,Single-stranded,125,0.85,252280,307,252280,2711,0,85292,20,327,0.9999207292905271,0.9881785207874719,0.9997664615420544,0.9940149488374659,0.9910892628256833,252280,20,85619,3018
30,2,SAFARI,Single-stranded,125,0.85,252516,307,252516,2475,0,85292,20,327,0.9999208033706085,0.989102930692759,0.9997664615420544,0.9944824489892367,0.9917814728234249,252516,20,85619,2782
30,2,vg giraffe,Single-stranded,125,0.8,237307,289,237307,2555,0,80300,19,311,0.9999199413465023,0.9881574509371187,0.9997643556988713,0.9940038996642769,0.991074907803143,237307,19,80611,2844
30,2,SAFARI,Single-stranded,125,0.8,238654,289,238654,1208,0,80300,23,307,0.999903635457124,0.9937664219595171,0.9997147463723179,0.9968255824638492,0.9952615647435478,238654,23,80607,1497
30,2,vg giraffe,Single-stranded,125,0.95,281804,344,281804,3029,0,95219,21,366,0.9999254856737337,0.9881722579310394,0.9997803485136916,0.994014130461621,0.9910867869626533,281804,21,95585,3373
30,2,SAFARI,Single-stranded,125,0.95,282066,344,282066,2767,0,95219,21,366,0.9999255548820045,0.9890909855984178,0.9997803485136916,0.9944787612117109,0.9917748428895198,282066,21,95585,3111
30,2,vg giraffe,Single-stranded,125,0.9,266971,323,266971,2882,0,90239,20,344,0.9999250911079399,0.9881373623119745,0.9997792567575026,0.9939962804863293,0.991061009648566,266971,20,90583,3205
30,2,SAFARI,Single-stranded,125,0.9,267223,323,267223,2630,0,90239,20,344,0.9999251617441803,0.9890700876465711,0.9997792567575026,0.9944680035503025,0.9917594981969572,267223,20,90583,2953
10,15,vg giraffe,High,125,0.15,42975,73,42975,1848,0,14956,14,44,0.9996743352950754,0.9572122238061297,0.9990675369654989,0.9779825908858165,0.9677015523284928,42975,14,15000,1921
10,15,SAFARI,High,125,0.15,43031,73,43031,1792,0,14956,14,44,0.9996747589731676,0.9584595509622238,0.9990675369654989,0.978633401939937,0.9686362877649808,43031,14,15000,1865
10,15,vg giraffe,High,125,0.1,28640,47,28640,1236,0,10014,10,27,0.999650959860384,0.9571232830932728,0.9990050741219779,0.9779249825004696,0.9676539750838045,28640,10,10041,1283
10,15,SAFARI,High,125,0.1,28673,47,28673,1203,0,10014,10,27,0.9996513614336018,0.958226113691809,0.9990050741219779,0.9785004948298809,0.9684795116825937,28673,10,10041,1250
10,15,vg giraffe,High,125,0.25,71654,130,71654,3096,2,24984,28,86,0.9995814965682719,0.956917735042735,0.998804780876494,0.9777844491143801,0.9674334866973394,71654,30,25070,3226
10,15,SAFARI,High,125,0.25,71773,129,71773,2978,2,24984,28,86,0.9995821901591856,0.9585069444444444,0.998804780876494,0.9786137452874566,0.968623724744949,71773,30,25070,3107
10,15,vg giraffe,High,125,0.2,57342,94,57342,2464,1,19909,20,62,0.9996339103603368,0.9572954924874791,0.9989495798319328,0.9780067028815568,0.9677189205427327,57342,21,19971,2558
10,15,SAFARI,High,125,0.2,57430,94,57430,2376,1,19909,20,62,0.999634471114515,0.9587646076794658,0.9989495798319328,0.9787730824620157,0.9688204075501927,57430,21,19971,2470
10,15,vg giraffe,High,125,0.35,100189,185,100189,4412,2,35008,32,117,0.999660756512976,0.9561296356383486,0.9990329645325521,0.9774107478208274,0.9669084283111222,100189,34,35125,4597
10,15,SAFARI,High,125,0.35,100322,185,100322,4279,2,35008,32,117,0.9996612061062617,0.957398889164583,0.9990329645325521,0.9780737245420246,0.9678588016720855,100322,34,35125,4464
10,15,vg giraffe,High,125,0.3,85751,153,85751,3752,2,29883,31,104,0.9996153128788585,0.956444632818774,0.9989007328447701,0.9775535795713635,0.9670944884521542,85751,33,29987,3905
10,15,SAFARI,High,125,0.3,85867,153,85867,3636,2,29883,31,104,0.999615832363213,0.9577384670295351,0.9989007328447701,0.9782291690400784,0.9680637721848993,85867,33,29987,3789
10,15,vg giraffe,High,125,0.45,129136,231,129136,5778,2,45253,38,157,0.9996903449557193,0.9555366458248548,0.9991199119911991,0.9771149473556774,0.9665051634873613,129136,40,45410,6009
10,15,SAFARI,High,125,0.45,129307,231,129307,5607,2,45253,38,157,0.9996907543275066,0.9568019534573976,0.9991199119911991,0.9777762654447015,0.9674520335557463,129307,40,45410,5838
10,15,vg giraffe,High,125,0.4,114473,203,114473,5097,2,40040,35,132,0.9996768841149245,0.9557496263765624,0.9990798080031834,0.9772198580349406,0.9666399969996624,114473,37,40172,5300
10,15,SAFARI,High,125,0.4,114625,203,114625,4945,2,40040,35,132,0.9996773124487625,0.9570186936955741,0.9990798080031834,0.97788299528654,0.9675901038866872,114625,37,40172,5148
10,15,vg giraffe,High,125,0.55,157920,278,157920,7006,2,55336,44,182,0.9997087980957927,0.9559090578920607,0.9991721258368728,0.9773184392115605,0.9667977243078707,157920,46,55518,7284
10,15,SAFARI,High,125,0.55,158128,278,158128,6798,2,55336,44,182,0.9997091810284876,0.9571681073097503,0.9991721258368728,0.9779762383340858,0.9677398898391071,158128,46,55518,7076
10,15,vg giraffe,High,125,0.5,143614,251,143614,6397,2,50379,42,166,0.9996937170223725,0.9557572772890018,0.9991302457055882,0.9772318998366901,0.9666817690725961,143614,44,50545,6648
10,15,SAFARI,High,125,0.5,143804,251,143804,6207,2,50379,42,166,0.9996941215727713,0.957021735368889,0.9991302457055882,0.9778926252082555,0.9676277439494949,143804,44,50545,6458
10,15,vg giraffe,High,125,0.65,186819,327,186819,8275,2,65460,53,218,0.9997056840437942,0.9559822127611669,0.9991632817610637,0.9773551838240103,0.9668509768182758,186819,55,65678,8602
10,15,SAFARI,High,125,0.65,187060,327,187060,8034,2,65460,53,218,0.9997060631162654,0.9572154476745078,0.9991632817610637,0.9779994562603259,0.967773803962413,187060,55,65678,8361
10,15,vg giraffe,High,125,0.6,172356,304,172356,7646,2,60356,48,201,0.9997099868914074,0.9559082892416225,0.9991750127873018,0.977318605547869,0.96679299166089,172356,50,60557,7950
10,15,SAFARI,High,125,0.6,172582,304,172582,7420,2,60356,48,201,0.9997103665600816,0.9571617139751312,0.9991750127873018,0.9779734684278826,0.9677310896464699,172582,50,60557,7724
10,15,vg giraffe,High,125,0.75,215307,377,215307,9576,3,75410,57,250,0.9997214057864018,0.9558155020864778,0.9992076069730587,0.9772755641392833,0.9667320087713469,215307,60,75660,9953
10,15,SAFARI,High,125,0.75,215579,377,215579,9304,3,75410,57,250,0.9997217571960545,0.9570229956494717,0.9992076069730587,0.9779065046643335,0.967635723303874,215579,60,75660,9681
10,15,vg giraffe,High,125,0.7,201137,355,201137,8925,3,70486,56,239,0.9997067536133919,0.9558970995689512,0.9991664783001808,0.9773112122309062,0.9667888805516339,201137,59,70725,9280
10,15,SAFARI,High,125,0.7,201387,355,201387,8675,3,70486,56,239,0.9997071175401845,0.957085216498667,0.9991664783001808,0.9779319822368119,0.9676779243317057,201387,59,70725,9030
10,15,vg giraffe,High,125,0.85,244043,432,244043,10808,3,85284,65,279,0.9997214381981967,0.9559704328137792,0.9992058950613679,0.9773565561460491,0.9668303443097086,244043,68,85563,11240
10,15,SAFARI,High,125,0.85,244350,432,244350,10501,3,85284,65,279,0.9997217880843473,0.9571730197467124,0.9992058950613679,0.9779848349312888,0.9677308646755487,244350,68,85563,10933
10,15,vg giraffe,High,125,0.8,229538,401,229538,10196,3,80294,62,268,0.9997169026537109,0.9558706560892831,0.9991938184479144,0.9773022408236081,0.9667604017932299,229538,65,80562,10597
10,15,SAFARI,High,125,0.8,229822,401,229822,9912,3,80294,62,268,0.9997172523892173,0.95705332417182,0.9991938184479144,0.9779201824595444,0.9676457934543369,229822,65,80562,10313
10,15,vg giraffe,High,125,0.95,272585,476,272585,12103,3,95212,69,310,0.999735931958468,0.9558885413306027,0.9992468146536394,0.9773206817240655,0.9667741715210186,272585,72,95522,12579
10,15,SAFARI,High,125,0.95,272919,476,272919,11769,3,95212,69,310,0.999736255041375,0.9570597971693482,0.9992468146536394,0.97793265311607,0.967651369111089,272919,72,95522,12245
10,15,vg giraffe,High,125,0.9,258273,459,258273,11431,3,90232,65,295,0.9997367820051792,0.9559895322453482,0.9992494067001491,0.9773738703964397,0.9668531259182056,258273,68,90527,11890
10,15,SAFARI,High,125,0.9,258594,459,258594,11110,3,90232,65,295,0.9997371086591769,0.9571777038306504,0.9992494067001491,0.9779946106935187,0.9677429190759457,258594,68,90527,11569
10,15,vg giraffe,Mid,125,0.15,44758,61,44758,79,2,14954,21,39,0.9994863893168978,0.9968818210165263,0.9984683004794885,0.9981824061374458,0.9972794338551925,44758,23,14993,140
10,15,SAFARI,Mid,125,0.15,44758,61,44758,79,2,14954,21,39,0.9994863893168978,0.9968818210165263,0.9984683004794885,0.9981824061374458,0.9972794338551925,44758,23,14993,140
10,15,vg giraffe,Mid,125,0.1,29837,44,29837,44,0,10014,16,20,0.9994640404649449,0.9970593149540518,0.998407960199005,0.9982602295158753,0.9973983739837399,29837,16,10034,88
10,15,SAFARI,Mid,125,0.1,29837,44,29837,44,0,10014,16,20,0.9994640404649449,0.9970593149540518,0.998407960199005,0.9982602295158753,0.9973983739837399,29837,16,10034,88
10,15,vg giraffe,Mid,125,0.25,74638,105,74638,138,3,24983,35,76,0.9994911350366918,0.9967548510303014,0.9984858748057537,0.9981211177009435,0.9971893816639661,74638,38,25059,243
10,15,SAFARI,Mid,125,0.25,74638,105,74638,138,3,24983,35,76,0.9994911350366918,0.9967548510303014,0.9984858748057537,0.9981211177009435,0.9971893816639661,74638,38,25059,243
10,15,vg giraffe,Mid,125,0.2,59712,82,59712,107,2,19908,27,53,0.9995145712324869,0.9968447939099514,0.9985492746373187,0.9981778973938918,0.9972712821218911,59712,29,19961,189
10,15,SAFARI,Mid,125,0.2,59712,82,59712,107,2,19908,27,53,0.9995145712324869,0.9968447939099514,0.9985492746373187,0.9981778973938918,0.9972712821218911,59712,29,19961,189
10,15,vg giraffe,Mid,125,0.35,104416,160,104416,211,4,35006,38,101,0.9995979245246893,0.9964594844780365,0.9988050869157017,0.9980262371860736,0.9970486508117997,104416,42,35107,371
10,15,SAFARI,Mid,125,0.35,104416,160,104416,211,4,35006,38,101,0.9995979245246893,0.9964594844780365,0.9988050869157017,0.9980262371860736,0.9970486508117997,104416,42,35107,371
10,15,vg giraffe,Mid,125,0.3,89347,135,89347,175,3,29882,37,92,0.9995525076353384,0.9965423781745988,0.998667288598654,0.998045173253502,0.9970753148214688,89347,40,29974,310
10,15,SAFARI,Mid,125,0.3,89347,135,89347,175,3,29882,37,92,0.9995525076353384,0.9965423781745988,0.998667288598654,0.998045173253502,0.9970753148214688,89347,40,29974,310
10,15,vg giraffe,Mid,125,0.45,134670,210,134670,264,5,45252,46,138,0.999621439864609,0.9964926300834666,0.9988776655443322,0.998054582846979,0.9970927817925077,134670,51,45390,474
10,15,SAFARI,Mid,125,0.45,134670,210,134670,264,5,45252,46,138,0.999621439864609,0.9964926300834666,0.9988776655443322,0.998054582846979,0.9970927817925077,134670,51,45390,474
10,15,vg giraffe,Mid,125,0.4,119358,180,119358,235,5,40037,42,116,0.9996063816423097,0.9965351122540138,0.9988308457711442,0.9980683842159396,0.997112012652135,119358,47,40153,415
10,15,SAFARI,Mid,125,0.4,119358,180,119358,235,5,40037,42,116,0.9996063816423097,0.9965351122540138,0.9988308457711442,0.9980683842159396,0.997112012652135,119358,47,40153,415
10,15,vg giraffe,Mid,125,0.55,164623,256,164623,325,5,55335,52,167,0.9996538741802283,0.9964831360015496,0.9989740636080563,0.9980659868317349,0.997110022965805,164623,57,55502,581
10,15,SAFARI,Mid,125,0.55,164623,256,164623,325,5,55335,52,167,0.9996538741802283,0.9964831360015496,0.9989740636080563,0.9980659868317349,0.997110022965805,164623,57,55502,581
10,15,vg giraffe,Mid,125,0.5,149737,235,149737,288,5,50378,51,148,0.9996261507547082,0.9965193664315187,0.9988928867976751,0.9980703409064399,0.9971171368538453,149737,56,50526,523
10,15,SAFARI,Mid,125,0.5,149737,235,149737,288,5,50378,51,148,0.9996261507547082,0.9965193664315187,0.9988928867976751,0.9980703409064399,0.9971171368538453,149737,56,50526,523
10,15,vg giraffe,Mid,125,0.65,194740,308,194740,377,6,65456,60,211,0.9996612014003675,0.9964948189842651,0.9989959381132765,0.9980754988711813,0.9971243461812389,194740,66,65667,685
10,15,SAFARI,Mid,125,0.65,194740,308,194740,377,6,65456,60,211,0.9996612014003675,0.9964948189842651,0.9989959381132765,0.9980754988711813,0.9971243461812389,194740,66,65667,685
10,15,vg giraffe,Mid,125,0.6,179681,280,179681,347,6,60354,55,190,0.9996606246731427,0.9965226168556026,0.9989934823859418,0.9980891542841273,0.9971441972828365,179681,61,60544,627
10,15,SAFARI,Mid,125,0.6,179681,280,179681,347,6,60354,55,190,0.9996606246731427,0.9965226168556026,0.9989934823859418,0.9980891542841273,0.9971441972828365,179681,61,60544,627
10,15,vg giraffe,Mid,125,0.75,224487,350,224487,429,6,75407,66,242,0.9996793715682738,0.9965418660605684,0.9990491409252387,0.9981081531706775,0.9971726353629891,224487,72,75649,779
10,15,SAFARI,Mid,125,0.75,224487,350,224487,429,6,75407,66,242,0.9996793715682738,0.9965418660605684,0.9990491409252387,0.9981081531706775,0.9971726353629891,224487,72,75649,779
10,15,vg giraffe,Mid,125,0.7,209689,330,209689,404,6,70483,63,233,0.9996710494951325,0.9965117881600395,0.9990252172070354,0.9980889188230787,0.9971444624619499,209689,69,70716,734
10,15,SAFARI,Mid,125,0.7,209689,330,209689,404,6,70483,63,233,0.9996710494951325,0.9965117881600395,0.9990252172070354,0.9980889188230787,0.9971444624619499,209689,69,70716,734
10,15,vg giraffe,Mid,125,0.85,254392,411,254392,486,7,85280,72,274,0.9996895520511178,0.9964863350947357,0.9990774584564361,0.9980853735091023,0.9971371750723039,254392,79,85554,897
10,15,SAFARI,Mid,125,0.85,254392,411,254392,486,7,85280,72,274,0.9996895520511178,0.9964863350947357,0.9990774584564361,0.9980853735091023,0.9971371750723039,254392,79,85554,897
10,15,vg giraffe,Mid,125,0.8,239300,386,239300,455,7,80290,70,258,0.9996783316692915,0.9964978908224751,0.9990449612403101,0.9980855776008408,0.9971381006715175,239300,77,80548,841
10,15,SAFARI,Mid,125,0.8,239300,386,239300,455,7,80290,70,258,0.9996783316692915,0.9964978908224751,0.9990449612403101,0.9980855776008408,0.9971381006715175,239300,77,80548,841
10,15,vg giraffe,Mid,125,0.95,284173,455,284173,541,7,95206,78,304,0.99970097587403,0.9965073342474112,0.9991108321564935,0.9981016003807337,0.9971609711002091,284173,85,95510,996
10,15,SAFARI,Mid,125,0.95,284173,455,284173,541,7,95206,78,304,0.99970097587403,0.9965073342474112,0.9991108321564935,0.9981016003807337,0.9971609711002091,284173,85,95510,996
10,15,vg giraffe,Mid,125,0.9,269218,429,269218,521,7,90228,73,289,0.9997029313251491,0.9964836694205087,0.9991169685530426,0.9980907045114984,0.9971449558576913,269218,80,90517,950
10,15,SAFARI,Mid,125,0.9,269218,429,269218,521,7,90228,73,289,0.9997029313251491,0.9964836694205087,0.9991169685530426,0.9980907045114984,0.9971449558576913,269218,80,90517,950
10,15,vg giraffe,None,125,0.15,44822,73,44822,5,1,14957,16,42,0.9996208657641785,0.9982628062360802,0.998867874267448,0.9989413744302923,0.998414446892316,44822,17,14999,78
10,15,SAFARI,None,125,0.15,44822,73,44822,5,1,14957,16,42,0.9996208657641785,0.9982628062360802,0.998867874267448,0.9989413744302923,0.998414446892316,44822,17,14999,78
10,15,vg giraffe,None,125,0.1,29876,47,29876,2,1,10013,10,27,0.9996319470003681,0.9983625730994152,0.9989055815341757,0.9989968568180299,0.9984990994596759,29876,11,10040,49
10,15,SAFARI,None,125,0.1,29876,47,29876,2,1,10013,10,27,0.9996319470003681,0.9983625730994152,0.9989055815341757,0.9989968568180299,0.9984990994596759,29876,11,10040,49
10,15,vg giraffe,None,125,0.25,74763,114,74763,6,1,24987,31,83,0.9995721639147002,0.9983975001001563,0.998725201179189,0.998984486698112,0.9984797719657948,74763,32,25070,120
10,15,SAFARI,None,125,0.25,74763,114,74763,6,1,24987,31,83,0.9995721639147002,0.9983975001001563,0.998725201179189,0.998984486698112,0.9984797719657948,74763,32,25070,120
10,15,vg giraffe,None,125,0.2,59806,92,59806,5,1,19911,22,60,0.9996155710441424,0.9983807154900423,0.9988496548964689,0.9989977616677246,0.9984980662603101,59806,23,19971,97
10,15,SAFARI,None,125,0.2,59806,92,59806,5,1,19911,22,60,0.9996155710441424,0.9983807154900423,0.9988496548964689,0.9989977616677246,0.9984980662603101,59806,23,19971,97
10,15,vg giraffe,None,125,0.35,104617,160,104617,9,1,35011,36,113,0.9996464540294685,0.9983871891283187,0.9989476977332841,0.9990164247517188,0.9985280141767955,104617,37,35124,169
10,15,SAFARI,None,125,0.35,104617,160,104617,9,1,35011,36,113,0.9996464540294685,0.9983871891283187,0.9989476977332841,0.9990164247517188,0.9985280141767955,104617,37,35124,169
10,15,vg giraffe,None,125,0.3,89511,138,89511,8,1,29886,35,100,0.9995979764816242,0.9983715716564239,0.9988008793551396,0.9989843976696948,0.9984792653681932,89511,36,29986,146
10,15,SAFARI,None,125,0.3,89511,138,89511,8,1,29886,35,100,0.9995979764816242,0.9983715716564239,0.9988008793551396,0.9989843976696948,0.9984792653681932,89511,36,29986,146
10,15,vg giraffe,None,125,0.45,134920,210,134920,13,3,45254,43,152,0.9996591734214543,0.9983498960360507,0.9989879433248262,0.999004105749901,0.9985104792491486,134920,46,45406,223
10,15,SAFARI,None,125,0.45,134920,210,134920,13,3,45254,43,152,0.9996591734214543,0.9983498960360507,0.9989879433248262,0.999004105749901,0.9985104792491486,134920,46,45406,223
10,15,vg giraffe,None,125,0.4,119578,184,119578,10,2,40042,40,127,0.999648888145795,0.9983802558193902,0.9989555096864042,0.9990141692287127,0.9985248432645969,119578,42,40169,194
10,15,SAFARI,None,125,0.4,119578,184,119578,10,2,40042,40,127,0.999648888145795,0.9983802558193902,0.9989555096864042,0.9990141692287127,0.9985248432645969,119578,42,40169,194
10,15,vg giraffe,None,125,0.55,164931,258,164931,14,4,55336,50,176,0.9996726975179562,0.9983535407952641,0.9990281827016521,0.999012683683235,0.9985233434041917,164931,54,55512,272
10,15,SAFARI,None,125,0.55,164931,258,164931,14,4,55336,50,176,0.9996726975179562,0.9983535407952641,0.9990281827016521,0.999012683683235,0.9985233434041917,164931,54,55512,272
10,15,vg giraffe,None,125,0.5,150009,236,150009,14,3,50380,48,160,0.9996601359456218,0.9983362061507131,0.9989919155581032,0.9989977324112027,0.9985013691809809,150009,51,50540,250
10,15,SAFARI,None,125,0.5,150009,236,150009,14,3,50380,48,160,0.9996601359456218,0.9983362061507131,0.9989919155581032,0.9989977324112027,0.9985013691809809,150009,51,50540,250
10,15,vg giraffe,None,125,0.65,195099,312,195099,16,4,65460,57,214,0.9996874359499898,0.9983216239311866,0.9990720316421997,0.9990040631152599,0.9985105030594037,195099,61,65674,328
10,15,SAFARI,None,125,0.65,195099,312,195099,16,4,65460,57,214,0.9996874359499898,0.9983216239311866,0.9990720316421997,0.9990040631152599,0.9985105030594037,195099,61,65674,328
10,15,vg giraffe,None,125,0.6,180004,288,180004,15,4,60356,52,197,0.9996889925580362,0.9983195327968409,0.9990760448118267,0.9990037933551075,0.9985098540570158,180004,56,60553,303
10,15,SAFARI,None,125,0.6,180004,288,180004,15,4,60356,52,197,0.9996889925580362,0.9983195327968409,0.9990760448118267,0.9990037933551075,0.9985098540570158,180004,56,60553,303
10,15,vg giraffe,None,125,0.75,224894,359,224894,19,4,75411,64,243,0.9996977267271806,0.9983220284811251,0.9991019782890045,0.9990094039988096,0.9985182428885626,224894,68,75654,378
10,15,SAFARI,None,125,0.75,224894,359,224894,19,4,75411,64,243,0.9996977267271806,0.9983220284811251,0.9991019782890045,0.9990094039988096,0.9985182428885626,224894,68,75654,378
10,15,vg giraffe,None,125,0.7,210080,332,210080,17,4,70487,61,234,0.9996906897618311,0.9983414833506788,0.9990817393269855,0.9990156310185603,0.9985278167949789,210080,65,70721,349
10,15,SAFARI,None,125,0.7,210080,332,210080,17,4,70487,61,234,0.9996906897618311,0.9983414833506788,0.9990817393269855,0.9990156310185603,0.9985278167949789,210080,65,70721,349
10,15,vg giraffe,None,125,0.85,254860,412,254860,23,5,85286,75,269,0.9996862006746685,0.9982960888384026,0.9990658025340107,0.9989906611659332,0.9984894259818731,254860,80,85555,435
10,15,SAFARI,None,125,0.85,254860,412,254860,23,5,85286,75,269,0.9996862006746685,0.9982960888384026,0.9990658025340107,0.9989906611659332,0.9984894259818731,254860,80,85555,435
10,15,vg giraffe,None,125,0.8,239739,386,239739,22,4,80295,71,259,0.9996872576246592,0.9983010406126248,0.9990698135906436,0.9989936682355441,0.998494276379779,239739,75,80554,408
10,15,SAFARI,None,125,0.8,239739,386,239739,22,4,80295,71,259,0.9996872576246592,0.9983010406126248,0.9990698135906436,0.9989936682355441,0.998494276379779,239739,75,80554,408
10,15,vg giraffe,None,125,0.95,284685,463,284685,26,5,95213,81,298,0.9996980029567617,0.9982852574217846,0.9991003901796082,0.9989911307231399,0.9984899060064973,284685,86,95511,489
10,15,SAFARI,None,125,0.95,284685,463,284685,26,5,95213,81,298,0.9996980029567617,0.9982852574217846,0.9991003901796082,0.9989911307231399,0.9984899060064973,284685,86,95511,489
10,15,vg giraffe,None,125,0.9,269706,442,269706,25,5,90233,76,284,0.9996997631464822,0.998271477904898,0.9991059405284884,0.9989851100081487,0.99848103090326,269706,81,90517,467
10,15,SAFARI,None,125,0.9,269706,442,269706,25,5,90233,76,284,0.9996997631464822,0.998271477904898,0.9991059405284884,0.9989851100081487,0.99848103090326,269706,81,90517,467
10,15,vg giraffe,Single-stranded,125,0.15,44818,67,44818,15,0,14958,17,40,0.9996208319393332,0.998173719376392,0.9988677988677989,0.9988967515462195,0.9983476591838438,44818,17,14998,82
10,15,SAFARI,Single-stranded,125,0.15,44818,67,44818,15,0,14958,17,40,0.9996208319393332,0.998173719376392,0.9988677988677989,0.9988967515462195,0.9983476591838438,44818,17,14998,82
10,15,vg giraffe,Single-stranded,125,0.1,29871,42,29871,12,0,10014,11,19,0.9996318854159695,0.9981954887218045,0.9989048187972919,0.998913170699082,0.9983737396482274,29871,11,10033,54
10,15,SAFARI,Single-stranded,125,0.1,29871,42,29871,12,0,10014,11,19,0.9996318854159695,0.9981954887218045,0.9989048187972919,0.998913170699082,0.9983737396482274,29871,11,10033,54
10,15,vg giraffe,Single-stranded,125,0.25,74738,121,74738,23,0,24987,29,81,0.999612128345393,0.9980769744397853,0.9988444834043909,0.9988439615366623,0.998269636623691,74738,29,25068,144
10,15,SAFARI,Single-stranded,125,0.25,74738,121,74738,23,0,24987,29,81,0.999612128345393,0.9980769744397853,0.9988444834043909,0.9988439615366623,0.998269636623691,74738,29,25068,144
10,15,vg giraffe,Single-stranded,125,0.2,59783,99,59783,21,0,19911,22,54,0.999632137781122,0.99799676143098,0.9988992845349477,0.998813780198483,0.9982225560145199,59783,22,19965,120
10,15,SAFARI,Single-stranded,125,0.2,59783,99,59783,21,0,19911,22,54,0.999632137781122,0.99799676143098,0.9988992845349477,0.998813780198483,0.9982225560145199,59783,22,19965,120
10,15,vg giraffe,Single-stranded,125,0.35,104591,164,104591,30,1,35009,34,104,0.9996654751209069,0.9981485899699385,0.9990042107659042,0.9989064566808812,0.9983635025333553,104591,35,35113,194
10,15,SAFARI,Single-stranded,125,0.35,104591,164,104591,30,1,35009,34,104,0.9996654751209069,0.9981485899699385,0.9990042107659042,0.9989064566808812,0.9983635025333553,104591,35,35113,194
10,15,vg giraffe,Single-stranded,125,0.3,89488,140,89488,28,0,29885,33,93,0.9996313714100602,0.9981261711430356,0.9989004031854987,0.9988782042338024,0.99832033894056,89488,33,29978,168
10,15,SAFARI,Single-stranded,125,0.3,89488,140,89488,28,0,29885,33,93,0.9996313714100602,0.9981261711430356,0.9989004031854987,0.9988782042338024,0.99832033894056,89488,33,29978,168
10,15,vg giraffe,Single-stranded,125,0.45,134883,218,134883,45,2,45253,40,141,0.9996887159533074,0.9980539564619004,0.9990756228541244,0.998870667343032,0.9983110166018762,134883,42,45394,263
10,15,SAFARI,Single-stranded,125,0.45,134883,218,134883,45,2,45253,40,141,0.9996887159533074,0.9980539564619004,0.9990756228541244,0.998870667343032,0.9983110166018762,134883,42,45394,263
10,15,vg giraffe,Single-stranded,125,0.4,119545,191,119545,39,2,40040,37,120,0.9996738694139684,0.998079732832394,0.9990298266126023,0.9988761650909304,0.9983184767524723,119545,39,40160,230
10,15,SAFARI,Single-stranded,125,0.4,119545,191,119545,39,2,40040,37,120,0.9996738694139684,0.998079732832394,0.9990298266126023,0.9988761650909304,0.9983184767524723,119545,39,40160,230
10,15,vg giraffe,Single-stranded,125,0.55,164886,259,164886,60,2,55337,48,166,0.9996968521123345,0.9980690657062438,0.9990999585980955,0.9988822957463629,0.998328486396869,164886,50,55503,319
10,15,SAFARI,Single-stranded,125,0.55,164886,259,164886,60,2,55337,48,166,0.9996968521123345,0.9980690657062438,0.9990999585980955,0.9988822957463629,0.998328486396869,164886,50,55503,319
10,15,vg giraffe,Single-stranded,125,0.5,149971,240,149971,50,2,50379,45,154,0.9996867042621552,0.9980700248234738,0.9990707789640174,0.9988777103959985,0.9983220557555479,149971,47,50533,290
10,15,SAFARI,Single-stranded,125,0.5,149971,240,149971,50,2,50379,45,154,0.9996867042621552,0.9980700248234738,0.9990707789640174,0.9988777103959985,0.9983220557555479,149971,47,50533,290
10,15,vg giraffe,Single-stranded,125,0.65,195060,301,195060,70,2,65461,59,208,0.9996873734759457,0.9981016317779676,0.9990719610527917,0.9988938732870398,0.9983458479635168,195060,61,65669,371
10,15,SAFARI,Single-stranded,125,0.65,195060,301,195060,70,2,65461,59,208,0.9996873734759457,0.9981016317779676,0.9990719610527917,0.9988938732870398,0.9983458479635168,195060,61,65669,371
10,15,vg giraffe,Single-stranded,125,0.6,179968,277,179968,64,2,60357,53,191,0.9996944834826661,0.9981088021119301,0.9990924541689356,0.9989010135097632,0.9983562462641961,179968,55,60548,341
10,15,SAFARI,Single-stranded,125,0.6,179968,277,179968,64,2,60357,53,191,0.9996944834826661,0.9981088021119301,0.9990924541689356,0.9989010135097632,0.9983562462641961,179968,55,60548,341
10,15,vg giraffe,Single-stranded,125,0.75,224834,358,224834,84,3,75411,69,240,0.9996798662552355,0.9980379623217742,0.9990491660393803,0.998858239556446,0.9982923531307413,224834,72,75651,442
10,15,SAFARI,Single-stranded,125,0.75,224834,358,224834,84,3,75411,69,240,0.9996798662552355,0.9980379623217742,0.9990491660393803,0.998858239556446,0.9982923531307413,224834,72,75651,442
10,15,vg giraffe,Single-stranded,125,0.7,210017,336,210017,80,2,70488,64,229,0.9996858384543252,0.998023123749602,0.9990675727222639,0.9988537891542771,0.9982860150204825,210017,66,70717,416
10,15,SAFARI,Single-stranded,125,0.7,210017,336,210017,80,2,70488,64,229,0.9996858384543252,0.998023123749602,0.9990675727222639,0.9988537891542771,0.9982860150204825,210017,66,70717,416
10,15,vg giraffe,Single-stranded,125,0.85,254786,409,254786,103,4,85288,76,271,0.9996861095634568,0.9979945005444618,0.9990658461682177,0.9988395888380991,0.9982636088192247,254786,80,85559,512
10,15,SAFARI,Single-stranded,125,0.85,254786,409,254786,103,4,85288,76,271,0.9996861095634568,0.9979945005444618,0.9990658461682177,0.9988395888380991,0.9982636088192247,254786,80,85559,512
10,15,vg giraffe,Single-stranded,125,0.8,239674,384,239674,93,4,80296,73,257,0.9996788334563776,0.9980137496824915,0.9990450204638472,0.9988455976428521,0.9982729650446878,239674,77,80553,477
10,15,SAFARI,Single-stranded,125,0.8,239674,384,239674,93,4,80296,73,257,0.9996788334563776,0.9980137496824915,0.9990450204638472,0.9988455976428521,0.9982729650446878,239674,77,80553,477
10,15,vg giraffe,Single-stranded,125,0.95,284606,459,284606,112,5,95214,80,307,0.9997014306739588,0.9979977347401789,0.9991109344601803,0.9988488562263541,0.998277234015174,284606,85,95521,571
10,15,SAFARI,Single-stranded,125,0.95,284606,459,284606,112,5,95214,80,307,0.9997014306739588,0.9979977347401789,0.9991109344601803,0.9988488562263541,0.998277234015174,284606,85,95521,571
10,15,vg giraffe,Single-stranded,125,0.9,269635,431,269635,110,4,90235,77,287,0.9996996841121772,0.9979976015634253,0.9991059898678851,0.9988479177316945,0.9982759528686537,269635,81,90522,541
10,15,SAFARI,Single-stranded,125,0.9,269635,431,269635,110,4,90235,77,287,0.9996996841121772,0.9979976015634253,0.9991059898678851,0.9988479177316945,0.9982759528686537,269635,81,90522,541
10,5,vg giraffe,High,125,0.15,44685,73,44685,138,0,14956,18,40,0.9995973424602376,0.9953002494654312,0.9988011189556414,0.9974441679036595,0.9961775997329327,44685,18,14996,211
10,5,SAFARI,High,125,0.15,44706,73,44706,117,0,14956,18,40,0.9995975315266971,0.9957679971489665,0.9988011189556414,0.9976790894889532,0.9965281255216157,44706,18,14996,190
10,5,vg giraffe,High,125,0.1,29788,47,29788,88,0,10014,11,26,0.9996308600959763,0.9954884202787154,0.9989055815341757,0.997555339740799,0.996347625956872,29788,11,10040,135
10,5,SAFARI,High,125,0.1,29802,47,29802,74,0,10014,11,26,0.9996310334417872,0.9959562878053672,0.9989055815341757,0.9977902772197671,0.9966978536048432,29802,11,10040,121
10,5,vg giraffe,High,125,0.25,74528,129,74528,223,2,24984,36,78,0.9994903843574819,0.9952991452991453,0.9984860557768924,0.9973903617360116,0.9960992198439688,74528,38,25062,352
10,5,SAFARI,High,125,0.25,74566,128,74566,186,2,24984,36,78,0.9994906439333011,0.9958066239316239,0.9984860557768924,0.9976452329346285,0.9964792958591718,74566,38,25062,314
10,5,vg giraffe,High,125,0.2,59616,94,59616,190,1,19909,27,55,0.9995305479176447,0.9952587646076795,0.9985994397759104,0.9973900823127886,0.9960947278826415,59616,28,19964,284
10,5,SAFARI,High,125,0.2,59648,94,59648,158,1,19909,27,55,0.9995307996514512,0.9957929883138564,0.9985994397759104,0.9976583929885596,0.996495268612627,59648,28,19964,252
10,5,vg giraffe,High,125,0.35,104303,181,104303,302,4,35006,41,108,0.9995687507187488,0.9953906056152539,0.998720100116613,0.9974753029158339,0.9962270892136197,104303,45,35114,483
10,5,SAFARI,High,125,0.35,104358,181,104358,247,5,35005,41,108,0.9995594038542585,0.9959154848930201,0.9986916578969823,0.9977341173096228,0.9966129550894994,104358,46,35113,428
10,5,vg giraffe,High,125,0.3,89241,149,89241,266,2,29883,39,96,0.9995407808964853,0.9953711965735701,0.9986342438374417,0.9974516312912852,0.9961897122230021,89241,41,29979,415
10,5,SAFARI,High,125,0.3,89290,149,89290,217,2,29883,39,96,0.9995410327881699,0.9959177299901847,0.9986342438374417,0.9977260918390721,0.9965991510411444,89290,41,29979,366
10,5,vg giraffe,High,125,0.45,134507,228,134507,410,5,45250,48,147,0.9996061236623067,0.9952791446224426,0.9988338833883388,0.9974379414545522,0.9961737589634264,134507,53,45397,638
10,5,SAFARI,High,125,0.45,134579,228,134579,338,7,45248,48,147,0.9995914850632084,0.9958119057308816,0.9987898789878988,0.9976981158652082,0.9965613665937595,134579,55,45395,566
10,5,vg giraffe,High,125,0.4,119215,199,119215,359,5,40037,44,123,0.9995891467668366,0.9953411870788909,0.9987813673555671,0.9974606441680577,0.996205823155105,119215,49,40160,558
10,5,SAFARI,High,125,0.4,119280,199,119280,294,6,40036,44,123,0.9995809938825106,0.9958838803403104,0.9987564973015991,0.9977290121830341,0.996605868160168,119280,50,40159,493
10,5,vg giraffe,High,125,0.55,164420,273,164420,511,6,55332,54,172,0.9996352140077821,0.9952543521948621,0.9989201641350515,0.9974399728224603,0.9961769821713292,164420,60,55504,784
10,5,SAFARI,High,125,0.55,164510,273,164510,421,9,55329,54,172,0.9996171911552928,0.9957991331929009,0.9988661723418041,0.9977045094109049,0.9965710610233367,164510,63,55501,694
10,5,vg giraffe,High,125,0.5,149557,246,149557,459,6,50375,52,156,0.99961233833506,0.9953081950193662,0.9988535057028207,0.9974556234722903,0.9962011640469801,149557,58,50531,705
10,5,SAFARI,High,125,0.5,149639,246,149639,377,8,50373,52,156,0.9995991957194102,0.9958539085064754,0.9988139714167111,0.997723037328186,0.9965994692583059,149639,60,50529,623
10,5,vg giraffe,High,125,0.65,194497,322,194497,602,8,65454,65,206,0.9996248136917305,0.995271746639307,0.9988894467010482,0.9974435307481455,0.9961823292003952,194497,73,65660,924
10,5,SAFARI,High,125,0.65,194602,322,194602,497,11,65451,65,206,0.9996096117691778,0.9958090481575675,0.998843807524379,0.9977057106016678,0.9965729033443869,194602,76,65657,819
10,5,vg giraffe,High,125,0.6,179453,299,179453,554,6,60352,59,190,0.999637919317283,0.995269153550076,0.9989275166234923,0.9974487527235538,0.9961894957930871,179453,65,60542,853
10,5,SAFARI,High,125,0.6,179549,299,179549,458,9,60349,59,190,0.9996214166810491,0.9958015817554602,0.9988780173907305,0.9977078430664337,0.9965755272650293,179549,68,60539,757
10,5,vg giraffe,High,125,0.75,224210,371,224210,679,9,75404,70,237,0.9996477758606084,0.9953387197016781,0.9989566825145272,0.9974885941243334,0.9962489201940328,224210,79,75641,1050
10,5,SAFARI,High,125,0.75,224325,371,224325,564,13,75400,70,237,0.9996301379629959,0.9958492408772086,0.9989038563127312,0.9977361075282208,0.9966177154628214,224325,83,75637,935
10,5,vg giraffe,High,125,0.7,209420,349,209420,648,9,70480,68,227,0.9996324529706869,0.9952617896842936,0.9989121835443038,0.9974423334301785,0.9961806679208111,209420,77,70707,997
10,5,SAFARI,High,125,0.7,209532,349,209532,536,12,70477,68,227,0.9996183424613094,0.9957940660688063,0.9988698010849909,0.9977025395865523,0.9965682910089224,209532,80,70704,885
10,5,vg giraffe,High,125,0.85,254103,426,254103,754,10,85277,81,263,0.9996420057121725,0.9953776788897029,0.9989373007438895,0.9975052848313074,0.9962717870196003,254103,91,85540,1180
10,5,SAFARI,High,125,0.85,254233,426,254233,624,14,85273,81,263,0.9996264666100468,0.9958869176560915,0.9988905886886759,0.99775318821611,0.9966413816974369,254233,95,85536,1050
10,5,vg giraffe,High,125,0.8,239028,395,239028,712,10,80287,78,252,0.9996319777848408,0.9953900930726466,0.9989085542064072,0.9975065258079794,0.9962744963555533,239028,88,80539,1107
10,5,SAFARI,High,125,0.8,239149,395,239149,591,14,80283,78,252,0.9996154505289645,0.9958939763049951,0.9988589430339713,0.9977512432829346,0.9966392527793192,239149,92,80535,986
10,5,vg giraffe,High,125,0.95,283853,468,283853,843,11,95204,88,291,0.9996513495238631,0.9954026454952238,0.998964370148754,0.9975224734500523,0.9962968604730563,283853,99,95495,1311
10,5,SAFARI,High,125,0.95,283993,468,283993,703,16,95199,88,291,0.999633927848587,0.9958935910563745,0.9989120656108124,0.9977602540838034,0.9966514163852106,283993,104,95490,1171
10,5,vg giraffe,High,125,0.9,268908,452,268908,803,10,90225,83,277,0.9996542763781547,0.9953546562630708,0.9989734532810861,0.9974998330749086,0.9962634231257519,268908,93,90502,1255
10,5,SAFARI,High,125,0.9,269045,452,269045,666,14,90221,83,277,0.9996395954551872,0.9958617575315643,0.9989293007340361,0.997747100434819,0.9966320913188342,269045,97,90498,1118
10,5,vg giraffe,Mid,125,0.15,44837,61,44837,0,4,14952,24,36,0.9993759054942606,0.9986413648714865,0.9981353223228556,0.9990085001615365,0.9985145375037554,44837,28,14988,61
10,5,SAFARI,Mid,125,0.15,44837,61,44837,0,4,14952,24,36,0.9993759054942606,0.9986413648714865,0.9981353223228556,0.9990085001615365,0.9985145375037554,44837,28,14988,61
10,5,vg giraffe,Mid,125,0.1,29881,44,29881,0,1,10013,17,19,0.9993979731763604,0.9985296574770259,0.9982089552238806,0.9989636266381386,0.9984490306441526,29881,18,10032,44
10,5,SAFARI,Mid,125,0.1,29881,44,29881,0,1,10013,17,19,0.9993979731763604,0.9985296574770259,0.9982089552238806,0.9989636266381386,0.9984490306441526,29881,18,10032,44
10,5,vg giraffe,Mid,125,0.25,74776,105,74776,0,7,24979,45,66,0.9993050729673384,0.99859777513655,0.9979280392078734,0.9989512988531084,0.9984296545239952,74776,52,25045,105
10,5,SAFARI,Mid,125,0.25,74776,105,74776,0,7,24979,45,66,0.9993050729673384,0.99859777513655,0.9979280392078734,0.9989512988531084,0.9984296545239952,74776,52,25045,105
10,5,vg giraffe,Mid,125,0.2,59819,82,59819,0,5,19905,33,47,0.9993651536161184,0.998631074606434,0.9980990495247624,0.9989979792581706,0.9984979534615914,59819,38,19952,82
10,5,SAFARI,Mid,125,0.2,59819,82,59819,0,5,19905,33,47,0.9993651536161184,0.998631074606434,0.9980990495247624,0.9989979792581706,0.9984979534615914,59819,38,19952,82
10,5,vg giraffe,Mid,125,0.35,104627,160,104627,0,9,35001,51,88,0.9994268629342707,0.9984730930363499,0.9982929813081454,0.9989497503270095,0.9984278527326778,104627,60,35089,160
10,5,SAFARI,Mid,125,0.35,104627,160,104627,0,9,35001,51,88,0.9994268629342707,0.9984730930363499,0.9982929813081454,0.9989497503270095,0.9984278527326778,104627,60,35089,160
10,5,vg giraffe,Mid,125,0.3,89522,135,89522,0,7,29878,48,81,0.9993860031034753,0.9984942614631317,0.9981675218231492,0.9989399332715891,0.998412313760226,89522,55,29959,135
10,5,SAFARI,Mid,125,0.3,89522,135,89522,0,7,29878,48,81,0.9993860031034753,0.9984942614631317,0.9981675218231492,0.9989399332715891,0.998412313760226,89522,55,29959,135
10,5,vg giraffe,Mid,125,0.45,134934,210,134934,0,11,45246,61,123,0.9994666903693169,0.998446101935713,0.9984155278272925,0.9989561354802887,0.9984384085056899,134934,72,45369,210
10,5,SAFARI,Mid,125,0.45,134934,210,134934,0,11,45246,61,123,0.9994666903693169,0.998446101935713,0.9984155278272925,0.9989561354802887,0.9984384085056899,134934,72,45369,210
10,5,vg giraffe,Mid,125,0.4,119593,180,119593,0,10,40032,55,103,0.9994567851710708,0.9984971571222229,0.9983830845771144,0.9989767406893844,0.9984684915579504,119593,65,40135,180
10,5,SAFARI,Mid,125,0.4,119593,180,119593,0,10,40032,55,103,0.9994567851710708,0.9984971571222229,0.9983830845771144,0.9989767406893844,0.9984684915579504,119593,65,40135,180
10,5,vg giraffe,Mid,125,0.55,164949,254,164949,1,11,55329,69,150,0.9995152367159711,0.9984564538388901,0.9985600892744649,0.9989855647376247,0.9984825355698193,164949,80,55479,255
10,5,SAFARI,Mid,125,0.55,164949,254,164949,1,11,55329,69,150,0.9995152367159711,0.9984564538388901,0.9985600892744649,0.9989855647376247,0.9984825355698193,164949,80,55479,255
10,5,vg giraffe,Mid,125,0.5,150026,234,150026,0,11,50372,66,133,0.9994870189136793,0.9984426993211766,0.9984777193468032,0.9989645861840506,0.9984515191045698,150026,77,50505,234
10,5,SAFARI,Mid,125,0.5,150026,234,150026,0,11,50372,66,133,0.9994870189136793,0.9984426993211766,0.9984777193468032,0.9989645861840506,0.9984515191045698,150026,77,50505,234
10,5,vg giraffe,Mid,125,0.65,195119,305,195119,1,14,65448,83,188,0.9995031144988116,0.9984341819112191,0.9985243332876942,0.998968362255882,0.9984568728509179,195119,97,65636,306
10,5,SAFARI,Mid,125,0.65,195119,305,195119,1,14,65448,82,189,0.9995082345106677,0.9984341819112191,0.9985395463465839,0.9989709195166906,0.9984607019505434,195119,96,65637,306
10,5,vg giraffe,Mid,125,0.6,180030,277,180030,1,13,60347,77,168,0.9995003331112592,0.9984581937573486,0.9985149740120453,0.9989789916432685,0.9984724776164009,180030,90,60515,278
10,5,SAFARI,Mid,125,0.6,180030,277,180030,1,13,60347,77,168,0.9995003331112592,0.9984581937573486,0.9985149740120453,0.9989789916432685,0.9984724776164009,180030,90,60515,278
10,5,vg giraffe,Mid,125,0.75,224918,347,224918,1,15,75398,90,218,0.9995333810321612,0.9984551596778919,0.9986133305159731,0.9989939794221044,0.9984949516092058,224918,105,75616,348
10,5,SAFARI,Mid,125,0.75,224918,347,224918,1,15,75398,89,219,0.9995378229684209,0.9984551596778919,0.9986265368920114,0.9989961979888426,0.9984982740118344,224918,104,75617,348
10,5,vg giraffe,Mid,125,0.7,210095,327,210095,1,14,70475,86,210,0.9995242512904684,0.9984412350360939,0.9985872713145441,0.9989824496336344,0.9984779949361327,210095,100,70685,328
10,5,SAFARI,Mid,125,0.7,210095,327,210095,1,14,70475,85,211,0.9995290065368184,0.9984412350360939,0.9986013986013986,0.9989848246742286,0.9984815510227305,210095,99,70686,328
10,5,vg giraffe,Mid,125,0.85,254879,409,254879,1,18,85269,99,247,0.9995411692732435,0.9983939770221201,0.998633704296241,0.9989672437951341,0.9984541918679346,254879,117,85516,410
10,5,SAFARI,Mid,125,0.85,254879,409,254879,1,18,85269,98,248,0.9995450891193945,0.9983939770221201,0.9986453820372987,0.9989692014642827,0.9984571250901966,254879,116,85517,410
10,5,vg giraffe,Mid,125,0.8,239757,383,239757,1,17,80280,97,231,0.9995247445501957,0.9984009394480743,0.9985860465116279,0.9989625259368516,0.9984474663773591,239757,114,80511,384
10,5,SAFARI,Mid,125,0.8,239757,383,239757,1,17,80280,96,232,0.9995289114937258,0.9984009394480743,0.9985984496124031,0.9989646070610881,0.998450583914754,239757,113,80512,384
10,5,vg giraffe,Mid,125,0.95,284715,453,284715,1,18,95195,108,274,0.9995576479509621,0.9984079615947035,0.9986819394319787,0.9989824739916843,0.9984767467512685,284715,126,95469,454
10,5,SAFARI,Mid,125,0.95,284715,453,284715,1,18,95195,107,275,0.999561157140851,0.9984079615947035,0.9986924002301376,0.9989842265648436,0.9984793730499733,284715,125,95470,454
10,5,vg giraffe,Mid,125,0.9,269740,427,269740,1,18,90217,101,261,0.9995590289743903,0.998415800538924,0.9986864907226508,0.998987087682653,0.9984837775283079,269740,119,90478,428
10,5,SAFARI,Mid,125,0.9,269740,427,269740,1,18,90217,100,262,0.9995627329929074,0.998415800538924,0.9986975286157378,0.9989889375696726,0.9984865494158247,269740,118,90479,428
10,5,vg giraffe,None,125,0.15,44827,73,44827,0,2,14956,18,40,0.9995540392891387,0.9983741648106904,0.9986680873734683,0.9989637536630752,0.9984478269577408,44827,20,14996,73
10,5,SAFARI,None,125,0.15,44827,73,44827,0,2,14956,18,40,0.9995540392891387,0.9983741648106904,0.9986680873734683,0.9989637536630752,0.9984478269577408,44827,20,14996,73
10,5,vg giraffe,None,125,0.1,29878,47,29878,0,1,10013,11,26,0.9995985279357644,0.9984294068504594,0.9988060889463735,0.9990136253448131,0.9985241144686812,29878,12,10039,47
10,5,SAFARI,None,125,0.1,29878,47,29878,0,1,10013,11,26,0.9995985279357644,0.9984294068504594,0.9988060889463735,0.9990136253448131,0.9985241144686812,29878,12,10039,47
10,5,vg giraffe,None,125,0.25,74769,114,74769,0,4,24984,39,75,0.9994252258995883,0.9984776250951485,0.9982869890845351,0.9989512007749091,0.9984297644646697,74769,43,25059,114
10,5,SAFARI,None,125,0.25,74769,114,74769,0,4,24984,39,75,0.9994252258995883,0.9984776250951485,0.9982869890845351,0.9989512007749091,0.9984297644646697,74769,43,25059,114
10,5,vg giraffe,None,125,0.2,59811,92,59811,0,3,19909,27,55,0.9994986714794205,0.9984641837637513,0.9984995498649595,0.9989811598075895,0.9984730340313153,59811,30,19964,92
10,5,SAFARI,None,125,0.2,59811,92,59811,0,3,19909,27,55,0.9994986714794205,0.9984641837637513,0.9984995498649595,0.9989811598075895,0.9984730340313153,59811,30,19964,92
10,5,vg giraffe,None,125,0.35,104628,158,104628,0,6,35006,47,102,0.9994936999073375,0.9984921649838719,0.9984926481044339,0.998992681424759,0.9984922863655527,104628,53,35108,158
10,5,SAFARI,None,125,0.35,104628,158,104628,0,6,35006,47,102,0.9994936999073375,0.9984921649838719,0.9984926481044339,0.998992681424759,0.9984922863655527,104628,53,35108,158
10,5,vg giraffe,None,125,0.3,89521,136,89521,0,5,29882,44,91,0.9994529418332031,0.9984831078443401,0.9983678635667177,0.9989677894513662,0.9984541983138228,89521,49,29973,136
10,5,SAFARI,None,125,0.3,89521,136,89521,0,5,29882,44,91,0.9994529418332031,0.9984831078443401,0.9983678635667177,0.9989677894513662,0.9984541983138228,89521,49,29973,136
10,5,vg giraffe,None,125,0.45,134935,208,134935,0,11,45246,56,139,0.9995037110561324,0.9984608895762267,0.9985259174513773,0.9989820281700569,0.9984772557379772,134935,67,45385,208
10,5,SAFARI,None,125,0.45,134935,208,134935,0,11,45246,56,139,0.9995037110561324,0.9984608895762267,0.9985259174513773,0.9989820281700569,0.9984772557379772,134935,67,45385,208
10,5,vg giraffe,None,125,0.4,119590,182,119590,0,9,40035,51,116,0.9994985374007522,0.9984804461810773,0.9985078709805775,0.9989892324013666,0.9984873392797985,119590,60,40151,182
10,5,SAFARI,None,125,0.4,119590,182,119590,0,9,40035,51,116,0.9994985374007522,0.9984804461810773,0.9985078709805775,0.9989892324013666,0.9984873392797985,119590,60,40151,182
10,5,vg giraffe,None,125,0.55,164947,256,164947,0,13,55327,66,160,0.9995212875546884,0.9984503913367191,0.9985782672857503,0.9989855524499666,0.9984825768110559,164947,79,55487,256
10,5,SAFARI,None,125,0.55,164947,256,164947,0,13,55327,66,160,0.9995212875546884,0.9984503913367191,0.9985782672857503,0.9989855524499666,0.9984825768110559,164947,79,55487,256
10,5,vg giraffe,None,125,0.5,150025,234,150025,0,12,50371,62,146,0.9995069920519124,0.9984426889570674,0.9985372892411694,0.9989745570286126,0.9984665173014687,150025,74,50517,234
10,5,SAFARI,None,125,0.5,150025,234,150025,0,12,50371,62,146,0.9995069920519124,0.9984426889570674,0.9985372892411694,0.9989745570286126,0.9984665173014687,150025,74,50517,234
10,5,vg giraffe,None,125,0.65,195117,310,195117,0,13,65451,78,193,0.9995338305807139,0.9984137299349629,0.9986156537613143,0.9989734662792632,0.998464554567663,195117,91,65644,310
10,5,SAFARI,None,125,0.65,195117,310,195117,0,13,65451,77,194,0.9995389509597504,0.9984137299349629,0.9986308663573439,0.9989760235924164,0.9984683836086414,195117,90,65645,310
10,5,vg giraffe,None,125,0.6,180021,286,180021,0,13,60347,72,177,0.9995280557005319,0.998413816435302,0.9985975680179511,0.9989706253658998,0.9984600441647711,180021,85,60524,286
10,5,SAFARI,None,125,0.6,180021,286,180021,0,13,60347,72,177,0.9995280557005319,0.998413816435302,0.9985975680179511,0.9989706253658998,0.9984600441647711,180021,85,60524,286
10,5,vg giraffe,None,125,0.75,224915,357,224915,0,13,75402,85,222,0.9995644696084226,0.9984152491210625,0.998705792240036,0.998989528853948,0.9984883419603049,224915,98,75624,357
10,5,SAFARI,None,125,0.75,224915,357,224915,0,13,75402,84,223,0.9995689118802553,0.9984152491210625,0.9987189984416682,0.9989917474305104,0.9984916642856668,224915,97,75625,357
10,5,vg giraffe,None,125,0.7,210099,330,210099,0,13,70478,82,213,0.9995480365757348,0.9984317750880345,0.9986579267086712,0.9989895940069848,0.9984887008161015,210099,95,70691,330
10,5,SAFARI,None,125,0.7,210099,330,210099,0,13,70478,81,214,0.9995527919578673,0.9984317750880345,0.9986720537959484,0.9989919690363319,0.9984922568141813,210099,94,70692,330
10,5,vg giraffe,None,125,0.85,254885,410,254885,0,14,85277,100,244,0.9995529394232918,0.9983940147672301,0.9986687686109651,0.9989731409736348,0.9984630276009738,254885,114,85521,410
10,5,SAFARI,None,125,0.85,254885,410,254885,0,14,85277,99,245,0.9995568592694845,0.9983940147672301,0.99868044607929,0.9989750986198127,0.9984659607544071,254885,113,85522,410
10,5,vg giraffe,None,125,0.8,239763,384,239763,0,13,80286,95,235,0.9995497579949223,0.9984009794001174,0.9986605315705267,0.9989750384360587,0.9984662194179116,239763,108,80521,384
10,5,SAFARI,None,125,0.8,239763,384,239763,0,13,80286,94,236,0.9995539250427314,0.9984009794001174,0.9986729340559848,0.9989771195603488,0.9984693368581191,239763,107,80522,384
10,5,vg giraffe,None,125,0.95,284713,461,284713,0,16,95202,109,270,0.9995611540595005,0.9983834430908849,0.9986924275866398,0.9989719514676885,0.998461017251839,284713,125,95472,461
10,5,SAFARI,None,125,0.95,284713,461,284713,0,16,95202,108,271,0.9995646632986586,0.9983834430908849,0.9987028881659467,0.9989737040162383,0.9984636435022625,284713,124,95473,461
10,5,vg giraffe,None,125,0.9,269733,440,269733,0,14,90224,103,257,0.9995664257921067,0.9983714138718525,0.9987085807633722,0.9989685624501179,0.9984560843305033,269733,117,90481,440
10,5,SAFARI,None,125,0.9,269733,440,269733,0,14,90224,102,258,0.9995701299615711,0.9983714138718525,0.9987196185346255,0.9989704123165352,0.9984588561719207,269733,116,90482,440
10,5,vg giraffe,Single-stranded,125,0.15,44833,67,44833,0,2,14956,21,36,0.9994872480827537,0.9985077951002227,0.9984681984681985,0.9989972815187843,0.9984978719853125,44833,23,14992,67
10,5,SAFARI,Single-stranded,125,0.15,44833,67,44833,0,2,14956,21,36,0.9994872480827537,0.9985077951002227,0.9984681984681985,0.9989972815187843,0.9984978719853125,44833,23,14992,67
10,5,vg giraffe,Single-stranded,125,0.1,29883,42,29883,0,2,10012,13,17,0.9994982942002809,0.9985964912280701,0.9985065710872163,0.999047189208164,0.9985738947684455,29883,15,10029,42
10,5,SAFARI,Single-stranded,125,0.1,29883,42,29883,0,2,10012,13,17,0.9994982942002809,0.9985964912280701,0.9985065710872163,0.999047189208164,0.9985738947684455,29883,15,10029,42
10,5,vg giraffe,Single-stranded,125,0.25,74761,121,74761,0,3,24984,39,71,0.9994385251928398,0.9983841243556529,0.9983264932063594,0.9989110465310486,0.9983696576281019,74761,42,25055,121
10,5,SAFARI,Single-stranded,125,0.25,74761,121,74761,0,3,24984,38,72,0.9994518863132001,0.9983841243556529,0.9983663386062079,0.9989177199967932,0.998379659728543,74761,41,25056,121
10,5,vg giraffe,Single-stranded,125,0.2,59804,99,59804,0,3,19908,28,48,0.9994819085819336,0.9983473281805586,0.998448991844699,0.9989142962133993,0.9983727625485042,59804,31,19956,99
10,5,SAFARI,Single-stranded,125,0.2,59804,99,59804,0,3,19908,28,48,0.9994819085819336,0.9983473281805586,0.998448991844699,0.9989142962133993,0.9983727625485042,59804,31,19956,99
10,5,vg giraffe,Single-stranded,125,0.35,104621,164,104621,0,7,35003,47,91,0.999484117506568,0.9984348904900511,0.998463639467395,0.9989592284923136,0.9984421115819714,104621,54,35094,164
10,5,SAFARI,Single-stranded,125,0.35,104621,164,104621,0,7,35003,46,92,0.9994936660488756,0.9984348904900511,0.9984920905883692,0.9989639977274789,0.9984492578591183,104621,53,35095,164
10,5,vg giraffe,Single-stranded,125,0.3,89516,140,89516,0,5,29880,44,82,0.999452911293474,0.9984384759525297,0.9983672653360435,0.9989454360817092,0.9984206172127654,89516,49,29962,140
10,5,SAFARI,Single-stranded,125,0.3,89516,140,89516,0,5,29880,43,83,0.9994640703854227,0.9984384759525297,0.9984005864516344,0.9989510099319272,0.9984289737354493,89516,48,29963,140
10,5,vg giraffe,Single-stranded,125,0.45,134929,217,134929,0,9,45246,54,127,0.9995333056773735,0.9983943290959407,0.9986134342811868,0.9989634927333438,0.9984494578640175,134929,63,45373,217
10,5,SAFARI,Single-stranded,125,0.45,134929,217,134929,0,9,45246,53,128,0.9995407101214155,0.9983943290959407,0.9986354432608504,0.9989671907217449,0.9984549955145031,134929,62,45374,217
10,5,vg giraffe,Single-stranded,125,0.4,119584,191,119584,0,9,40033,50,107,0.9995068662604581,0.9984053433521185,0.9985323017985522,0.9989558011511248,0.9984372460524835,119584,59,40140,191
10,5,SAFARI,Single-stranded,125,0.4,119584,191,119584,0,9,40033,49,108,0.9995152204075491,0.9984053433521185,0.9985571780392547,0.9989599736025429,0.9984434970682736,119584,58,40141,191
10,5,vg giraffe,Single-stranded,125,0.55,164947,258,164947,0,9,55330,65,149,0.9995515722241411,0.998438303925426,0.9986679387251813,0.9989946279214841,0.9984960907418984,164947,74,55479,258
10,5,SAFARI,Single-stranded,125,0.55,164947,258,164947,0,9,55330,64,150,0.9995576293782572,0.998438303925426,0.9986859395532195,0.9989976531153001,0.9985006205890613,164947,73,55480,258
10,5,vg giraffe,Single-stranded,125,0.5,150022,239,150022,0,9,50372,60,139,0.9995402788974689,0.9984094342510698,0.9986358244365362,0.9989745365437886,0.9984664485837055,150022,69,50511,239
10,5,SAFARI,Single-stranded,125,0.5,150022,239,150022,0,9,50372,59,140,0.9995469385035646,0.9984094342510698,0.9986555950968762,0.9989778625674628,0.9984714276467455,150022,68,50512,239
10,5,vg giraffe,Single-stranded,125,0.65,195131,300,195131,0,10,65453,81,186,0.9995338640112282,0.9984649313568472,0.998615548455804,0.9989991117436703,0.998502839244757,195131,91,65639,300
10,5,SAFARI,Single-stranded,125,0.65,195131,300,195131,0,10,65453,80,187,0.9995389840232352,0.9984649313568472,0.998630762209037,0.9990016690046384,0.998506668300397,195131,90,65640,300
10,5,vg giraffe,Single-stranded,125,0.6,180033,276,180033,0,9,60350,75,169,0.9995336364696281,0.9984692943779845,0.9986139300034652,0.9990011819347107,0.9985056784219964,180033,84,60519,276
10,5,SAFARI,Single-stranded,125,0.6,180033,276,180033,0,9,60350,74,170,0.9995391858580026,0.9984692943779845,0.9986304308367573,0.9990039536658113,0.9985098293152687,180033,83,60520,276
10,5,vg giraffe,Single-stranded,125,0.75,224919,357,224919,0,13,75401,92,217,0.9995333831058021,0.9984152772598945,0.9986133671407631,0.9989740173217855,0.9984651111797713,224919,105,75618,357
10,5,SAFARI,Single-stranded,125,0.75,224919,357,224919,0,13,75401,91,218,0.999537825022331,0.9984152772598945,0.9986265731679939,0.9989762357899973,0.9984684334499451,224919,104,75619,357
10,5,vg giraffe,Single-stranded,125,0.7,210098,335,210098,0,10,70480,86,207,0.9995432790660057,0.9984080443656651,0.9986437421414747,0.9989753391960098,0.9984673702776513,210098,96,70687,335
10,5,SAFARI,Single-stranded,125,0.7,210098,335,210098,0,10,70480,85,208,0.9995480344255042,0.9984080443656651,0.9986578698275009,0.9989777141688816,0.998470926263086,210098,95,70688,335
10,5,vg giraffe,Single-stranded,125,0.85,254891,407,254891,0,14,85278,104,243,0.9995372712335643,0.9984057846124921,0.9986221230981212,0.9989712075280174,0.9984601260643462,254891,118,85521,407
10,5,SAFARI,Single-stranded,125,0.85,254891,407,254891,0,14,85278,103,244,0.9995411908646004,0.9984057846124921,0.9986338000210184,0.9989731651205355,0.998463059157557,254891,117,85522,407
10,5,vg giraffe,Single-stranded,125,0.8,239768,383,239768,0,14,80286,100,230,0.9995247663434522,0.998405170080491,0.9985861341932283,0.9989646545133354,0.9984506563668047,239768,114,80516,383
10,5,SAFARI,Single-stranded,125,0.8,239768,383,239768,0,14,80286,99,231,0.9995289330959934,0.998405170080491,0.9985985365248666,0.9989667355509633,0.9984537737584208,239768,113,80517,383
10,5,vg giraffe,Single-stranded,125,0.95,284720,457,284720,0,16,95203,110,277,0.9995576557157201,0.9983974864733131,0.9986820910821497,0.9989772342519512,0.9984689442543391,284720,126,95480,457
10,5,SAFARI,Single-stranded,125,0.95,284720,457,284720,0,16,95203,109,278,0.999561164844038,0.9983974864733131,0.9986925506767358,0.998978986775949,0.9984715704219989,284720,125,95481,457
10,5,vg giraffe,Single-stranded,125,0.9,269747,429,269747,0,14,90225,106,258,0.999555336517618,0.9984121461565794,0.9986755405450151,0.9989834142836774,0.9984782928052908,269747,120,90483,429
10,5,SAFARI,Single-stranded,125,0.9,269747,429,269747,0,14,90225,105,259,0.9995590404126492,0.9984121461565794,0.99868657770714,0.9989852641090877,0.9984810645852447,269747,119,90484,429
10,8,vg giraffe,High,125,0.15,44486,74,44486,336,0,14956,17,41,0.9996180032806777,0.990867783321454,0.9988677234581058,0.9952236602199129,0.9928726422967785,44486,17,14997,410
10,8,SAFARI,High,125,0.15,44517,74,44517,305,0,14956,17,41,0.999618269187587,0.991558267997149,0.9988677234581058,0.9955719557195571,0.9933900851276916,44517,17,14997,379
10,8,vg giraffe,High,125,0.1,29661,48,29661,214,0,10014,11,26,0.999629280129415,0.9912441934298032,0.9989055815341757,0.995419078781777,0.993170560864562,29661,11,10040,262
10,8,SAFARI,High,125,0.1,29681,48,29681,194,0,10014,11,26,0.9996295298396874,0.9919125756107342,0.9989055815341757,0.9957561016522687,0.9936708860759493,29681,11,10040,242
10,8,vg giraffe,High,125,0.25,74182,130,74182,568,1,24985,35,79,0.9995149424667871,0.9906784188034188,0.9985657370517929,0.9950770634079599,0.9926585317063412,74182,36,25064,698
10,8,SAFARI,High,125,0.25,74241,129,74241,510,1,24985,35,79,0.9995153277596026,0.9914663461538461,0.9985657370517929,0.9954745670669161,0.993248649729946,74241,36,25064,639
10,8,vg giraffe,High,125,0.2,59338,95,59338,467,0,19910,26,56,0.9995620241223637,0.9906176961602671,0.9986994797919168,0.9950697612020392,0.9926400640865168,59338,26,19966,562
10,8,SAFARI,High,125,0.2,59386,95,59386,419,0,19910,26,56,0.9995623779707803,0.9914190317195326,0.9986994797919168,0.995474051227035,0.9932408751814951,59386,26,19966,514
10,8,vg giraffe,High,125,0.35,103804,182,103804,800,3,35007,39,110,0.9995955549563778,0.9906285190769759,0.9988054267755055,0.9950918363434181,0.9926828396870199,103804,42,35117,982
10,8,SAFARI,High,125,0.35,103878,182,103878,726,4,35006,39,110,0.9995862241510378,0.9913347202870613,0.9987769845558747,0.9954433727666058,0.9932044731858944,103878,43,35116,908
10,8,vg giraffe,High,125,0.3,88816,150,88816,690,1,29884,38,97,0.9995610826627652,0.9906308557151781,0.9987008660892738,0.9950759336959628,0.9926551689561817,88816,39,29981,840
10,8,SAFARI,High,125,0.3,88880,150,88880,626,1,29884,38,97,0.9995613985762323,0.9913446952797359,0.9987008660892738,0.9954360912781743,0.993189946188041,88880,39,29981,776
10,8,vg giraffe,High,125,0.45,133847,229,133847,1069,4,45251,45,150,0.9996340443329151,0.9903955011284177,0.9989218921892189,0.9949933281544449,0.9925413217420195,133847,49,45401,1298
10,8,SAFARI,High,125,0.45,133946,229,133946,970,5,45250,45,150,0.9996268545329712,0.9911280476525214,0.9988998899889989,0.9953593098041549,0.9930839724244858,133946,50,45400,1199
10,8,vg giraffe,High,125,0.4,118634,200,118634,939,4,40038,42,125,0.9996124031007751,0.9904903442345103,0.9988559775174712,0.9950304672199554,0.9925929167031291,118634,46,40163,1139
10,8,SAFARI,High,125,0.4,118721,200,118721,852,5,40037,42,125,0.9996042705105752,0.9912167182921026,0.9988311074635032,0.9953928255520015,0.9931304771786826,118721,47,40162,1052
10,8,vg giraffe,High,125,0.55,163626,276,163626,1302,5,55333,51,175,0.9996578731931428,0.9904481731677199,0.9989921531927147,0.995031713116399,0.9925985650094217,163626,56,55508,1578
10,8,SAFARI,High,125,0.55,163748,276,163748,1180,6,55332,51,175,0.9996520252739538,0.9911866540761725,0.9989741559282989,0.995401341604637,0.9931466516886506,163748,57,55507,1456
10,8,vg giraffe,High,125,0.5,148821,249,148821,1192,5,50376,49,159,0.9996372795969773,0.9904100837204349,0.99893257427504,0.9950022899206717,0.9925566713633489,148821,54,50535,1441
10,8,SAFARI,High,125,0.5,148938,249,148938,1075,6,50375,49,159,0.9996308551408456,0.9911887236959445,0.9989128071319852,0.9953918898598185,0.9931342139197714,148938,55,50534,1324
10,8,vg giraffe,High,125,0.65,193567,325,193567,1529,5,65457,62,209,0.9996539863866883,0.9905127903347133,0.9989807250543867,0.995062394777088,0.9926441869548236,193567,67,65666,1854
10,8,SAFARI,High,125,0.65,193709,325,193709,1387,6,65456,62,209,0.9996490811603028,0.9912394266736942,0.9989655119954969,0.9954264924280186,0.993184098271518,193709,68,65665,1712
10,8,vg giraffe,High,125,0.6,178585,302,178585,1419,5,60353,56,193,0.9996585425926133,0.9904551151930607,0.9989935156005082,0.995035547928414,0.9926031388924632,178585,61,60546,1721
10,8,SAFARI,High,125,0.6,178714,302,178714,1290,6,60352,56,193,0.9996531972971764,0.9911705655940457,0.9989770158562542,0.9953938097704703,0.993134451025889,178714,62,60545,1592
10,8,vg giraffe,High,125,0.75,223119,374,223119,1767,6,75407,67,240,0.9996729273450662,0.9904954275059931,0.9990359218172213,0.9950630167777152,0.9926440295036215,223119,73,75647,2141
10,8,SAFARI,High,125,0.75,223283,374,223283,1603,7,75406,67,240,0.9996686918251947,0.9912234750954453,0.9990227152667723,0.9954281714692041,0.993185593727158,223283,74,75646,1977
10,8,vg giraffe,High,125,0.7,208402,352,208402,1663,6,70483,65,230,0.9996594283192548,0.990423777546491,0.9989969484629295,0.9950201723602855,0.99258181869908,208402,71,70713,2015
10,8,SAFARI,High,125,0.7,208558,352,208558,1507,7,70482,65,230,0.9996548914345972,0.9911651625106337,0.9989828209764918,0.9953919250107984,0.9931330258427246,208558,72,70712,1859
10,8,vg giraffe,High,125,0.85,252850,429,252850,2004,6,85281,77,267,0.9996718498574722,0.990469400625972,0.9990307248543168,0.9950493490956601,0.992619839607643,252850,83,85548,2433
10,8,SAFARI,High,125,0.85,253041,429,253041,1813,7,85280,77,267,0.9996681481481482,0.9912175898904353,0.9990190468405133,0.9954249343047316,0.9931771649154919,253041,84,85547,2242
10,8,vg giraffe,High,125,0.8,237845,398,237845,1892,6,80291,74,256,0.9996637595881055,0.9904636975034876,0.9990077765512794,0.9950424632891268,0.9926113442365367,237845,80,80547,2290
10,8,SAFARI,High,125,0.8,238021,398,238021,1716,7,80290,74,256,0.9996598096614057,0.9911966185687218,0.9989953737581704,0.9954102254739805,0.9931569200840499,238021,81,80546,2114
10,8,vg giraffe,High,125,0.95,282464,472,282464,2228,6,95209,83,296,0.9996850148467721,0.9905317641778064,0.9990689792246376,0.9950873410519677,0.9926751374889037,282464,89,95505,2700
10,8,SAFARI,High,125,0.95,282675,472,282675,2017,8,95207,83,296,0.9996781791304471,0.9912716892735408,0.9990480574094609,0.9954571866251122,0.9932240425677202,282675,91,95503,2489
10,8,vg giraffe,High,125,0.9,267589,455,267589,2119,6,90229,79,281,0.9996824495468368,0.9904724185029038,0.9990617583751863,0.9950561229517494,0.9926294080796545,267589,85,90510,2574
10,8,SAFARI,High,125,0.9,267792,455,267792,1916,7,90228,79,281,0.9996789583317779,0.9912238167328613,0.9990507202384238,0.9954334335115724,0.9931893402225315,267792,86,90509,2371
10,8,vg giraffe,Mid,125,0.15,44835,61,44835,2,2,14954,23,37,0.9994427106553723,0.9985968194574368,0.9983351092168353,0.9990195859979054,0.9985312280936008,44835,25,14991,63
10,8,SAFARI,Mid,125,0.15,44835,61,44835,2,2,14954,23,37,0.9994427106553723,0.9985968194574368,0.9983351092168353,0.9990195859979054,0.9985312280936008,44835,25,14991,63
10,8,vg giraffe,Mid,125,0.1,29880,44,29880,1,0,10014,17,19,0.9994313810750243,0.9984962406015038,0.9983084577114428,0.9989635919895691,0.9984490306441526,29880,17,10033,45
10,8,SAFARI,Mid,125,0.1,29880,44,29880,1,0,10014,17,19,0.9994313810750243,0.9984962406015038,0.9983084577114428,0.9989635919895691,0.9984490306441526,29880,17,10033,45
10,8,vg giraffe,Mid,125,0.25,74773,105,74773,3,4,24982,43,68,0.9993718257150495,0.9985577115690228,0.9981272662071163,0.9989646027748644,0.9984496589249635,74773,47,25050,108
10,8,SAFARI,Mid,125,0.25,74773,105,74773,3,4,24982,43,68,0.9993718257150495,0.9985577115690228,0.9981272662071163,0.9989646027748644,0.9984496589249635,74773,47,25050,108
10,8,vg giraffe,Mid,125,0.2,59816,82,59816,3,2,19908,32,48,0.9994319131161237,0.998580991970084,0.9982991495747874,0.9990062713463771,0.9985104705160781,59816,34,19956,85
10,8,SAFARI,Mid,125,0.2,59816,82,59816,3,2,19908,32,48,0.9994319131161237,0.998580991970084,0.9982991495747874,0.9990062713463771,0.9985104705160781,59816,34,19956,85
10,8,vg giraffe,Mid,125,0.35,104623,160,104623,4,5,35005,47,92,0.9995032242655839,0.9984349203622587,0.9985205838003927,0.9989687867011677,0.9984564372284472,104623,52,35097,164
10,8,SAFARI,Mid,125,0.35,104623,160,104623,4,5,35005,47,92,0.9995032242655839,0.9984349203622587,0.9985205838003927,0.9989687867011677,0.9984564372284472,104623,52,35097,164
10,8,vg giraffe,Mid,125,0.3,89519,135,89519,3,4,29881,46,83,0.9994417711485001,0.9984608006067569,0.9983341107483175,0.9989510450492675,0.9984290262469604,89519,50,29964,138
10,8,SAFARI,Mid,125,0.3,89519,135,89519,3,4,29881,46,83,0.9994417711485001,0.9984608006067569,0.9983341107483175,0.9989510450492675,0.9984290262469604,89519,50,29964,138
10,8,vg giraffe,Mid,125,0.45,134928,210,134928,6,6,45251,56,128,0.9995407067190162,0.9984017048481619,0.9986355934068353,0.9989708811182597,0.9984605587396517,134928,62,45379,216
10,8,SAFARI,Mid,125,0.45,134928,210,134928,6,6,45251,56,128,0.9995407067190162,0.9984017048481619,0.9986355934068353,0.9989708811182597,0.9984605587396517,134928,62,45379,216
10,8,vg giraffe,Mid,125,0.4,119587,180,119587,6,6,40036,51,107,0.9995235866403664,0.9984470623596303,0.9985820895522388,0.99898503447959,0.9984809936676814,119587,57,40143,186
10,8,SAFARI,Mid,125,0.4,119587,180,119587,6,6,40036,51,107,0.9995235866403664,0.9984470623596303,0.9985820895522388,0.99898503447959,0.9984809936676814,119587,57,40143,186
10,8,vg giraffe,Mid,125,0.55,164942,255,164942,7,6,55334,64,155,0.9995757884275083,0.9984140819834871,0.9987400781151569,0.9989945974755918,0.9984961248035223,164942,70,55489,262
10,8,SAFARI,Mid,125,0.55,164942,255,164942,7,6,55334,64,155,0.9995757884275083,0.9984140819834871,0.9987400781151569,0.9989945974755918,0.9984961248035223,164942,70,55489,262
10,8,vg giraffe,Mid,125,0.5,150019,235,150019,6,6,50377,61,138,0.9995535892754821,0.998396113403434,0.9986754181329327,0.9989745160581464,0.9984664562193166,150019,67,50515,241
10,8,SAFARI,Mid,125,0.5,150019,235,150019,6,6,50377,61,138,0.9995535892754821,0.998396113403434,0.9986754181329327,0.9989745160581464,0.9984664562193166,150019,67,50515,241
10,8,vg giraffe,Mid,125,0.65,195112,306,195112,7,8,65454,77,194,0.9995645424878457,0.9983983625431752,0.9987068899943712,0.9989811121749416,0.9984760183490454,195112,85,65648,313
10,8,SAFARI,Mid,125,0.65,195112,306,195112,7,8,65454,77,194,0.9995645424878457,0.9983983625431752,0.9987068899943712,0.9989811121749416,0.9984760183490454,195112,85,65648,313
10,8,vg giraffe,Mid,125,0.6,180023,278,180023,7,7,60353,71,174,0.9995669096784582,0.9984193712980012,0.9987129774771059,0.9989928109453426,0.9984932319966129,180023,78,60527,285
10,8,SAFARI,Mid,125,0.6,180023,278,180023,7,7,60353,71,174,0.9995669096784582,0.9984193712980012,0.9987129774771059,0.9989928109453426,0.9984932319966129,180023,78,60527,285
10,8,vg giraffe,Mid,125,0.75,224909,348,224909,9,8,75405,84,224,0.999591112928387,0.9984152069109409,0.9987850134044717,0.9990028138859832,0.9985082412197205,224909,92,75629,357
10,8,SAFARI,Mid,125,0.75,224908,348,224908,10,8,75405,84,224,0.9995911111111111,0.9984107677146129,0.9987850134044717,0.9990005907619052,0.9985049188170918,224908,92,75629,358
10,8,vg giraffe,Mid,125,0.7,210087,328,210087,8,8,70481,80,216,0.9995813012965385,0.9984032163784378,0.9987567987567988,0.9989919115164598,0.998492219282524,210087,88,70697,336
10,8,SAFARI,Mid,125,0.7,210086,328,210086,9,8,70481,80,216,0.9995812993043859,0.9983984640462307,0.9987567987567988,0.9989895315468252,0.9984886631959261,210086,88,70697,337
10,8,vg giraffe,Mid,125,0.85,254869,410,254869,10,10,85277,92,254,0.9995999545046299,0.9983548057299766,0.9988088704121075,0.9989769921216635,0.9984688579792446,254869,102,85531,420
10,8,SAFARI,Mid,125,0.85,254868,410,254868,11,10,85277,92,254,0.9995999529356395,0.9983508886007623,0.9988088704121075,0.9989750303277356,0.9984659247569825,254868,102,85531,421
10,8,vg giraffe,Mid,125,0.8,239748,384,239748,9,9,80288,90,238,0.9995872368635005,0.9983634614663885,0.9987720930232559,0.9989749743743594,0.9984661716017283,239748,99,80526,393
10,8,SAFARI,Mid,125,0.8,239747,384,239747,10,9,80288,90,238,0.9995872351425498,0.9983592972462012,0.9987720930232559,0.998972888849073,0.9984630540643336,239747,99,80526,394
10,8,vg giraffe,Mid,125,0.95,284705,454,284705,10,10,95203,99,283,0.9996172940936893,0.9983728946694767,0.99885977300068,0.9989947068596783,0.9984951308422014,284705,109,95486,464
10,8,SAFARI,Mid,125,0.95,284704,454,284704,11,10,95203,99,283,0.9996172927499798,0.9983693879769541,0.99885977300068,0.998992950654582,0.9984925045434968,284704,109,95486,465
10,8,vg giraffe,Mid,125,0.9,269730,428,269730,10,10,90225,94,268,0.999614577851568,0.998378786532824,0.9988520591189554,0.9989963000137037,0.9984976369658919,269730,104,90493,438
10,8,SAFARI,Mid,125,0.9,269729,428,269729,11,10,90225,94,268,0.9996145764231951,0.9983750851322141,0.9988520591189554,0.998994446306581,0.9984948650783751,269729,104,90493,439
10,8,vg giraffe,None,125,0.15,44827,73,44827,0,1,14957,18,40,0.9995763278776256,0.9983741648106904,0.9987346830047948,0.9989748846745259,0.9984645169904534,44827,19,14997,73
10,8,SAFARI,None,125,0.15,44827,73,44827,0,1,14957,18,40,0.9995763278776256,0.9983741648106904,0.9987346830047948,0.9989748846745259,0.9984645169904534,44827,19,14997,73
10,8,vg giraffe,None,125,0.1,29878,47,29878,0,0,10014,11,26,0.9996319716283583,0.9984294068504594,0.9989055815341757,0.9990303273481125,0.9985491294776866,29878,11,10040,47
10,8,SAFARI,None,125,0.1,29878,47,29878,0,0,10014,11,26,0.9996319716283583,0.9984294068504594,0.9989055815341757,0.9990303273481125,0.9985491294776866,29878,11,10040,47
10,8,vg giraffe,None,125,0.25,74769,114,74769,0,1,24987,38,76,0.9994786653833815,0.9984776250951485,0.9984463389371365,0.9989778944625929,0.9984697704655698,74769,39,25063,114
10,8,SAFARI,None,125,0.25,74769,114,74769,0,1,24987,38,76,0.9994786653833815,0.9984776250951485,0.9984463389371365,0.9989778944625929,0.9984697704655698,74769,39,25063,114
10,8,vg giraffe,None,125,0.2,59811,92,59811,0,1,19911,27,55,0.9995320777419409,0.9984641837637513,0.9985995798739622,0.9989978453675401,0.9984980662603101,59811,28,19966,92
10,8,SAFARI,None,125,0.2,59811,92,59811,0,1,19911,27,55,0.9995320777419409,0.9984641837637513,0.9985995798739622,0.9989978453675401,0.9984980662603101,59811,28,19966,92
10,8,vg giraffe,None,125,0.35,104628,158,104628,0,1,35011,44,105,0.9995700897079476,0.9984921649838719,0.998720172918859,0.9990308365837706,0.9985494508635412,104628,45,35116,158
10,8,SAFARI,None,125,0.35,104628,158,104628,0,1,35011,44,105,0.9995700897079476,0.9984921649838719,0.998720172918859,0.9990308365837706,0.9985494508635412,104628,45,35116,158
10,8,vg giraffe,None,125,0.3,89521,136,89521,0,1,29886,43,92,0.9995087366716909,0.9984831078443401,0.9985344081007261,0.9989956590150761,0.9984959767377736,89521,44,29978,136
10,8,SAFARI,None,125,0.3,89521,136,89521,0,1,29886,43,92,0.9995087366716909,0.9984831078443401,0.9985344081007261,0.9989956590150761,0.9984959767377736,89521,44,29978,136
10,8,vg giraffe,None,125,0.45,134935,208,134935,0,4,45253,52,143,0.9995851575290204,0.9984608895762267,0.9987679310041362,0.9990227072489949,0.9985381655084582,134935,56,45396,208
10,8,SAFARI,None,125,0.45,134935,208,134935,0,4,45253,52,143,0.9995851575290204,0.9984608895762267,0.9987679310041362,0.9990227072489949,0.9985381655084582,134935,56,45396,208
10,8,vg giraffe,None,125,0.4,119590,182,119590,0,3,40041,48,119,0.9995737247264733,0.9984804461810773,0.9987316903334909,0.9990267863482769,0.9985435952569961,119590,51,40160,182
10,8,SAFARI,None,125,0.4,119590,182,119590,0,3,40041,48,119,0.9995737247264733,0.9984804461810773,0.9987316903334909,0.9990267863482769,0.9985435952569961,119590,51,40160,182
10,8,vg giraffe,None,125,0.55,164947,256,164947,0,6,55334,62,164,0.9995879162500378,0.9984503913367191,0.998776230068747,0.9990188299850402,0.9985324026471107,164947,68,55498,256
10,8,SAFARI,None,125,0.55,164947,256,164947,0,6,55334,62,164,0.9995879162500378,0.9984503913367191,0.998776230068747,0.9990188299850402,0.9985324026471107,164947,68,55498,256
10,8,vg giraffe,None,125,0.5,150025,234,150025,0,5,50378,58,150,0.9995802462555301,0.9984426889570674,0.9987547192188334,0.9990111437770312,0.998521284540702,150025,63,50528,234
10,8,SAFARI,None,125,0.5,150025,234,150025,0,5,50378,58,150,0.9995802462555301,0.9984426889570674,0.9987547192188334,0.9990111437770312,0.998521284540702,150025,63,50528,234
10,8,vg giraffe,None,125,0.65,195117,310,195117,0,6,65458,73,198,0.9995952785917744,0.9984137299349629,0.9987982049136686,0.9990041549012731,0.9985105030594037,195117,79,65656,310
10,8,SAFARI,None,125,0.65,195117,310,195117,0,6,65458,73,198,0.9995952785917744,0.9984137299349629,0.9987982049136686,0.9990041549012731,0.9985105030594037,195117,79,65656,310
10,8,vg giraffe,None,125,0.6,180021,286,180021,0,6,60354,67,182,0.9995946561240241,0.998413816435302,0.9987955584154169,0.9990038873366055,0.9985098540570158,180021,73,60536,286
10,8,SAFARI,None,125,0.6,180021,286,180021,0,6,60354,67,182,0.9995946561240241,0.998413816435302,0.9987955584154169,0.9990038873366055,0.9985098540570158,180021,73,60536,286
10,8,vg giraffe,None,125,0.75,224915,357,224915,0,6,75409,80,227,0.9996177794765356,0.9984152491210625,0.9988642666596234,0.9990161524230855,0.9985282098646485,224915,86,75636,357
10,8,SAFARI,None,125,0.75,224915,357,224915,0,6,75409,80,227,0.9996177794765356,0.9984152491210625,0.9988642666596234,0.9990161524230855,0.9985282098646485,224915,86,75636,357
10,8,vg giraffe,None,125,0.7,210099,330,210099,0,6,70485,77,218,0.9996051041478338,0.9984317750880345,0.998827451755997,0.9990180951045027,0.9985313727930587,210099,83,70703,330
10,8,SAFARI,None,125,0.7,210099,330,210099,0,6,70485,77,218,0.9996051041478338,0.9984317750880345,0.998827451755997,0.9990180951045027,0.9985313727930587,210099,83,70703,330
10,8,vg giraffe,None,125,0.85,254885,410,254885,0,7,85284,94,250,0.999603899821951,0.9983940147672301,0.9988205756991884,0.9989985909724249,0.9985011585956062,254885,101,85534,410
10,8,SAFARI,None,125,0.85,254885,410,254885,0,7,85284,94,250,0.999603899821951,0.9983940147672301,0.9988205756991884,0.9989985909724249,0.9985011585956062,254885,101,85534,410
10,8,vg giraffe,None,125,0.8,239763,384,239763,0,6,80293,89,241,0.9996039323266266,0.9984009794001174,0.9988217638814818,0.9990020937281904,0.998506746140609,239763,95,80534,384
10,8,SAFARI,None,125,0.8,239763,384,239763,0,6,80293,89,241,0.9996039323266266,0.9984009794001174,0.9988217638814818,0.9990020937281904,0.998506746140609,239763,95,80534,384
10,8,vg giraffe,None,125,0.95,284713,461,284713,0,7,95211,102,277,0.9996173048430248,0.9983834430908849,0.9988597968555498,0.9989999929824069,0.9985030372586148,284713,109,95488,461
10,8,SAFARI,None,125,0.95,284713,461,284713,0,7,95211,102,277,0.9996173048430248,0.9983834430908849,0.9988597968555498,0.9989999929824069,0.9985030372586148,284713,109,95488,461
10,8,vg giraffe,None,125,0.9,269733,440,269733,0,7,90231,97,263,0.9996145821366232,0.9983714138718525,0.9988520717896643,0.9989926112479399,0.9984921182689296,269733,104,90494,440
10,8,SAFARI,None,125,0.9,269733,440,269733,0,7,90231,97,263,0.9996145821366232,0.9983714138718525,0.9988520717896643,0.9989926112479399,0.9984921182689296,269733,104,90494,440
10,8,vg giraffe,Single-stranded,125,0.15,44833,67,44833,0,1,14957,20,37,0.9995318143309404,0.9985077951002227,0.9986013986013986,0.9990195423045212,0.9985312526078611,44833,21,14994,67
10,8,SAFARI,Single-stranded,125,0.15,44833,67,44833,0,1,14957,20,37,0.9995318143309404,0.9985077951002227,0.9986013986013986,0.9990195423045212,0.9985312526078611,44833,21,14994,67
10,8,vg giraffe,Single-stranded,125,0.1,29883,42,29883,0,1,10013,12,18,0.9995651592186245,0.9985964912280701,0.998705694942254,0.9990805904281105,0.9986239335485001,29883,13,10031,42
10,8,SAFARI,Single-stranded,125,0.1,29883,42,29883,0,1,10013,12,18,0.9995651592186245,0.9985964912280701,0.998705694942254,0.9990805904281105,0.9986239335485001,29883,13,10031,42
10,8,vg giraffe,Single-stranded,125,0.25,74761,121,74761,0,1,24986,37,73,0.999491971817805,0.9983841243556529,0.9984858748057537,0.9989377409290425,0.9984096660298662,74761,38,25059,121
10,8,SAFARI,Single-stranded,125,0.25,74761,121,74761,0,1,24986,37,73,0.999491971817805,0.9983841243556529,0.9984858748057537,0.9989377409290425,0.9984096660298662,74761,38,25059,121
10,8,vg giraffe,Single-stranded,125,0.2,59804,99,59804,0,1,19910,27,49,0.9995320229977269,0.9983473281805586,0.9985990894081153,0.9989393243412535,0.9984103141820002,59804,28,19959,99
10,8,SAFARI,Single-stranded,125,0.2,59804,99,59804,0,1,19910,27,49,0.9995320229977269,0.9983473281805586,0.9985990894081153,0.9989393243412535,0.9984103141820002,59804,28,19959,99
10,8,vg giraffe,Single-stranded,125,0.35,104621,164,104621,0,3,35007,43,95,0.9995605109537867,0.9984348904900511,0.9986912484351883,0.9989973836487597,0.9984992817991467,104621,46,35102,164
10,8,SAFARI,Single-stranded,125,0.35,104621,164,104621,0,3,35007,43,95,0.9995605109537867,0.9984348904900511,0.9986912484351883,0.9989973836487597,0.9984992817991467,104621,46,35102,164
10,8,vg giraffe,Single-stranded,125,0.3,89516,140,89516,0,2,29883,42,84,0.9995087092451987,0.9984384759525297,0.9985338709139983,0.9989733059548254,0.9984623998261843,89516,44,29967,140
10,8,SAFARI,Single-stranded,125,0.3,89516,140,89516,0,2,29883,42,84,0.9995087092451987,0.9984384759525297,0.9985338709139983,0.9989733059548254,0.9984623998261843,89516,44,29967,140
10,8,vg giraffe,Single-stranded,125,0.45,134929,217,134929,0,5,45250,50,131,0.9995925443015469,0.9983943290959407,0.9987895061184964,0.9989930774071742,0.9984937590679027,134929,55,45381,217
10,8,SAFARI,Single-stranded,125,0.45,134929,217,134929,0,5,45250,50,131,0.9995925443015469,0.9983943290959407,0.9987895061184964,0.9989930774071742,0.9984937590679027,134929,55,45381,217
10,8,vg giraffe,Single-stranded,125,0.4,119584,191,119584,0,5,40037,46,111,0.9995737033476826,0.9984053433521185,0.9987313117241723,0.9989891817384404,0.998487254178804,119584,51,40148,191
10,8,SAFARI,Single-stranded,125,0.4,119584,191,119584,0,5,40037,46,111,0.9995737033476826,0.9984053433521185,0.9987313117241723,0.9989891817384404,0.998487254178804,119584,51,40148,191
10,8,vg giraffe,Single-stranded,125,0.55,164947,258,164947,0,5,55334,61,153,0.9996000315126687,0.998438303925426,0.998811945349486,0.9990188299850401,0.998532329519202,164947,66,55487,258
10,8,SAFARI,Single-stranded,125,0.55,164947,258,164947,0,5,55334,61,153,0.9996000315126687,0.998438303925426,0.998811945349486,0.9990188299850401,0.998532329519202,164947,66,55487,258
10,8,vg giraffe,Single-stranded,125,0.5,150022,239,150022,0,5,50376,56,143,0.9995935582311121,0.9984094342510698,0.9987939897192566,0.9990011453533282,0.9985062810880249,150022,61,50519,239
10,8,SAFARI,Single-stranded,125,0.5,150022,239,150022,0,5,50376,56,143,0.9995935582311121,0.9984094342510698,0.9987939897192566,0.9990011453533282,0.9985062810880249,150022,61,50519,239
10,8,vg giraffe,Single-stranded,125,0.65,195131,300,195131,0,5,65458,76,191,0.999585066491814,0.9984649313568472,0.9987676859881333,0.9990246849425178,0.9985411298011572,195131,81,65649,300
10,8,SAFARI,Single-stranded,125,0.65,195131,300,195131,0,5,65458,76,191,0.999585066491814,0.9984649313568472,0.9987676859881333,0.9990246849425178,0.9985411298011572,195131,81,65649,300
10,8,vg giraffe,Single-stranded,125,0.6,180033,276,180033,0,5,60354,70,174,0.9995835831834233,0.9984692943779845,0.9987624375030939,0.9990261280683208,0.9985430364614465,180033,75,60528,276
10,8,SAFARI,Single-stranded,125,0.6,180033,276,180033,0,5,60354,70,174,0.9995835831834233,0.9984692943779845,0.9987624375030939,0.9990261280683208,0.9985430364614465,180033,75,60528,276
10,8,vg giraffe,Single-stranded,125,0.75,224919,357,224919,0,7,75407,87,222,0.9995822463590992,0.9984152772598945,0.9987586334403021,0.9989984210140599,0.9985016561516815,224919,94,75629,357
10,8,SAFARI,Single-stranded,125,0.75,224919,357,224919,0,7,75407,87,222,0.9995822463590992,0.9984152772598945,0.9987586334403021,0.9989984210140599,0.9985016561516815,224919,94,75629,357
10,8,vg giraffe,Single-stranded,125,0.7,210098,335,210098,0,5,70485,81,212,0.9995908346972177,0.9984080443656651,0.9987850190017377,0.9989990894329044,0.9985029301319982,210098,86,70697,335
10,8,SAFARI,Single-stranded,125,0.7,210098,335,210098,0,5,70485,81,212,0.9995908346972177,0.9984080443656651,0.9987850190017377,0.9989990894329044,0.9985029301319982,210098,86,70697,335
10,8,vg giraffe,Single-stranded,125,0.85,254891,407,254891,0,7,85285,98,249,0.9995882288349621,0.9984057846124921,0.9987739230957858,0.9989966568292006,0.9984982562760862,254891,105,85534,407
10,8,SAFARI,Single-stranded,125,0.85,254891,407,254891,0,7,85285,98,249,0.9995882288349621,0.9984057846124921,0.9987739230957858,0.9989966568292006,0.9984982562760862,254891,105,85534,407
10,8,vg giraffe,Single-stranded,125,0.8,239768,383,239768,0,7,80293,94,236,0.9995789368363565,0.998405170080491,0.9987473645045268,0.998991708678805,0.9984911824578139,239768,101,80529,383
10,8,SAFARI,Single-stranded,125,0.8,239768,383,239768,0,7,80293,94,236,0.9995789368363565,0.998405170080491,0.9987473645045268,0.998991708678805,0.9984911824578139,239768,101,80529,383
10,8,vg giraffe,Single-stranded,125,0.95,284720,457,284720,0,8,95211,103,284,0.9996102952276964,0.9983974864733131,0.9988389850009414,0.9990035227575752,0.998508336769236,284720,111,95495,457
10,8,SAFARI,Single-stranded,125,0.95,284720,457,284720,0,8,95211,103,284,0.9996102952276964,0.9983974864733131,0.9988389850009414,0.9990035227575752,0.998508336769236,284720,111,95495,457
10,8,vg giraffe,Single-stranded,125,0.9,269747,429,269747,0,7,90232,100,264,0.999603489294211,0.9984121461565794,0.9988190236526384,0.9990074625483769,0.9985143259446919,269747,107,90496,429
10,8,SAFARI,Single-stranded,125,0.9,269747,429,269747,0,7,90232,100,264,0.999603489294211,0.9984121461565794,0.9988190236526384,0.9990074625483769,0.9985143259446919,269747,107,90496,429
11,7,vg giraffe,High,125,0.15,44396,73,44396,427,0,14956,14,44,0.9996847556856564,0.9888631503920171,0.9990675369654989,0.9942445076478624,0.9914204640293774,44396,14,15000,500
11,7,SAFARI,High,125,0.15,44443,73,44443,380,0,14956,14,44,0.9996850889623682,0.9899100142551674,0.9990675369654989,0.9947735386612648,0.9922049741278585,44443,14,15000,453
11,7,vg giraffe,High,125,0.1,29592,47,29592,284,0,10014,10,27,0.9996621849875008,0.988938274905591,0.9990050741219779,0.9942713145737084,0.9914694551458448,29592,10,10041,331
11,7,SAFARI,High,125,0.1,29624,46,29624,253,0,10014,10,27,0.9996625497739083,0.9900076863950807,0.9990050741219779,0.9948116929999833,0.9922699754840646,29624,10,10041,299
11,7,vg giraffe,High,125,0.25,74021,128,74021,731,1,24985,29,85,0.9995948738031897,0.9885283119658119,0.998804780876494,0.9940307927832353,0.9911082216443289,74021,30,25070,859
11,7,SAFARI,High,125,0.25,74111,128,74111,641,1,24985,30,84,0.9995818834129103,0.989730235042735,0.9987649402390438,0.9946316651232705,0.991998399679936,74111,31,25069,769
11,7,vg giraffe,High,125,0.2,59226,94,59226,580,0,19910,20,62,0.9996624244674746,0.9887479131886477,0.998999599839936,0.9941752136034782,0.9913132729184398,59226,20,19972,674
11,7,SAFARI,High,125,0.2,59293,94,59293,513,0,19910,21,61,0.9996459520517922,0.9898664440734558,0.9989495798319328,0.9947321623299277,0.9921393881740349,59293,21,19971,607
11,7,vg giraffe,High,125,0.35,103578,180,103578,1028,3,35007,33,116,0.9996525566043198,0.988471742408337,0.9989760800932905,0.9940307101727447,0.991110793526028,103578,36,35123,1208
11,7,SAFARI,High,125,0.35,103695,180,103695,911,3,35007,34,115,0.9996433116106891,0.9895883037810395,0.9989476378736597,0.9945903950738066,0.9919396905927329,103695,37,35122,1091
11,7,vg giraffe,High,125,0.3,88628,148,88628,880,1,29884,32,103,0.9996277957613833,0.9885339519942893,0.9989007328447701,0.9940499223293349,0.9911343962030816,88628,33,29987,1028
11,7,SAFARI,High,125,0.3,88729,148,88729,779,1,29884,33,102,0.9996169575160821,0.9896604800571072,0.9988674217188541,0.9946138023416788,0.9919699856278619,88729,34,29986,927
11,7,vg giraffe,High,125,0.45,133569,227,133569,1349,3,45252,40,155,0.9996781726192259,0.9883384512930556,0.9990539053905391,0.9939759708584336,0.9910351892355824,133569,43,45407,1576
11,7,SAFARI,High,125,0.45,133713,227,133713,1205,3,45252,41,154,0.9996710452537063,0.9894039735099338,0.999031903190319,0.9945110114465493,0.9918270162518342,133713,44,45406,1432
11,7,vg giraffe,High,125,0.4,118390,198,118390,1185,3,40039,36,131,0.9996706887671094,0.9884531572224124,0.9990300678952473,0.9940302768238722,0.9911115000437549,118390,39,40170,1383
11,7,SAFARI,High,125,0.4,118527,198,118527,1048,3,40039,37,130,0.9996626380021423,0.9895969876349427,0.9990051978412793,0.9946043467315601,0.9919615956795139,118527,40,40169,1246
11,7,vg giraffe,High,125,0.55,163283,273,163283,1648,3,55335,46,180,0.9996999975510004,0.988371952252972,0.9991181340436254,0.9940037012686584,0.9910766053051167,163283,49,55515,1921
11,7,SAFARI,High,125,0.55,163462,273,163462,1469,3,55335,47,179,0.999694212045599,0.9894554611268492,0.9991001367792096,0.9945484856228476,0.9918828815770402,163462,50,55514,1742
11,7,vg giraffe,High,125,0.5,148513,247,148513,1502,3,50378,44,164,0.9996836295099623,0.9883603306225127,0.9990709442764237,0.9939897330183185,0.9910580480057356,148513,47,50542,1749
11,7,SAFARI,High,125,0.5,148675,247,148675,1340,3,50378,45,163,0.9996772523416015,0.9894384475116796,0.9990511771333689,0.9945314982356975,0.9918596372435288,148675,48,50541,1587
11,7,vg giraffe,High,125,0.65,193131,322,193131,1968,3,65459,57,214,0.9996894265260804,0.9882817097446027,0.9990872164666149,0.9939528372772843,0.991001478055094,193131,60,65673,2290
11,7,SAFARI,High,125,0.65,193339,322,193339,1760,3,65459,58,213,0.9996845915201654,0.9893460784664903,0.9990720034077252,0.9944884664151371,0.9917941138179005,193339,61,65672,2082
11,7,vg giraffe,High,125,0.6,178205,299,178205,1802,3,60355,51,198,0.9996970699936609,0.9883475868800816,0.9991090138102859,0.993989932090416,0.9910548621286522,178205,54,60553,2101
11,7,SAFARI,High,125,0.6,178390,299,178390,1617,3,60355,52,197,0.9996917817815013,0.9893736204008741,0.999092514066032,0.9945059386594044,0.9918186233204518,178390,55,60552,1916
11,7,vg giraffe,High,125,0.75,222630,371,222630,2259,3,75410,60,247,0.9997170993250798,0.988324602681346,0.9991679873217115,0.9939882085843827,0.9910525616320022,222630,63,75657,2630
11,7,SAFARI,High,125,0.75,222865,371,222865,2024,3,75410,61,246,0.9997129130799493,0.9893678416052561,0.9991547807712625,0.994513475341876,0.9918300219283673,222865,64,75656,2395
11,7,vg giraffe,High,125,0.7,207946,349,207946,2122,3,70486,59,236,0.9997019345409792,0.9882566522666895,0.999124095840868,0.9939463464181156,0.9909922084203114,207946,62,70722,2471
11,7,SAFARI,High,125,0.7,208169,349,208169,1899,3,70486,60,235,0.9996974528410619,0.9893164525679959,0.9991099683544303,0.9944798626056672,0.9917816792970153,208169,63,70721,2248
11,7,vg giraffe,High,125,0.85,252300,426,252300,2557,4,85283,69,275,0.9997107456027388,0.9883149289220199,0.9991475049923509,0.9939801755519486,0.9910358624169145,252300,73,85558,2983
11,7,SAFARI,High,125,0.85,252564,426,252564,2293,4,85283,70,274,0.9997070907781094,0.9893490753399169,0.9991358269785475,0.9945011133621174,0.9918073179746212,252564,74,85557,2719
11,7,vg giraffe,High,125,0.8,237327,395,237327,2413,4,80293,66,264,0.9997051352797213,0.9883065775501281,0.9991318044823694,0.993973178760795,0.991027615490613,237327,70,80557,2808
11,7,SAFARI,High,125,0.8,237578,395,237578,2162,4,80293,67,263,0.9997012400641282,0.9893518229329336,0.9991194016892604,0.9944996065167523,0.9918070095584889,237578,71,80556,2557
11,7,vg giraffe,High,125,0.95,281833,468,281833,2863,5,95210,75,304,0.9997162245089797,0.9883190023986197,0.9991631273929326,0.9939849438436049,0.9910415539529045,281833,80,95514,3331
11,7,SAFARI,High,125,0.95,282127,468,282127,2569,5,95210,76,303,0.9997129776618664,0.9893499880770363,0.9991526664853443,0.9945044873557384,0.9918110715992835,282127,81,95513,3037
11,7,vg giraffe,High,125,0.9,266991,452,266991,2720,4,90231,71,289,0.9997191705421132,0.9882589399732754,0.9991721397428114,0.9939560224783099,0.9909995065944484,266991,75,90520,3172
11,7,SAFARI,High,125,0.9,267268,452,267268,2443,4,90231,72,288,0.9997157220659525,0.9892842469176016,0.9991611016060489,0.9944726301238868,0.9917645623936268,267268,76,90519,2895
11,7,vg giraffe,Mid,125,0.15,44833,61,44833,4,3,14953,20,40,0.9994872480827537,0.9985522740433872,0.9984683004794885,0.9990195423045213,0.9985312280936008,44833,23,14993,65
11,7,SAFARI,Mid,125,0.15,44833,61,44833,4,3,14953,20,40,0.9994872480827537,0.9985522740433872,0.9984683004794885,0.9990195423045213,0.9985312280936008,44833,23,14993,65
11,7,vg giraffe,Mid,125,0.1,29879,44,29879,2,0,10014,14,22,0.999531662931121,0.9984628237259816,0.9986069651741294,0.9989969574375607,0.9984990619136961,29879,14,10036,46
11,7,SAFARI,Mid,125,0.1,29879,44,29879,2,0,10014,14,22,0.999531662931121,0.9984628237259816,0.9986069651741294,0.9989969574375607,0.9984990619136961,29879,14,10036,46
11,7,vg giraffe,Mid,125,0.25,74771,105,74771,5,4,24982,40,71,0.9994118826438548,0.9985310025240047,0.9982468024066622,0.9989712483967508,0.9984596611254476,74771,44,25053,110
11,7,SAFARI,Mid,125,0.25,74771,105,74771,5,4,24982,40,71,0.9994118826438548,0.9985310025240047,0.9982468024066622,0.9989712483967508,0.9984596611254476,74771,44,25053,110
11,7,vg giraffe,Mid,125,0.2,59814,82,59814,5,3,19907,28,52,0.9994819951541483,0.9985476035458507,0.9984492246123061,0.9990145808628264,0.9985229875705649,59814,31,19959,87
11,7,SAFARI,Mid,125,0.2,59814,82,59814,5,3,19907,28,52,0.9994819951541483,0.9985476035458507,0.9984492246123061,0.9990145808628264,0.9985229875705649,59814,31,19959,87
11,7,vg giraffe,Mid,125,0.35,104621,160,104621,6,6,35004,43,96,0.9995318620426101,0.9984158340252131,0.9986059347349854,0.9989735363344266,0.9984635833523897,104621,49,35100,166
11,7,SAFARI,Mid,125,0.35,104621,160,104621,6,6,35004,43,96,0.9995318620426101,0.9984158340252131,0.9986059347349854,0.9989735363344266,0.9984635833523897,104621,49,35100,166
11,7,vg giraffe,Mid,125,0.3,89517,135,89517,5,4,29881,42,87,0.9994863950515279,0.9984384933691737,0.9984673818884521,0.9989621694007366,0.9984457387336949,89517,46,29968,140
11,7,SAFARI,Mid,125,0.3,89517,135,89517,5,4,29881,42,87,0.9994863950515279,0.9984384933691737,0.9984673818884521,0.9989621694007366,0.9984457387336949,89517,46,29968,140
11,7,vg giraffe,Mid,125,0.45,134928,210,134928,6,7,45250,52,132,0.9995629208738619,0.9984017048481619,0.998701613080698,0.9989819754119297,0.998477171415123,134928,59,45382,216
11,7,SAFARI,Mid,125,0.45,134928,210,134928,6,7,45250,52,132,0.9995629208738619,0.9984017048481619,0.998701613080698,0.9989819754119297,0.998477171415123,134928,59,45382,216
11,7,vg giraffe,Mid,125,0.4,119587,180,119587,6,7,40035,46,112,0.9995570043463724,0.9984470623596303,0.998681592039801,0.9990017250525243,0.9985059978871434,119587,53,40147,186
11,7,SAFARI,Mid,125,0.4,119587,180,119587,6,7,40035,46,112,0.9995570043463724,0.9984470623596303,0.998681592039801,0.9990017250525243,0.9985059978871434,119587,53,40147,186
11,7,vg giraffe,Mid,125,0.55,164940,255,164940,9,7,55333,60,159,0.9995939566200222,0.9984019757390862,0.9987940747673644,0.998997610618665,0.99850065454809,164940,67,55492,264
11,7,SAFARI,Mid,125,0.55,164940,255,164940,9,7,55333,60,159,0.9995939566200222,0.9984019757390862,0.9987940747673644,0.998997610618665,0.99850065454809,164940,67,55492,264
11,7,vg giraffe,Mid,125,0.5,150017,235,150017,8,7,50376,57,142,0.9995735636089845,0.9983828031412219,0.9987347277687715,0.9989778285348987,0.9984714352575657,150017,64,50518,243
11,7,SAFARI,Mid,125,0.5,150017,235,150017,8,7,50376,57,142,0.9995735636089845,0.9983828031412219,0.9987347277687715,0.9989778285348987,0.9984714352575657,150017,64,50518,243
11,7,vg giraffe,Mid,125,0.65,195109,306,195109,10,7,65455,72,199,0.9995952620038117,0.9983830113854419,0.9987981683477096,0.9989887689349816,0.998487505647922,195109,79,65654,316
11,7,SAFARI,Mid,125,0.65,195109,306,195109,10,7,65455,72,199,0.9995952620038117,0.9983830113854419,0.9987981683477096,0.9989887689349816,0.998487505647922,195109,79,65654,316
11,7,vg giraffe,Mid,125,0.6,180021,278,180021,9,7,60353,67,178,0.9995891057497432,0.9984082791667591,0.9987789786321261,0.9989983435210028,0.9985015337486977,180021,74,60531,287
11,7,SAFARI,Mid,125,0.6,180021,278,180021,9,7,60353,67,178,0.9995891057497432,0.9984082791667591,0.9987789786321261,0.9989983435210028,0.9985015337486977,180021,74,60531,287
11,7,vg giraffe,Mid,125,0.75,224906,348,224906,12,7,75406,79,229,0.9996177641871711,0.9984018893219572,0.9988642516607018,0.9990094568003234,0.9985182084276065,224906,86,75635,360
11,7,SAFARI,Mid,125,0.75,224906,348,224906,12,7,75406,79,229,0.9996177641871711,0.9984018893219572,0.9988642516607018,0.9990094568003234,0.9985182084276065,224906,86,75635,360
11,7,vg giraffe,Mid,125,0.7,210084,328,210084,11,7,70482,75,221,0.9996098322278579,0.9983889593818166,0.9988415624779261,0.9989990227989795,0.9985028875423174,210084,82,70703,339
11,7,SAFARI,Mid,125,0.7,210084,328,210084,11,7,70482,75,221,0.9996098322278579,0.9983889593818166,0.9988415624779261,0.9989990227989795,0.9985028875423174,210084,82,70703,339
11,7,vg giraffe,Mid,125,0.85,254863,410,254863,16,8,85279,86,260,0.9996313103778284,0.9983313029546905,0.9989022923405696,0.9989808837305927,0.9984747244237685,254863,94,85539,426
11,7,SAFARI,Mid,125,0.85,254863,410,254863,16,8,85279,86,260,0.9996313103778284,0.9983313029546905,0.9989022923405696,0.9989808837305927,0.9984747244237685,254863,94,85539,426
11,7,vg giraffe,Mid,125,0.8,239744,384,239744,13,8,80289,84,244,0.9996164045431044,0.9983468045856393,0.9988589147286822,0.9989812011825567,0.998475524213913,239744,92,80533,397
11,7,SAFARI,Mid,125,0.8,239744,384,239744,13,8,80289,84,244,0.9996164045431044,0.9983468045856393,0.9988589147286822,0.9989812011825567,0.998475524213913,239744,92,80533,397
11,7,vg giraffe,Mid,125,0.95,284698,454,284698,17,8,95205,93,289,0.9996453639233284,0.9983483478218179,0.9989434593859512,0.9989964348875726,0.9984977571409062,284698,101,95494,471
11,7,SAFARI,Mid,125,0.95,284698,454,284698,17,8,95205,93,289,0.9996453639233284,0.9983483478218179,0.9989434593859512,0.9989964348875726,0.9984977571409062,284698,101,95494,471
11,7,vg giraffe,Mid,125,0.9,269723,428,269723,17,8,90227,88,274,0.9996442059306424,0.9983528767285541,0.9989403622636511,0.9989981240289117,0.9985004088534087,269723,96,90501,445
11,7,SAFARI,Mid,125,0.9,269723,428,269723,17,8,90227,88,274,0.9996442059306424,0.9983528767285541,0.9989403622636511,0.9989981240289117,0.9985004088534087,269723,96,90501,445
11,7,vg giraffe,None,125,0.15,44827,73,44827,0,0,14958,14,44,0.9996877857318079,0.9983741648106904,0.9990676611614278,0.9990305434528254,0.9985479671540156,44827,14,15002,73
11,7,SAFARI,None,125,0.15,44827,73,44827,0,0,14958,14,44,0.9996877857318079,0.9983741648106904,0.9990676611614278,0.9990305434528254,0.9985479671540156,44827,14,15002,73
11,7,vg giraffe,None,125,0.1,29878,47,29878,0,0,10014,9,28,0.9996988657275738,0.9984294068504594,0.9991045667097801,0.9990637330301612,0.9985991594956974,29878,9,10042,47
11,7,SAFARI,None,125,0.1,29878,47,29878,0,0,10014,9,28,0.9996988657275738,0.9984294068504594,0.9991045667097801,0.9990637330301612,0.9985991594956974,29878,9,10042,47
11,7,vg giraffe,None,125,0.25,74769,114,74769,0,0,24988,34,80,0.999545472775156,0.9984776250951485,0.9986455262528883,0.9990112635784241,0.998519777966695,74769,34,25068,114
11,7,SAFARI,None,125,0.25,74769,114,74769,0,0,24988,34,80,0.999545472775156,0.9984776250951485,0.9986455262528883,0.9990112635784241,0.998519777966695,74769,34,25068,114
11,7,vg giraffe,None,125,0.2,59811,92,59811,0,0,19912,22,60,0.9996323099293032,0.9984641837637513,0.9988996699009703,0.9990479053918621,0.9985731629472946,59811,22,19972,92
11,7,SAFARI,None,125,0.2,59811,92,59811,0,0,19912,22,60,0.9996323099293032,0.9984641837637513,0.9988996699009703,0.9990479053918621,0.9985731629472946,59811,22,19972,92
11,7,vg giraffe,None,125,0.35,104628,158,104628,0,1,35011,39,110,0.9996178392631941,0.9984921649838719,0.9988623759278746,0.9990546850382424,0.998585178674784,104628,40,35121,158
11,7,SAFARI,None,125,0.35,104628,158,104628,0,1,35011,39,110,0.9996178392631941,0.9984921649838719,0.9988623759278746,0.9990546850382424,0.998585178674784,104628,40,35121,158
11,7,vg giraffe,None,125,0.3,89521,136,89521,0,0,29887,38,97,0.9995756987014147,0.9984831078443401,0.9987342615415362,0.9990291045442371,0.9985461108465145,89521,38,29984,136
11,7,SAFARI,None,125,0.3,89521,136,89521,0,0,29887,38,97,0.9995756987014147,0.9984831078443401,0.9987342615415362,0.9990291045442371,0.9985461108465145,89521,38,29984,136
11,7,vg giraffe,None,125,0.45,134935,208,134935,0,3,45254,47,148,0.9996295884727933,0.9984608895762267,0.9988999383965502,0.999044897233904,0.9985713890196296,134935,50,45402,208
11,7,SAFARI,None,125,0.45,134935,208,134935,0,3,45254,47,148,0.9996295884727933,0.9984608895762267,0.9988999383965502,0.999044897233904,0.9985713890196296,134935,50,45402,208
11,7,vg giraffe,None,125,0.4,119590,182,119590,0,2,40042,42,125,0.9996322115786482,0.9984804461810773,0.9989057720524235,0.9990559969257244,0.9985873499059275,119590,44,40167,182
11,7,SAFARI,None,125,0.4,119590,182,119590,0,2,40042,42,125,0.9996322115786482,0.9984804461810773,0.9989057720524235,0.9990559969257244,0.9985873499059275,119590,44,40167,182
11,7,vg giraffe,None,125,0.55,164947,256,164947,0,3,55337,57,169,0.9996363790627064,0.9984503913367191,0.9989202030018357,0.9990430332212834,0.9985686396187871,164947,60,55506,256
11,7,SAFARI,None,125,0.55,164947,256,164947,0,3,55337,57,169,0.9996363790627064,0.9984503913367191,0.9989202030018357,0.9990430332212834,0.9985686396187871,164947,60,55506,256
11,7,vg giraffe,None,125,0.5,150025,234,150025,0,3,50380,53,155,0.9996268681578614,0.9984426889570674,0.9988930837500741,0.9990344276486648,0.9985561364202141,150025,56,50535,234
11,7,SAFARI,None,125,0.5,150025,234,150025,0,3,50380,53,155,0.9996268681578614,0.9984426889570674,0.9988930837500741,0.9990344276486648,0.9985561364202141,150025,56,50535,234
11,7,vg giraffe,None,125,0.65,195117,310,195117,0,3,65461,68,203,0.999636248130008,0.9984137299349629,0.9989199056819046,0.9990246150301448,0.9985411353872309,195117,71,65664,310
11,7,SAFARI,None,125,0.65,195117,310,195117,0,3,65461,68,203,0.999636248130008,0.9984137299349629,0.9989199056819046,0.9990246150301448,0.9985411353872309,195117,71,65664,310
11,7,vg giraffe,None,125,0.6,180021,286,180021,0,3,60357,62,187,0.999639061337361,0.998413816435302,0.9989275520137273,0.9990260632143244,0.9985430606518455,180021,65,60544,286
11,7,SAFARI,None,125,0.6,180021,286,180021,0,3,60357,62,187,0.999639061337361,0.998413816435302,0.9989275520137273,0.9990260632143244,0.9985430606518455,180021,65,60544,286
11,7,vg giraffe,None,125,0.75,224915,357,224915,0,3,75412,74,233,0.9996577656094439,0.9984152491210625,0.998983122474314,0.9990361210312172,0.9985581107929061,224915,77,75645,357
11,7,SAFARI,None,125,0.75,224915,357,224915,0,3,75412,74,233,0.9996577656094439,0.9984152491210625,0.998983122474314,0.9990361210312172,0.9985581107929061,224915,77,75645,357
11,7,vg giraffe,None,125,0.7,210099,330,210099,0,3,70488,71,224,0.9996479091034529,0.9984317750880345,0.9989545955414912,0.9990394719949026,0.9985633767757766,210099,74,70712,330
11,7,SAFARI,None,125,0.7,210099,330,210099,0,3,70488,71,224,0.9996479091034529,0.9984317750880345,0.9989545955414912,0.9990394719949026,0.9985633767757766,210099,74,70712,330
11,7,vg giraffe,None,125,0.85,254885,410,254885,0,4,85287,87,257,0.9996431036646586,0.9983940147672301,0.9989373503824371,0.9990181687769831,0.9985304901299387,254885,91,85544,410
11,7,SAFARI,None,125,0.85,254885,410,254885,0,4,85287,87,257,0.9996431036646586,0.9983940147672301,0.9989373503824371,0.9990181687769831,0.9985304901299387,254885,91,85544,410
11,7,vg giraffe,None,125,0.8,239763,384,239763,0,3,80296,82,248,0.9996456088856276,0.9984009794001174,0.9989457887360627,0.9990229064886093,0.998537920542684,239763,85,80544,384
11,7,SAFARI,None,125,0.8,239763,384,239763,0,3,80296,82,248,0.9996456088856276,0.9984009794001174,0.9989457887360627,0.9990229064886093,0.998537920542684,239763,85,80544,384
11,7,vg giraffe,None,125,0.95,284713,461,284713,0,5,95213,95,284,0.9996488924311742,0.9983834430908849,0.9989539420693118,0.9990157670262656,0.9985266735124261,284713,100,95497,461
11,7,SAFARI,None,125,0.95,284713,461,284713,0,5,95213,95,284,0.9996488924311742,0.9983834430908849,0.9989539420693118,0.9990157670262656,0.9985266735124261,284713,100,95497,461
11,7,vg giraffe,None,125,0.9,269733,440,269733,0,4,90234,90,270,0.9996516286361261,0.9983714138718525,0.9989624495021965,0.9990111111111111,0.9985198366831037,269733,94,90504,440
11,7,SAFARI,None,125,0.9,269733,440,269733,0,4,90234,90,270,0.9996516286361261,0.9983714138718525,0.9989624495021965,0.9990111111111111,0.9985198366831037,269733,94,90504,440
11,7,vg giraffe,Single-stranded,125,0.15,44833,67,44833,0,0,14958,18,39,0.9995986711556041,0.9985077951002227,0.9988011988011988,0.9990529353433387,0.998581323541684,44833,18,14997,67
11,7,SAFARI,Single-stranded,125,0.15,44833,67,44833,0,0,14958,18,39,0.9995986711556041,0.9985077951002227,0.9988011988011988,0.9990529353433387,0.998581323541684,44833,18,14997,67
11,7,vg giraffe,Single-stranded,125,0.1,29883,42,29883,0,0,10014,11,19,0.9996320331839165,0.9985964912280701,0.9989048187972919,0.9991139938815427,0.9986739723285546,29883,11,10033,42
11,7,SAFARI,Single-stranded,125,0.1,29883,42,29883,0,0,10014,11,19,0.9996320331839165,0.9985964912280701,0.9989048187972919,0.9991139938815427,0.9986739723285546,29883,11,10033,42
11,7,vg giraffe,Single-stranded,125,0.25,74761,121,74761,0,0,24987,35,75,0.9995320605379967,0.9983841243556529,0.9986054110052994,0.9989577626638517,0.9984396723311896,74761,35,25062,121
11,7,SAFARI,Single-stranded,125,0.25,74761,121,74761,0,0,24987,35,75,0.9995320605379967,0.9983841243556529,0.9986054110052994,0.9989577626638517,0.9984396723311896,74761,35,25062,121
11,7,vg giraffe,Single-stranded,125,0.2,59804,99,59804,0,0,19911,24,52,0.9995988500367721,0.9983473281805586,0.9987992194926703,0.9989726971293984,0.9984603830266616,59804,24,19963,99
11,7,SAFARI,Single-stranded,125,0.2,59804,99,59804,0,0,19911,24,52,0.9995988500367721,0.9983473281805586,0.9987992194926703,0.9989726971293984,0.9984603830266616,59804,24,19963,99
11,7,vg giraffe,Single-stranded,125,0.35,104621,164,104621,0,2,35008,39,99,0.9996082627887868,0.9984348904900511,0.9988335040400592,0.9990212321016773,0.9985350131848814,104621,41,35107,164
11,7,SAFARI,Single-stranded,125,0.35,104621,164,104621,0,2,35008,39,99,0.9996082627887868,0.9984348904900511,0.9988335040400592,0.9990212321016773,0.9985350131848814,104621,41,35107,164
11,7,vg giraffe,Single-stranded,125,0.3,89516,140,89516,0,0,29885,38,88,0.9995756750117247,0.9984384759525297,0.9987337976075439,0.9990067518553652,0.998512538962287,89516,38,29973,140
11,7,SAFARI,Single-stranded,125,0.3,89516,140,89516,0,0,29885,38,88,0.9995756750117247,0.9984384759525297,0.9987337976075439,0.9990067518553652,0.998512538962287,89516,38,29973,140
11,7,vg giraffe,Single-stranded,125,0.45,134929,217,134929,0,3,45252,46,135,0.9996369778778764,0.9983943290959407,0.9989215599964786,0.9990152670625343,0.9985269849708166,134929,49,45387,217
11,7,SAFARI,Single-stranded,125,0.45,134929,217,134929,0,3,45252,46,135,0.9996369778778764,0.9983943290959407,0.9989215599964786,0.9990152670625343,0.9985269849708166,134929,49,45387,217
11,7,vg giraffe,Single-stranded,125,0.4,119584,191,119584,0,3,40039,42,115,0.9996238370294828,0.9984053433521185,0.9988805691683873,0.9990142186429632,0.9985247602735444,119584,45,40154,191
11,7,SAFARI,Single-stranded,125,0.4,119584,191,119584,0,3,40039,42,115,0.9996238370294828,0.9984053433521185,0.9988805691683873,0.9990142186429632,0.9985247602735444,119584,45,40154,191
11,7,vg giraffe,Single-stranded,125,0.55,164947,258,164947,0,3,55336,57,157,0.9996363790627064,0.998438303925426,0.9989199503177146,0.9990369823022786,0.9985595086021798,164947,60,55493,258
11,7,SAFARI,Single-stranded,125,0.55,164947,258,164947,0,3,55336,57,157,0.9996363790627064,0.998438303925426,0.9989199503177146,0.9990369823022786,0.9985595086021798,164947,60,55493,258
11,7,vg giraffe,Single-stranded,125,0.5,150022,239,150022,0,3,50378,52,147,0.9996335214589844,0.9984094342510698,0.9989126136812969,0.9990211028907431,0.9985361554662644,150022,55,50525,239
11,7,SAFARI,Single-stranded,125,0.5,150022,239,150022,0,3,50378,52,147,0.9996335214589844,0.9984094342510698,0.9989126136812969,0.9990211028907431,0.9985361554662644,150022,55,50525,239
11,7,vg giraffe,Single-stranded,125,0.65,195131,300,195131,0,4,65459,71,196,0.9996157904982429,0.9984649313568472,0.9988589685075308,0.999040029490294,0.9985641041349972,195131,75,65655,300
11,7,SAFARI,Single-stranded,125,0.65,195131,300,195131,0,4,65459,71,196,0.9996157904982429,0.9984649313568472,0.9988589685075308,0.999040029490294,0.9985641041349972,195131,75,65655,300
11,7,vg giraffe,Single-stranded,125,0.6,180033,276,180033,0,3,60356,66,178,0.999616883765866,0.9984692943779845,0.9988614425028464,0.9990427595162189,0.9985679418210799,180033,69,60534,276
11,7,SAFARI,Single-stranded,125,0.6,180033,276,180033,0,3,60356,66,178,0.999616883765866,0.9984692943779845,0.9988614425028464,0.9990427595162189,0.9985679418210799,180033,69,60534,276
11,7,vg giraffe,Single-stranded,125,0.75,224919,357,224919,0,4,75410,82,227,0.9996177862714162,0.9984152772598945,0.9988642816581488,0.999016169902794,0.9985282343130708,224919,86,75637,357
11,7,SAFARI,Single-stranded,125,0.75,224919,357,224919,0,4,75410,82,227,0.9996177862714162,0.9984152772598945,0.9988642816581488,0.999016169902794,0.9985282343130708,224919,86,75637,357
11,7,vg giraffe,Single-stranded,125,0.7,210098,335,210098,0,4,70486,76,217,0.9996193702480755,0.9984080443656651,0.9988697851178956,0.9990133401171153,0.9985242660446063,210098,80,70703,335
11,7,SAFARI,Single-stranded,125,0.7,210098,335,210098,0,4,70486,76,217,0.9996193702480755,0.9984080443656651,0.9988697851178956,0.9990133401171153,0.9985242660446063,210098,80,70703,335
11,7,vg giraffe,Single-stranded,125,0.85,254891,407,254891,0,4,85288,91,256,0.9996274305255974,0.9984057846124921,0.9988906923247586,0.9990162340970911,0.9985275872081939,254891,95,85544,407
11,7,SAFARI,Single-stranded,125,0.85,254891,407,254891,0,4,85288,91,256,0.9996274305255974,0.9984057846124921,0.9988906923247586,0.9990162340970911,0.9985275872081939,254891,95,85544,407
11,7,vg giraffe,Single-stranded,125,0.8,239768,383,239768,0,4,80296,88,242,0.9996164429250396,0.998405170080491,0.998858985489272,0.9990104393440984,0.9985192389823587,239768,92,80538,383
11,7,SAFARI,Single-stranded,125,0.8,239768,383,239768,0,4,80296,88,242,0.9996164429250396,0.998405170080491,0.998858985489272,0.9990104393440984,0.9985192389823587,239768,92,80538,383
11,7,vg giraffe,Single-stranded,125,0.95,284720,457,284720,0,5,95214,96,291,0.9996453913159493,0.9983974864733131,0.9989435809468025,0.9990210491966638,0.998534598445834,284720,101,95505,457
11,7,SAFARI,Single-stranded,125,0.95,284720,457,284720,0,5,95214,96,291,0.9996453913159493,0.9983974864733131,0.9989435809468025,0.9990210491966638,0.998534598445834,284720,101,95505,457
11,7,vg giraffe,Single-stranded,125,0.9,269747,429,269747,0,4,90235,93,271,0.9996405330487245,0.9984121461565794,0.9989293952738871,0.9990259620014073,0.9985420437442313,269747,97,90506,429
11,7,SAFARI,Single-stranded,125,0.9,269747,429,269747,0,4,90235,93,271,0.9996405330487245,0.9984121461565794,0.9989293952738871,0.9990259620014073,0.9985420437442313,269747,97,90506,429
12,4,vg giraffe,High,125,0.15,44501,73,44501,322,0,14956,16,42,0.9996405867421434,0.9912018888096935,0.9989343279605701,0.9954033529799918,0.9931397095643465,44501,16,14998,395
12,4,SAFARI,High,125,0.15,44555,73,44555,268,0,14956,18,40,0.9995961680838176,0.9924046685673557,0.9988011189556414,0.9959874369893483,0.9940076781839425,44555,18,14996,341
12,4,vg giraffe,High,125,0.1,29673,48,29673,202,0,10014,11,26,0.9996294299959574,0.9916452227383618,0.9989055815341757,0.995621319643666,0.9934707559913944,29673,11,10040,250
12,4,SAFARI,High,125,0.1,29702,48,29702,173,0,10014,11,26,0.9996297916736782,0.9926143769007119,0.9989055815341757,0.996109732376417,0.9941962275479062,29702,11,10040,221
12,4,vg giraffe,High,125,0.25,74192,129,74192,559,1,24985,33,81,0.9995419394821222,0.9908119658119658,0.9986454183266932,0.9951578071975643,0.9927785557111423,74192,34,25066,688
12,4,SAFARI,High,125,0.25,74305,129,74305,446,1,24985,36,78,0.999502300180248,0.9923210470085471,0.9985258964143426,0.9958987280695876,0.993878775755151,74305,37,25063,575
12,4,vg giraffe,High,125,0.2,59363,94,59363,443,0,19910,24,58,0.9995958711502517,0.9910350584307178,0.9987995198079231,0.995297056678431,0.9929780203274421,59363,24,19968,537
12,4,SAFARI,High,125,0.2,59447,94,59447,359,0,19910,27,55,0.9995460201096278,0.9924373956594323,0.9986494597839136,0.9959790239080537,0.9939918890502178,59447,27,19965,453
12,4,vg giraffe,High,125,0.35,103825,181,103825,780,2,35008,37,112,0.9996245089732727,0.9908289275284866,0.998890753434398,0.9952072849269111,0.9928543356318553,103825,39,35120,961
12,4,SAFARI,High,125,0.35,103961,181,103961,644,2,35008,40,109,0.9995961654952261,0.9921268108335083,0.9988054267755055,0.9958474823865241,0.9938047089928186,103961,42,35117,825
12,4,vg giraffe,High,125,0.3,88846,149,88846,661,1,29884,36,99,0.9995837224216104,0.9909654680110646,0.998767488341106,0.9952559384784276,0.9929225575721113,88846,37,29983,810
12,4,SAFARI,High,125,0.3,88970,149,88970,537,1,29884,39,96,0.9995506122907538,0.9923485321673954,0.9986675549633578,0.9959365520020598,0.9939336207760955,88970,40,29980,686
12,4,vg giraffe,High,125,0.45,133894,228,133894,1023,2,45253,43,152,0.9996640261611629,0.990743275740871,0.999009900990099,0.9951836601210031,0.9928237215869764,133894,45,45405,1251
12,4,SAFARI,High,125,0.45,134076,228,134076,841,2,45253,46,149,0.9996421222152635,0.9920899774316475,0.998943894389439,0.9958517319112115,0.9938148896702567,134076,48,45402,1069
12,4,vg giraffe,High,125,0.4,118675,199,118675,899,2,40040,40,127,0.999646217475172,0.9908326584455596,0.9989554577333433,0.9952199253637469,0.992874198347314,118675,42,40167,1098
12,4,SAFARI,High,125,0.4,118837,199,118837,737,2,40040,43,124,0.9996214733937855,0.992185217035559,0.9988808475714392,0.9958894638704407,0.9938680601567677,118837,45,40164,936
12,4,vg giraffe,High,125,0.55,163697,271,163697,1236,2,55336,49,177,0.9996885458143,0.9908779448439505,0.9990821395147937,0.9952637466864467,0.9929428177996811,163697,51,55513,1507
12,4,SAFARI,High,125,0.55,163909,273,163909,1022,2,55336,52,174,0.9996706574044144,0.9921612067504418,0.9990281477215464,0.9959017763019987,0.9938895129728946,163909,54,55510,1295
12,4,vg giraffe,High,125,0.5,148880,245,148880,1137,2,50379,47,161,0.9996709841602375,0.9908027312294525,0.9990314099903141,0.9952171021187136,0.9928753155324096,148880,49,50540,1382
12,4,SAFARI,High,125,0.5,149086,247,149086,929,2,50379,50,158,0.9996513296410037,0.9921736699897512,0.9989721085611497,0.9958984635938544,0.9938860150061488,149086,52,50537,1176
12,4,vg giraffe,High,125,0.65,193637,320,193637,1464,2,65460,60,211,0.999679915745564,0.9908709913468869,0.9990567903488354,0.9952559621710526,0.9929313738254057,193637,62,65671,1784
12,4,SAFARI,High,125,0.65,193885,322,193885,1214,2,65460,63,208,0.9996648620778551,0.9921400463614453,0.9990111511721662,0.9958882402644265,0.9938695176026406,193885,65,65668,1536
12,4,vg giraffe,High,125,0.6,178654,297,178654,1355,2,60356,54,195,0.9996866431649041,0.9908377979656806,0.9990760143217781,0.9952425518639838,0.9929103037196,178654,56,60551,1652
12,4,SAFARI,High,125,0.6,178889,299,178889,1118,2,60356,57,192,0.9996702952813108,0.9921411378434439,0.9990265150890161,0.9958914862464997,0.9938733069614342,178889,59,60548,1417
12,4,vg giraffe,High,125,0.75,223204,369,223204,1687,2,75411,63,244,0.9997088713614519,0.9908727692444287,0.9991415742208135,0.9952712087735688,0.9929530201342281,223204,65,75655,2056
12,4,SAFARI,High,125,0.75,223491,371,223491,1398,2,75411,67,240,0.9996913580246913,0.99214685252597,0.9990887480190175,0.9959048170758878,0.9938932819456442,223491,69,75651,1769
12,4,vg giraffe,High,125,0.7,208489,348,208489,1580,2,70487,62,233,0.9996931235705072,0.990837242238032,0.9990958408679927,0.9952454829701411,0.992916099160387,208489,64,70720,1928
12,4,SAFARI,High,125,0.7,208757,350,208757,1310,2,70487,66,229,0.9996743684903627,0.9921109035866874,0.9990393309222423,0.995878275554453,0.993854929392143,208757,68,70716,1660
12,4,vg giraffe,High,125,0.85,252965,424,252965,1894,3,85284,73,271,0.9996996534158497,0.990919881073162,0.9991124709509407,0.9952904053320324,0.9929777011211038,252965,76,85555,2318
12,4,SAFARI,High,125,0.85,253251,426,253251,1606,3,85284,77,267,0.9996842076177017,0.9920402063592171,0.999065758895727,0.9958475386049145,0.9938048892095954,253251,80,85551,2032
12,4,vg giraffe,High,125,0.8,237954,393,237954,1788,3,80294,70,260,0.9996933121032487,0.9909176088450247,0.9990945961030424,0.9952861164207946,0.9929729830840311,237954,73,80554,2181
12,4,SAFARI,High,125,0.8,238247,395,238247,1493,3,80294,74,256,0.9996769104244642,0.9921377558456701,0.9990449849306063,0.9958930650275154,0.9938739626264956,238247,77,80550,1888
12,4,vg giraffe,High,125,0.95,282578,466,282578,2120,4,95211,79,300,0.9997063620379182,0.9909315341347436,0.9991317446701676,0.9952996081539206,0.9929902982997074,282578,83,95511,2586
12,4,SAFARI,High,125,0.95,282901,468,282901,1795,4,95211,83,296,0.9996925664692495,0.9920642156793985,0.9990899010398142,0.9958637829313282,0.9938281007884273,282901,87,95507,2263
12,4,vg giraffe,High,125,0.9,267703,450,267703,2010,3,90232,75,285,0.9997087171980088,0.9908943859817961,0.9991390253325239,0.9952820367919337,0.9929648129771204,267703,78,90517,2460
12,4,SAFARI,High,125,0.9,268007,452,268007,1704,3,90232,79,281,0.9996941314265039,0.9920196325921758,0.9990948727854738,0.995842096267176,0.9937963953675317,268007,82,90513,2156
12,4,vg giraffe,Mid,125,0.15,44837,60,44837,1,3,14953,22,38,0.9994427354999778,0.9986413648714865,0.9983351092168353,0.9990418894830659,0.9985646092732917,44837,25,14991,61
12,4,SAFARI,Mid,125,0.15,44836,61,44836,1,3,14953,22,38,0.9994427230779519,0.9986190921644617,0.9983351092168353,0.9990307378647267,0.9985479186834463,44836,25,14991,62
12,4,vg giraffe,Mid,125,0.1,29880,44,29880,1,0,10014,17,19,0.9994313810750243,0.9984962406015038,0.9983084577114428,0.9989635919895691,0.9984490306441526,29880,17,10033,45
12,4,SAFARI,Mid,125,0.1,29880,44,29880,1,0,10014,17,19,0.9994313810750243,0.9984962406015038,0.9983084577114428,0.9989635919895691,0.9984490306441526,29880,17,10033,45
12,4,vg giraffe,Mid,125,0.25,74776,104,74776,1,5,24981,42,69,0.9993718509014607,0.99859777513655,0.9981272662071163,0.9989846630684551,0.9984796655264158,74776,47,25050,105
12,4,SAFARI,Mid,125,0.25,74775,105,74775,1,5,24981,42,69,0.9993718425062148,0.998584420614041,0.9981272662071163,0.9989779763932587,0.9984696633259317,74775,47,25050,106
12,4,vg giraffe,Mid,125,0.2,59819,81,59819,1,3,19907,30,50,0.9994486399786139,0.998631074606434,0.9983491745872937,0.9990396900286423,0.9985605387340251,59819,33,19957,82
12,4,SAFARI,Mid,125,0.2,59818,82,59818,1,3,19907,30,50,0.9994486307664032,0.9986143803943173,0.9983491745872937,0.9990313314182644,0.9985480216795384,59818,33,19957,83
12,4,vg giraffe,Mid,125,0.35,104626,159,104626,2,7,35003,45,94,0.9995032385028373,0.9984635498678271,0.9985205838003927,0.9989831236722126,0.9984778756002745,104626,52,35097,161
12,4,SAFARI,Mid,125,0.35,104625,160,104625,2,7,35003,45,94,0.9995032337571769,0.9984540066993043,0.9985205838003927,0.9989783447274949,0.9984707294763321,104625,52,35097,162
12,4,vg giraffe,Mid,125,0.3,89522,134,89522,1,5,29880,44,85,0.9994529479407398,0.9984942614631317,0.9983674285333511,0.9989733746959181,0.9984624512204293,89522,49,29965,135
12,4,SAFARI,Mid,125,0.3,89521,135,89521,1,5,29880,44,85,0.9994529418332031,0.9984831078443401,0.9983674285333511,0.9989677894513662,0.9984540949770621,89521,49,29965,136
12,4,vg giraffe,Mid,125,0.45,134933,209,134933,2,8,45249,53,131,0.9995481280649511,0.9984387024211212,0.9986575999647895,0.9989931072266768,0.9984937840905944,134933,61,45380,211
12,4,SAFARI,Mid,125,0.45,134932,210,134932,2,8,45249,53,131,0.9995481247175779,0.9984313029065294,0.9986575999647895,0.9989894016739654,0.998488246532104,134932,61,45380,212
12,4,vg giraffe,Mid,125,0.4,119592,179,119592,2,8,40034,49,109,0.9995236065491563,0.9984888079951241,0.9985820895522388,0.9990059393038233,0.998512248942009,119592,57,40143,181
12,4,SAFARI,Mid,125,0.4,119591,180,119591,2,8,40034,49,109,0.9995236025675315,0.9984804588680254,0.9985820895522388,0.9990017584088279,0.9985059978871434,119591,57,40143,182
12,4,vg giraffe,Mid,125,0.55,164945,254,164945,5,8,55332,61,158,0.9995818536609015,0.9984322413500883,0.998758076999226,0.999006716774979,0.9985142437817931,164945,69,55490,259
12,4,SAFARI,Mid,125,0.55,164944,255,164944,5,8,55332,61,158,0.9995818511268809,0.998426188227888,0.998758076999226,0.9990036854553219,0.9985097140372254,164944,69,55490,260
12,4,vg giraffe,Mid,125,0.5,150023,234,150023,3,8,50375,58,141,0.999560260911859,0.9984227339278584,0.9986951880115456,0.9989911736013771,0.9984913514105616,150023,66,50516,237
12,4,SAFARI,Mid,125,0.5,150022,235,150022,3,8,50375,58,141,0.9995602579819839,0.9984160787967523,0.9986951880115456,0.9989878407713719,0.9984863723723125,150022,66,50516,238
12,4,vg giraffe,Mid,125,0.65,195115,305,195115,5,9,65453,71,200,0.9995901534363073,0.9984137137009083,0.9987829552888199,0.9990015872203165,0.9985066511460495,195115,80,65653,310
12,4,SAFARI,Mid,125,0.65,195114,306,195114,5,9,65453,72,199,0.9995850303542612,0.9984085966483306,0.9987677422299301,0.9989964671547796,0.9984989929467984,195114,81,65652,311
12,4,vg giraffe,Mid,125,0.6,180026,277,180026,5,9,60351,66,179,0.9995835669985175,0.9984360094948643,0.9987624783433711,0.9990094586983123,0.9985181372528672,180026,75,60530,282
12,4,SAFARI,Mid,125,0.6,180025,278,180025,5,9,60351,67,178,0.9995780145584977,0.9984304634292432,0.998745978054616,0.9990039094473223,0.9985098355007824,180025,76,60529,283
12,4,vg giraffe,Mid,125,0.75,224912,347,224912,7,10,75403,78,230,0.9996088888888889,0.9984285244999246,0.9988378389086251,0.9990183580372491,0.9985314980381212,224912,88,75633,354
12,4,SAFARI,Mid,125,0.75,224911,348,224911,7,10,75403,79,229,0.9996044444444444,0.9984240853035966,0.9988246325325867,0.9990139162184131,0.9985248532328639,224911,89,75632,355
12,4,vg giraffe,Mid,125,0.7,210090,327,210090,6,9,70480,74,222,0.9996050872376566,0.9984174733750588,0.9988274351910715,0.9990109273507117,0.9985206679753066,210090,83,70702,333
12,4,SAFARI,Mid,125,0.7,210089,328,210089,6,9,70480,75,221,0.9996003292525681,0.9984127210428517,0.998813307904217,0.9990061721937441,0.9985135558021109,210089,84,70701,334
12,4,vg giraffe,Mid,125,0.85,254872,409,254872,8,12,85275,86,260,0.9996156410558105,0.9983665571176197,0.9988555813763386,0.998990708640122,0.9984893905350785,254872,98,85535,417
12,4,SAFARI,Mid,125,0.85,254872,410,254872,7,12,85275,87,259,0.9996117205486114,0.9983665571176197,0.9988439036352807,0.9989887508329086,0.9984864573128164,254872,99,85534,417
12,4,vg giraffe,Mid,125,0.8,239750,383,239750,8,12,80285,84,244,0.9995997431685332,0.9983717899067631,0.9988093023255814,0.9989853891876238,0.9984817592887026,239750,96,80529,391
12,4,SAFARI,Mid,125,0.8,239750,384,239750,7,12,80285,85,243,0.9995955755127227,0.9983717899067631,0.9987968992248062,0.9989833079160312,0.9984786417513078,239750,97,80528,391
12,4,vg giraffe,Mid,125,0.95,284708,453,284708,8,12,95201,93,289,0.9996313370527329,0.9983834147470447,0.9989016161933155,0.9990069861855287,0.9985135149331344,284708,105,95490,461
12,4,SAFARI,Mid,125,0.95,284708,454,284708,7,12,95201,94,288,0.9996278272837712,0.9983834147470447,0.9988911553951566,0.9990052334894199,0.9985108886344297,284708,106,95489,461
12,4,vg giraffe,Mid,125,0.9,269733,427,269733,8,12,90223,88,274,0.9996294004069184,0.998389890734654,0.9988962106913033,0.9990092610939609,0.9985170401785095,269733,100,90497,435
12,4,SAFARI,Mid,125,0.9,269733,428,269733,7,12,90223,89,273,0.9996256957981574,0.998389890734654,0.9988851727982163,0.9990074110836628,0.9985142682909928,269733,101,90496,435
12,4,vg giraffe,None,125,0.15,44827,73,44827,0,0,14958,17,41,0.9996209080367496,0.9983741648106904,0.998867874267448,0.9989971474416117,0.9984978970558782,44827,17,14999,73
12,4,SAFARI,None,125,0.15,44827,73,44827,0,0,14958,17,41,0.9996209080367496,0.9983741648106904,0.998867874267448,0.9989971474416117,0.9984978970558782,44827,17,14999,73
12,4,vg giraffe,None,125,0.1,29878,47,29878,0,0,10014,11,26,0.9996319716283583,0.9984294068504594,0.9989055815341757,0.9990303273481125,0.9985491294776866,29878,11,10040,47
12,4,SAFARI,None,125,0.1,29878,47,29878,0,0,10014,11,26,0.9996319716283583,0.9984294068504594,0.9989055815341757,0.9990303273481125,0.9985491294776866,29878,11,10040,47
12,4,vg giraffe,None,125,0.25,74769,114,74769,0,0,24988,37,77,0.9995053872684009,0.9984776250951485,0.9985260138634372,0.9989912418414179,0.9984897734660199,74769,37,25065,114
12,4,SAFARI,None,125,0.25,74769,114,74769,0,0,24988,37,77,0.9995053872684009,0.9984776250951485,0.9985260138634372,0.9989912418414179,0.9984897734660199,74769,37,25065,114
12,4,vg giraffe,None,125,0.2,59811,92,59811,0,0,19912,25,57,0.9995821913229493,0.9984641837637513,0.9987496248874662,0.9990228747525867,0.9985356146038024,59811,25,19969,92
12,4,SAFARI,None,125,0.2,59811,92,59811,0,0,19912,25,57,0.9995821913229493,0.9984641837637513,0.9987496248874662,0.9990228747525867,0.9985356146038024,59811,25,19969,92
12,4,vg giraffe,None,125,0.35,104628,158,104628,0,2,35010,42,107,0.9995796392540508,0.9984921649838719,0.9987486135206621,0.9990356061835786,0.9985565964257898,104628,44,35117,158
12,4,SAFARI,None,125,0.35,104628,158,104628,0,2,35010,42,107,0.9995796392540508,0.9984921649838719,0.9987486135206621,0.9990356061835786,0.9985565964257898,104628,44,35117,158
12,4,vg giraffe,None,125,0.3,89521,136,89521,0,1,29886,41,94,0.999531056351395,0.9984831078443401,0.9986010259143295,0.9990068072759737,0.9985126881073538,89521,42,29980,136
12,4,SAFARI,None,125,0.3,89521,136,89521,0,1,29886,41,94,0.999531056351395,0.9984831078443401,0.9986010259143295,0.9990068072759737,0.9985126881073538,89521,42,29980,136
12,4,vg giraffe,None,125,0.45,134935,208,134935,0,6,45251,49,146,0.9995925624120305,0.9984608895762267,0.9987899322362053,0.9990264055113592,0.99854370276032,134935,55,45397,208
12,4,SAFARI,None,125,0.45,134935,208,134935,0,6,45251,49,146,0.9995925624120305,0.9984608895762267,0.9987899322362053,0.9990264055113592,0.99854370276032,134935,55,45397,208
12,4,vg giraffe,None,125,0.4,119590,182,119590,0,4,40040,46,121,0.9995820795720495,0.9984804461810773,0.9987565591504812,0.9990309591833325,0.9985498459211292,119590,50,40161,182
12,4,SAFARI,None,125,0.4,119590,182,119590,0,4,40040,46,121,0.9995820795720495,0.9984804461810773,0.9987565591504812,0.9990309591833325,0.9985498459211292,119590,50,40161,182
12,4,vg giraffe,None,125,0.55,164947,256,164947,0,6,55334,58,168,0.9996121470689833,0.9984503913367191,0.9988482165352913,0.9990309314565706,0.998550521132949,164947,64,55502,256
12,4,SAFARI,None,125,0.55,164947,256,164947,0,6,55334,58,168,0.9996121470689833,0.9984503913367191,0.9988482165352913,0.9990309314565706,0.998550521132949,164947,64,55502,256
12,4,vg giraffe,None,125,0.5,150025,234,150025,0,6,50377,54,154,0.999600226538295,0.9984426889570674,0.9988140183036508,0.9990211224462615,0.9985362210604929,150025,60,50531,234
12,4,SAFARI,None,125,0.5,150025,234,150025,0,6,50377,54,154,0.999600226538295,0.9984426889570674,0.9988140183036508,0.9990211224462615,0.9985362210604929,150025,60,50531,234
12,4,vg giraffe,None,125,0.65,195117,310,195117,0,6,65458,67,204,0.9996260054306061,0.9984137299349629,0.9988894804898456,0.9990194999193583,0.9985334773052741,195117,73,65662,310
12,4,SAFARI,None,125,0.65,195117,310,195117,0,6,65458,67,204,0.9996260054306061,0.9984137299349629,0.9988894804898456,0.9990194999193583,0.9985334773052741,195117,73,65662,310
12,4,vg giraffe,None,125,0.6,180021,286,180021,0,6,60354,61,188,0.9996279596641642,0.998413816435302,0.9988945536141497,0.9990205191525965,0.998534759003138,180021,67,60542,286
12,4,SAFARI,None,125,0.6,180021,286,180021,0,6,60354,61,188,0.9996279596641642,0.998413816435302,0.9988945536141497,0.9990205191525965,0.998534759003138,180021,67,60542,286
12,4,vg giraffe,None,125,0.75,224915,357,224915,0,6,75409,73,234,0.9996488795256763,0.9984152491210625,0.9989567100710494,0.9990316834937569,0.9985514661421823,224915,79,75643,357
12,4,SAFARI,None,125,0.75,224915,357,224915,0,6,75409,73,234,0.9996488795256763,0.9984152491210625,0.9989567100710494,0.9990316834937569,0.9985514661421823,224915,79,75643,357
12,4,vg giraffe,None,125,0.7,210099,330,210099,0,6,70485,70,225,0.9996383965742833,0.9984317750880345,0.9989263413669369,0.9990347214957537,0.998556264779617,210099,76,70710,330
12,4,SAFARI,None,125,0.7,210099,330,210099,0,6,70485,70,225,0.9996383965742833,0.9984317750880345,0.9989263413669369,0.9990347214957537,0.998556264779617,210099,76,70710,330
12,4,vg giraffe,None,125,0.85,254885,410,254885,0,7,85284,87,257,0.9996313421889645,0.9983940147672301,0.9989023179774625,0.9990122953550447,0.9985216906696389,254885,94,85541,410
12,4,SAFARI,None,125,0.85,254885,410,254885,0,7,85284,87,257,0.9996313421889645,0.9983940147672301,0.9989023179774625,0.9990122953550447,0.9985216906696389,254885,94,85541,410
12,4,vg giraffe,None,125,0.8,239763,384,239763,0,6,80293,82,248,0.9996331055530309,0.9984009794001174,0.9989085812796884,0.9990166625694274,0.9985285682220615,239763,88,80541,384
12,4,SAFARI,None,125,0.8,239763,384,239763,0,6,80293,82,248,0.9996331055530309,0.9984009794001174,0.9989085812796884,0.9990166625694274,0.9985285682220615,239763,88,80541,384
12,4,vg giraffe,None,125,0.95,284713,461,284713,0,9,95209,95,284,0.9996348532566525,0.9983834430908849,0.9989120997520843,0.999008756278608,0.9985161685107322,284713,104,95493,461
12,4,SAFARI,None,125,0.95,284713,461,284713,0,9,95209,95,284,0.9996348532566525,0.9983834430908849,0.9989120997520843,0.999008756278608,0.9985161685107322,284713,104,95493,461
12,4,vg giraffe,None,125,0.9,269733,440,269733,0,7,90231,90,270,0.9996405143979543,0.9983714138718525,0.9989293361884368,0.9990055610802162,0.9985115211588514,269733,97,90501,440
12,4,SAFARI,None,125,0.9,269733,440,269733,0,7,90231,90,270,0.9996405143979543,0.9983714138718525,0.9989293361884368,0.9990055610802162,0.9985115211588514,269733,97,90501,440
12,4,vg giraffe,Single-stranded,125,0.15,44833,67,44833,0,0,14958,19,38,0.9995763845536431,0.9985077951002227,0.9987345987345987,0.9990418040823603,0.9985646332304098,44833,19,14996,67
12,4,SAFARI,Single-stranded,125,0.15,44833,67,44833,0,0,14958,19,38,0.9995763845536431,0.9985077951002227,0.9987345987345987,0.9990418040823603,0.9985646332304098,44833,19,14996,67
12,4,vg giraffe,Single-stranded,125,0.1,29883,42,29883,0,0,10014,12,18,0.9995985950827898,0.9985964912280701,0.998805256869773,0.9990972918756269,0.9986489529385274,29883,12,10032,42
12,4,SAFARI,Single-stranded,125,0.1,29883,42,29883,0,0,10014,12,18,0.9995985950827898,0.9985964912280701,0.998805256869773,0.9990972918756269,0.9986489529385274,29883,12,10032,42
12,4,vg giraffe,Single-stranded,125,0.25,74761,121,74761,0,0,24987,37,73,0.9995053343672291,0.9983841243556529,0.9985257202056023,0.9989444147514698,0.9984196681303074,74761,37,25060,121
12,4,SAFARI,Single-stranded,125,0.25,74761,121,74761,0,0,24987,37,73,0.9995053343672291,0.9983841243556529,0.9985257202056023,0.9989444147514698,0.9984196681303074,74761,37,25060,121
12,4,vg giraffe,Single-stranded,125,0.2,59804,99,59804,0,0,19911,26,50,0.9995654354003009,0.9983473281805586,0.9986991544503927,0.9989560104565993,0.9984353486043309,59804,26,19961,99
12,4,SAFARI,Single-stranded,125,0.2,59804,99,59804,0,0,19911,26,50,0.9995654354003009,0.9983473281805586,0.9986991544503927,0.9989560104565993,0.9984353486043309,59804,26,19961,99
12,4,vg giraffe,Single-stranded,125,0.35,104621,164,104621,0,3,35007,42,96,0.9995700609558023,0.9984348904900511,0.9987196995561625,0.9990021532482538,0.9985064280762936,104621,45,35103,164
12,4,SAFARI,Single-stranded,125,0.35,104621,164,104621,0,3,35007,42,96,0.9995700609558023,0.9984348904900511,0.9987196995561625,0.9990021532482538,0.9985064280762936,104621,45,35103,164
12,4,vg giraffe,Single-stranded,125,0.3,89516,140,89516,0,1,29884,41,85,0.9995310301703924,0.9984384759525297,0.9986005131451801,0.9989844543395047,0.9984791128715519,89516,42,29969,140
12,4,SAFARI,Single-stranded,125,0.3,89516,140,89516,0,1,29884,41,85,0.9995310301703924,0.9984384759525297,0.9986005131451801,0.9989844543395047,0.9984791128715519,89516,42,29969,140
12,4,vg giraffe,Single-stranded,125,0.45,134929,217,134929,0,5,45250,48,133,0.9996073550547481,0.9983943290959407,0.9988335240778238,0.9990004738494344,0.9985048343688739,134929,53,45383,217
12,4,SAFARI,Single-stranded,125,0.45,134929,217,134929,0,5,45250,48,133,0.9996073550547481,0.9983943290959407,0.9988335240778238,0.9990004738494344,0.9985048343688739,134929,53,45383,217
12,4,vg giraffe,Single-stranded,125,0.4,119584,191,119584,0,5,40037,45,112,0.9995820586121003,0.9984053433521185,0.9987561879648748,0.9989933544687125,0.9984935051945941,119584,50,40149,191
12,4,SAFARI,Single-stranded,125,0.4,119584,191,119584,0,5,40037,45,112,0.9995820586121003,0.9984053433521185,0.9987561879648748,0.9989933544687125,0.9984935051945941,119584,50,40149,191
12,4,vg giraffe,Single-stranded,125,0.55,164947,258,164947,0,5,55334,58,156,0.9996182049572753,0.998438303925426,0.9988659478336004,0.9990279060612025,0.9985459190606909,164947,63,55490,258
12,4,SAFARI,Single-stranded,125,0.55,164947,258,164947,0,5,55334,58,156,0.9996182049572753,0.998438303925426,0.9988659478336004,0.9990279060612025,0.9985459190606909,164947,63,55490,258
12,4,vg giraffe,Single-stranded,125,0.5,150022,239,150022,0,5,50376,53,146,0.999613539445629,0.9984094342510698,0.9988533017002768,0.9990111240223613,0.9985212182771446,150022,58,50522,239
12,4,SAFARI,Single-stranded,125,0.5,150022,239,150022,0,5,50376,53,146,0.999613539445629,0.9984094342510698,0.9988533017002768,0.9990111240223613,0.9985212182771446,150022,58,50522,239
12,4,vg giraffe,Single-stranded,125,0.65,195131,300,195131,0,6,65457,70,197,0.9996106696993448,0.9984649313568472,0.9988437547542979,0.9990374720329308,0.9985602750793572,195131,76,65654,300
12,4,SAFARI,Single-stranded,125,0.65,195131,300,195131,0,6,65457,70,197,0.9996106696993448,0.9984649313568472,0.9988437547542979,0.9990374720329308,0.9985602750793572,195131,76,65654,300
12,4,vg giraffe,Single-stranded,125,0.6,180033,276,180033,0,5,60354,65,179,0.999611333514711,0.9984692943779845,0.9988449416695543,0.9990399875697812,0.9985637909278077,180033,70,60533,276
12,4,SAFARI,Single-stranded,125,0.6,180033,276,180033,0,5,60354,65,179,0.999611333514711,0.9984692943779845,0.9988449416695543,0.9990399875697812,0.9985637909278077,180033,70,60533,276
12,4,vg giraffe,Single-stranded,125,0.75,224919,357,224919,0,7,75407,80,229,0.9996133436441695,0.9984152772598945,0.9988510756309179,0.9990139512572122,0.9985249120428972,224919,87,75636,357
12,4,SAFARI,Single-stranded,125,0.75,224919,357,224919,0,7,75407,80,229,0.9996133436441695,0.9984152772598945,0.9988510756309179,0.9990139512572122,0.9985249120428972,224919,87,75636,357
12,4,vg giraffe,Single-stranded,125,0.7,210098,335,210098,0,6,70484,75,218,0.9996146142097926,0.9984080443656651,0.9988556574318692,0.9990109649748462,0.9985207100591716,210098,81,70702,335
12,4,SAFARI,Single-stranded,125,0.7,210098,335,210098,0,6,70484,75,218,0.9996146142097926,0.9984080443656651,0.9988556574318692,0.9990109649748462,0.9985207100591716,210098,81,70702,335
12,4,vg giraffe,Single-stranded,125,0.85,254891,407,254891,0,8,85284,91,256,0.9996117494803718,0.9984057846124921,0.9988439846331695,0.9990084030978585,0.9985158548353508,254891,99,85540,407
12,4,SAFARI,Single-stranded,125,0.85,254891,407,254891,0,8,85284,91,256,0.9996117494803718,0.9984057846124921,0.9988439846331695,0.9990084030978585,0.9985158548353508,254891,99,85540,407
12,4,vg giraffe,Single-stranded,125,0.8,239768,383,239768,0,8,80292,87,243,0.9996039405827494,0.998405170080491,0.9988217784943569,0.9990041957109583,0.9985098868075104,239768,95,80535,383
12,4,SAFARI,Single-stranded,125,0.8,239768,383,239768,0,8,80292,87,243,0.9996039405827494,0.998405170080491,0.9988217784943569,0.9990041957109583,0.9985098868075104,239768,95,80535,383
12,4,vg giraffe,Single-stranded,125,0.95,284720,457,284720,0,9,95210,96,291,0.9996313525849205,0.9983974864733131,0.9989017425684581,0.9990140385472331,0.9985240937751948,284720,105,95501,457
12,4,SAFARI,Single-stranded,125,0.95,284720,457,284720,0,9,95210,96,291,0.9996313525849205,0.9983974864733131,0.9989017425684581,0.9990140385472331,0.9985240937751948,284720,105,95501,457
12,4,vg giraffe,Single-stranded,125,0.9,269747,429,269747,0,8,90231,93,271,0.9996257152174558,0.9984121461565794,0.9988852466253877,0.999018562137979,0.9985309566244155,269747,101,90502,429
12,4,SAFARI,Single-stranded,125,0.9,269747,429,269747,0,8,90231,93,271,0.9996257152174558,0.9984121461565794,0.9988852466253877,0.999018562137979,0.9985309566244155,269747,101,90502,429
12,6,vg giraffe,High,125,0.15,44289,71,44289,536,0,14956,16,42,0.9996388669450401,0.9864798645759087,0.9989343279605701,0.9930157733657694,0.9896010682690702,44289,16,14998,607
12,6,SAFARI,High,125,0.15,44351,71,44351,474,0,14956,16,42,0.9996393716050217,0.9878608339272986,0.9989343279605701,0.9937152011471717,0.9906359539308963,44351,16,14998,545
12,6,vg giraffe,High,125,0.1,29529,46,29529,348,0,10014,11,26,0.9996276235612729,0.9868328710356582,0.9989055815341757,0.9931890419252308,0.9898684144694051,29529,11,10040,394
12,6,SAFARI,High,125,0.1,29561,46,29561,316,0,10014,11,26,0.999628026511565,0.9879022825251479,0.9989055815341757,0.9937305655937474,0.990668934807625,29561,11,10040,362
12,6,vg giraffe,High,125,0.25,73824,125,73824,931,1,24985,33,81,0.999539657179994,0.985897435897436,0.9986454183266932,0.9926716777151771,0.9890978195639127,73824,34,25066,1056
12,6,SAFARI,High,125,0.25,73932,125,73932,823,1,24985,34,80,0.9995268160125461,0.9873397435897436,0.9986055776892431,0.9933959031757441,0.9901680336067213,73932,35,25065,948
12,6,vg giraffe,High,125,0.2,59079,91,59079,730,0,19910,24,58,0.9995939292421705,0.9862938230383973,0.9987995198079231,0.9928993386721343,0.9894232213488209,59079,24,19968,821
12,6,SAFARI,High,125,0.2,59161,91,59161,648,0,19910,25,57,0.9995776028114757,0.9876627712854757,0.99874949979992,0.9935844683673982,0.9904370900715966,59161,25,19967,739
12,6,vg giraffe,High,125,0.35,103294,177,103294,1315,2,35008,37,112,0.9996225794276756,0.9857614566831447,0.998890753434398,0.9926436317683633,0.9890599878523706,103294,39,35120,1492
12,6,SAFARI,High,125,0.35,103432,177,103432,1177,2,35008,38,111,0.9996134219885573,0.9870784265073579,0.9988623112147672,0.9933063795868585,0.9900389438708064,103432,40,35119,1354
12,6,vg giraffe,High,125,0.3,88396,145,88396,1115,1,29884,36,99,0.9995816041522961,0.985946283572767,0.998767488341106,0.9927171245837756,0.9891624051606003,88396,37,29983,1260
12,6,SAFARI,High,125,0.3,88518,145,88518,993,1,29884,37,98,0.9995708929942635,0.9873070402427054,0.9987341772151899,0.9934011177698472,0.9901734683645844,88518,38,29982,1138
12,6,vg giraffe,High,125,0.45,133182,224,133182,1739,2,45253,43,152,0.9996622306289266,0.9854748603351955,0.999009900990099,0.9925178483597394,0.9888811982613029,133182,45,45405,1963
12,6,SAFARI,High,125,0.45,133373,224,133373,1548,2,45253,44,151,0.9996552215201733,0.9868881571645269,0.998987898789879,0.9932306638268718,0.9899332761150641,133373,46,45404,1772
12,6,vg giraffe,High,125,0.4,118045,195,118045,1533,2,40040,40,127,0.9996443300278608,0.9855727083733395,0.9989554577333433,0.9925586479441688,0.9889362553287245,118045,42,40167,1728
12,6,SAFARI,High,125,0.4,118217,195,118217,1361,2,40040,41,126,0.9996363943852529,0.9870087582343267,0.9989305876793753,0.9932824440308697,0.9900051255766273,118217,43,40166,1556
12,6,vg giraffe,High,125,0.55,162822,268,162822,2114,2,55336,49,177,0.9996868725939843,0.9855814629185734,0.9990821395147937,0.9925840580107719,0.9889793810697203,162822,51,55513,2382
12,6,SAFARI,High,125,0.55,163050,269,163050,1885,2,55336,50,176,0.9996811811013967,0.9869615747802717,0.999064142250378,0.9932806588974921,0.9900076097985215,163050,52,55512,2154
12,6,vg giraffe,High,125,0.5,148090,242,148090,1930,2,50379,47,161,0.9996692295749262,0.9855452476341324,0.9990314099903141,0.9925569954524281,0.9889420515705672,148090,49,50540,2172
12,6,SAFARI,High,125,0.5,148305,243,148305,1714,2,50379,48,160,0.9996629705773314,0.9869760817771626,0.9990116428472593,0.9932790162649817,0.9900075180108637,148305,50,50539,1957
12,6,vg giraffe,High,125,0.65,192613,317,192613,2491,2,65460,60,211,0.9996782146100948,0.9856310222545172,0.9990567903488354,0.9926049224934037,0.9890103157523913,192613,62,65671,2808
12,6,SAFARI,High,125,0.65,192878,318,192878,2225,2,65460,61,210,0.9996734753111055,0.9869870689434606,0.9990415772899457,0.9932897657340317,0.9900212135368404,192878,63,65670,2543
12,6,vg giraffe,High,125,0.6,177708,294,177708,2304,2,60356,54,195,0.9996849755856079,0.9855911616917906,0.9990760143217781,0.9925880414444103,0.9889835749835003,177708,56,60551,2598
12,6,SAFARI,High,125,0.6,177955,295,177955,2056,2,60356,55,194,0.9996797968676269,0.986961055095227,0.9990595145775241,0.9932797124342064,0.9900046904899279,177955,57,60550,2351
12,6,vg giraffe,High,125,0.75,222018,366,222018,2876,2,75411,63,244,0.9997073166338711,0.9856077421646098,0.9991415742208135,0.9926074622828568,0.9890125589740182,222018,65,75655,3242
12,6,SAFARI,High,125,0.75,222324,367,222324,2569,2,75411,64,243,0.9997032240658303,0.9869661724229779,0.9991283676703645,0.9932938679772144,0.9900259153432122,222324,66,75654,2936
12,6,vg giraffe,High,125,0.7,207390,345,207390,2682,2,70487,62,233,0.9996914978742275,0.9856142802150016,0.9990958408679927,0.992602980345609,0.989007862703191,207390,64,70720,3027
12,6,SAFARI,High,125,0.7,207671,346,207671,2400,2,70487,63,232,0.999687102861324,0.9869497236440021,0.9990817133815552,0.993277580215854,0.9900035917368715,207671,65,70719,2746
12,6,vg giraffe,High,125,0.85,251617,421,251617,3245,3,85284,72,272,0.9997020167506318,0.9856394667878394,0.9991241489647441,0.9926209379160709,0.9890265580175646,251617,75,85556,3666
12,6,SAFARI,High,125,0.85,251929,422,251929,2932,3,85284,73,271,0.999698418682169,0.9868616398271722,0.9991124709509407,0.9932385548248727,0.9899388115477804,251929,76,85555,3354
12,6,vg giraffe,High,125,0.8,236685,390,236685,3060,3,80294,69,261,0.9996958907233999,0.9856330813917171,0.9991069988961514,0.9926146800533454,0.9890198963717647,236685,72,80555,3450
12,6,SAFARI,High,125,0.8,237004,391,237004,2740,3,80294,70,260,0.9996920831628543,0.986961500822454,0.9990945961030424,0.9932860028666506,0.9900112856261029,237004,73,80554,3131
12,6,vg giraffe,High,125,0.95,281072,462,281072,3630,3,95212,78,301,0.9997119006377311,0.9856503625983645,0.9991526664853443,0.9926313354534652,0.9890402828043009,281072,81,95513,4092
12,6,SAFARI,High,125,0.95,281428,464,281428,3272,3,95212,79,300,0.9997087137224255,0.9868987670252907,0.9991422055777559,0.9932624401331277,0.9899726335362619,281428,82,95512,3736
12,6,vg giraffe,High,125,0.9,266274,446,266274,3443,3,90232,74,286,0.9997109077870929,0.9856049866191892,0.9991500634692864,0.9926078350238764,0.9890064807987626,266274,77,90518,3889
12,6,SAFARI,High,125,0.9,266611,448,266611,3104,3,90232,75,285,0.9997075244948236,0.9868523817103008,0.9991390253325239,0.993238359920425,0.9899378530760232,266611,78,90517,3552
12,6,vg giraffe,Mid,125,0.15,44830,60,44830,8,2,14954,20,40,0.9995094979042183,0.9984854559223127,0.9985348961108151,0.9989972144846796,0.99849784691391,44830,22,14994,68
12,6,SAFARI,Mid,125,0.15,44829,61,44829,8,2,14954,20,40,0.9995094869679606,0.998463183215288,0.9985348961108151,0.9989860611260292,0.9984811563240645,44829,22,14994,69
12,6,vg giraffe,Mid,125,0.1,29877,44,29877,4,0,10014,16,20,0.9994647576355669,0.9983959899749374,0.998407960199005,0.9989300879333979,0.9983989993746091,29877,16,10034,48
12,6,SAFARI,Mid,125,0.1,29877,44,29877,4,0,10014,16,20,0.9994647576355669,0.9983959899749374,0.998407960199005,0.9989300879333979,0.9983989993746091,29877,16,10034,48
12,6,vg giraffe,Mid,125,0.25,74768,104,74768,9,3,24983,39,72,0.99943857773025,0.9984909389564776,0.9983264932063594,0.9989645336058948,0.9984496589249635,74768,42,25055,113
12,6,SAFARI,Mid,125,0.25,74767,105,74767,9,3,24983,39,72,0.9994385702255076,0.9984775844339686,0.9983264932063594,0.998957846215512,0.9984396567244794,74767,42,25055,114
12,6,vg giraffe,Mid,125,0.2,59812,81,59812,8,2,19908,28,52,0.9994986798569566,0.9985142151216173,0.9984992496248124,0.9990062049556132,0.9985104705160781,59812,30,19960,89
12,6,SAFARI,Mid,125,0.2,59811,82,59811,8,2,19908,28,52,0.9994986714794205,0.9984975209095007,0.9984992496248124,0.9989978453675402,0.9984979534615914,59811,30,19960,90
12,6,vg giraffe,Mid,125,0.35,104617,159,104617,11,4,35006,42,97,0.9995604941574386,0.9983776613511218,0.9986912856695781,0.998968727619957,0.9984564372284472,104617,46,35103,170
12,6,SAFARI,Mid,125,0.35,104616,160,104616,11,4,35006,42,97,0.999560489958151,0.998368118182599,0.9986912856695781,0.9989639482642552,0.9984492911045049,104616,46,35103,171
12,6,vg giraffe,Mid,125,0.3,89514,134,89514,9,3,29882,41,88,0.9995086982737443,0.9984050325127988,0.9985340174585193,0.998956560555757,0.9984373824903277,89514,44,29970,143
12,6,SAFARI,Mid,125,0.3,89513,135,89513,9,3,29882,41,88,0.9995086927878335,0.9983938788940072,0.9985340174585193,0.9989509748122357,0.9984290262469604,89513,44,29970,144
12,6,vg giraffe,Mid,125,0.45,134922,209,134922,13,5,45252,50,134,0.9995925231706142,0.9983573077606109,0.9987896393125151,0.9989745336349265,0.9984660962981422,134922,55,45386,222
12,6,SAFARI,Mid,125,0.45,134921,210,134921,13,5,45252,50,134,0.9995925201517307,0.9983499082460191,0.9987896393125151,0.9989708277802459,0.9984605587396517,134921,55,45386,223
12,6,vg giraffe,Mid,125,0.4,119582,179,119582,12,5,40037,46,112,0.9995736962209424,0.9984053167241365,0.998731343283582,0.9989891648496696,0.9984872447225469,119582,51,40149,191
12,6,SAFARI,Mid,125,0.4,119581,180,119581,12,5,40037,46,112,0.999573692657483,0.9983969675970378,0.998731343283582,0.9989849836051878,0.9984809936676814,119581,51,40149,192
12,6,vg giraffe,Mid,125,0.55,164933,254,164933,17,5,55335,58,161,0.9996181725617591,0.9983596038836832,0.9988660703036412,0.9989884918231375,0.9984870653143869,164933,63,55496,271
12,6,SAFARI,Mid,125,0.55,164932,255,164932,17,5,55335,58,161,0.9996181702475833,0.9983535507614828,0.9988660703036412,0.9989854602830415,0.9984825355698193,164932,63,55496,272
12,6,vg giraffe,Mid,125,0.5,150012,234,150012,14,5,50378,55,144,0.9996001919078842,0.9983495274856915,0.9988138072832233,0.998974468255131,0.9984664562193166,150012,60,50522,248
12,6,SAFARI,Mid,125,0.5,150011,235,150011,14,5,50378,55,144,0.9996001892437579,0.9983428723545854,0.9988138072832233,0.9989711351808505,0.9984614771810677,150011,60,50522,249
12,6,vg giraffe,Mid,125,0.65,195103,305,195103,17,6,65456,68,203,0.9996208569657286,0.9983523090699757,0.9988742336421584,0.9989861803062965,0.9984836765482964,195103,74,65659,322
12,6,SAFARI,Mid,125,0.65,195102,306,195102,17,6,65456,69,202,0.9996157334112113,0.998347192017398,0.9988590205832687,0.998981060004813,0.9984760183490454,195102,75,65658,323
12,6,vg giraffe,Mid,125,0.6,180014,277,180014,17,6,60354,63,182,0.9996168433444579,0.9983694567074117,0.9988614800759014,0.9989927606405266,0.9984932319966129,180014,69,60536,294
12,6,SAFARI,Mid,125,0.6,180013,278,180013,17,6,60354,64,181,0.99961129034945,0.9983639106417908,0.9988449797871463,0.9989872111123751,0.9984849302445281,180013,70,60535,295
12,6,vg giraffe,Mid,125,0.75,224899,347,224899,20,7,75406,75,233,0.9996355247776479,0.9983708149476619,0.9989170771648552,0.9990027695909135,0.9985082412197205,224899,82,75639,367
12,6,SAFARI,Mid,125,0.75,224898,348,224898,20,7,75406,76,232,0.9996310799578632,0.998366375751334,0.9989038707888168,0.9989983275846368,0.9985015964144631,224898,83,75638,368
12,6,vg giraffe,Mid,125,0.7,210078,327,210078,18,6,70483,71,225,0.999633603768647,0.9983604453885745,0.998912198912199,0.9989966189386987,0.9984993314557196,210078,77,70708,345
12,6,SAFARI,Mid,125,0.7,210077,328,210077,18,6,70483,72,224,0.999628845376032,0.9983556930563674,0.9988980716253444,0.9989918635782187,0.998492219282524,210077,78,70707,346
12,6,vg giraffe,Mid,125,0.85,254856,409,254856,24,8,85279,81,265,0.9996509050971778,0.9983038830501901,0.9989606810458584,0.9989769399922388,0.9984688579792446,254856,89,85544,433
12,6,SAFARI,Mid,125,0.85,254856,410,254856,23,8,85279,82,264,0.9996469840672142,0.9983038830501901,0.9989490033048007,0.9989749821160837,0.9984659247569825,254856,90,85543,433
12,6,vg giraffe,Mid,125,0.8,239736,383,239736,22,8,80289,79,249,0.9996372324589384,0.9983134908241408,0.9989209302325581,0.998974923119234,0.9984661716017283,239736,87,80538,405
12,6,SAFARI,Mid,125,0.8,239736,384,239736,21,8,80289,80,248,0.9996330642471145,0.9983134908241408,0.9989085271317829,0.9989728417697122,0.9984630540643336,239736,88,80537,405
12,6,vg giraffe,Mid,125,0.95,284690,453,284690,26,8,95205,88,294,0.9996629047776225,0.9983202942816365,0.9989957633767457,0.9989911484239985,0.9984898782447921,284690,96,95499,479
12,6,SAFARI,Mid,125,0.95,284690,454,284690,25,8,95205,89,293,0.9996593945650609,0.9983202942816365,0.9989853025785868,0.9989893956726484,0.9984872519460873,284690,97,95498,479
12,6,vg giraffe,Mid,125,0.9,269715,427,269715,26,8,90227,83,279,0.9996627206214835,0.9983232655236741,0.9989955517290859,0.9989925440854559,0.9984920931908583,269715,91,90506,453
12,6,SAFARI,Mid,125,0.9,269715,428,269715,25,8,90227,84,278,0.9996590155185002,0.9983232655236741,0.998984513835999,0.9989906940136116,0.9984893213033416,269715,92,90505,453
12,6,vg giraffe,None,125,0.15,44827,73,44827,0,0,14958,15,43,0.9996654921725169,0.9983741648106904,0.9990010655301013,0.9990194112009985,0.9985312771213032,44827,15,15001,73
12,6,SAFARI,None,125,0.15,44827,73,44827,0,0,14958,15,43,0.9996654921725169,0.9983741648106904,0.9990010655301013,0.9990194112009985,0.9985312771213032,44827,15,15001,73
12,6,vg giraffe,None,125,0.1,29878,47,29878,0,0,10014,10,27,0.9996654175588865,0.9984294068504594,0.9990050741219779,0.9990470299098858,0.998574144486692,29878,10,10041,47
12,6,SAFARI,None,125,0.1,29878,47,29878,0,0,10014,10,27,0.9996654175588865,0.9984294068504594,0.9990050741219779,0.9990470299098858,0.998574144486692,29878,10,10041,47
12,6,vg giraffe,None,125,0.25,74769,114,74769,0,0,24988,35,79,0.9995321105823218,0.9984776250951485,0.9986056887897379,0.9990045895769173,0.99850977646647,74769,35,25067,114
12,6,SAFARI,None,125,0.25,74769,114,74769,0,0,24988,35,79,0.9995321105823218,0.9984776250951485,0.9986056887897379,0.9990045895769173,0.99850977646647,74769,35,25067,114
12,6,vg giraffe,None,125,0.2,59811,92,59811,0,0,19912,23,59,0.999615603168767,0.9984641837637513,0.9988496548964689,0.9990395617060724,0.9985606468327972,59811,23,19971,92
12,6,SAFARI,None,125,0.2,59811,92,59811,0,0,19912,23,59,0.999615603168767,0.9984641837637513,0.9988496548964689,0.9990395617060724,0.9985606468327972,59811,23,19971,92
12,6,vg giraffe,None,125,0.35,104628,158,104628,0,2,35010,40,109,0.9995987388936658,0.9984921649838719,0.9988054947242684,0.9990451455198229,0.9985708875502869,104628,42,35119,158
12,6,SAFARI,None,125,0.35,104628,158,104628,0,2,35010,40,109,0.9995987388936658,0.9984921649838719,0.9988054947242684,0.9990451455198229,0.9985708875502869,104628,42,35119,158
12,6,vg giraffe,None,125,0.3,89521,136,89521,0,1,29886,39,96,0.9995533770279474,0.9984831078443401,0.9986676437279328,0.9990179557856912,0.9985293994769341,89521,40,29982,136
12,6,SAFARI,None,125,0.3,89521,136,89521,0,1,29886,39,96,0.9995533770279474,0.9984831078443401,0.9986676437279328,0.9990179557856912,0.9985293994769341,89521,40,29982,136
12,6,vg giraffe,None,125,0.45,134935,208,134935,0,5,45252,47,148,0.9996147777193359,0.9984608895762267,0.9988559359324122,0.9990375004627402,0.9985603145159058,134935,52,45400,208
12,6,SAFARI,None,125,0.45,134935,208,134935,0,5,45252,47,148,0.9996147777193359,0.9984608895762267,0.9988559359324122,0.9990375004627402,0.9985603145159058,134935,52,45400,208
12,6,vg giraffe,None,125,0.4,119590,182,119590,0,3,40041,44,123,0.9996071449467974,0.9984804461810773,0.9988311656014524,0.9990434778976564,0.9985685979135284,119590,47,40164,182
12,6,SAFARI,None,125,0.4,119590,182,119590,0,3,40041,44,123,0.9996071449467974,0.9984804461810773,0.9988311656014524,0.9990434778976564,0.9985685979135284,119590,47,40164,182
12,6,vg giraffe,None,125,0.55,164947,256,164947,0,5,55335,56,170,0.9996303209541355,0.9984503913367191,0.9989022063851996,0.9990400077526188,0.9985641099973275,164947,61,55505,256
12,6,SAFARI,None,125,0.55,164947,256,164947,0,5,55335,56,170,0.9996303209541355,0.9984503913367191,0.9989022063851996,0.9990400077526188,0.9985641099973275,164947,61,55505,256
12,6,vg giraffe,None,125,0.5,150025,234,150025,0,5,50378,52,156,0.9996202076198345,0.9984426889570674,0.9988733173884683,0.9990311013148387,0.9985511575802838,150025,57,50534,234
12,6,SAFARI,None,125,0.5,150025,234,150025,0,5,50378,52,156,0.9996202076198345,0.9984426889570674,0.9988733173884683,0.9990311013148387,0.9985511575802838,150025,57,50534,234
12,6,vg giraffe,None,125,0.65,195117,310,195117,0,5,65459,65,206,0.9996413695584234,0.9984137299349629,0.9989351182779341,0.9990271726051805,0.9985449644282093,195117,70,65665,310
12,6,SAFARI,None,125,0.65,195117,310,195117,0,5,65459,65,206,0.9996413695584234,0.9984137299349629,0.9989351182779341,0.9990271726051805,0.9985449644282093,195117,70,65665,310
12,6,vg giraffe,None,125,0.6,180021,286,180021,0,5,60355,59,190,0.9996446122664298,0.998413816435302,0.9989440512135161,0.9990288352682635,0.9985472114761992,180021,64,60545,286
12,6,SAFARI,None,125,0.6,180021,286,180021,0,5,60355,59,190,0.9996446122664298,0.998413816435302,0.9989440512135161,0.9990288352682635,0.9985472114761992,180021,64,60545,286
12,6,vg giraffe,None,125,0.75,224915,357,224915,0,5,75410,71,236,0.9996622087105707,0.9984152491210625,0.9989963286759462,0.9990383398147306,0.9985614331182682,224915,76,75646,357
12,6,SAFARI,None,125,0.75,224915,357,224915,0,5,75410,71,236,0.9996622087105707,0.9984152491210625,0.9989963286759462,0.9990383398147306,0.9985614331182682,224915,76,75646,357
12,6,vg giraffe,None,125,0.7,210099,330,210099,0,5,70486,68,227,0.9996526654359287,0.9984317750880345,0.9989687226287683,0.9990418472614189,0.9985669327738563,210099,73,70713,330
12,6,SAFARI,None,125,0.7,210099,330,210099,0,5,70486,68,227,0.9996526654359287,0.9984317750880345,0.9989687226287683,0.9990418472614189,0.9985669327738563,210099,73,70713,330
12,6,vg giraffe,None,125,0.85,254885,410,254885,0,5,85286,83,261,0.9996548654171226,0.9983940147672301,0.9989723827874117,0.9990240422679846,0.9985392895902384,254885,88,85547,410
12,6,SAFARI,None,125,0.85,254885,410,254885,0,5,85286,83,261,0.9996548654171226,0.9983940147672301,0.9989723827874117,0.9990240422679846,0.9985392895902384,254885,88,85547,410
12,6,vg giraffe,None,125,0.8,239763,384,239763,0,5,80294,78,252,0.999653944614461,0.9984009794001174,0.9989705937069788,0.9990270691447584,0.9985441554230989,239763,83,80546,384
12,6,SAFARI,None,125,0.8,239763,384,239763,0,5,80294,78,252,0.999653944614461,0.9984009794001174,0.9989705937069788,0.9990270691447584,0.9985441554230989,239763,83,80546,384
12,6,vg giraffe,None,125,0.95,284713,461,284713,0,6,95212,91,288,0.9996594220708542,0.9983834430908849,0.9989853238072325,0.9990210251515833,0.9985345522636966,284713,97,95500,461
12,6,SAFARI,None,125,0.95,284713,461,284713,0,6,95212,91,288,0.9996594220708542,0.9983834430908849,0.9989853238072325,0.9990210251515833,0.9985345522636966,284713,97,95500,461
12,6,vg giraffe,None,125,0.9,269733,440,269733,0,5,90233,86,274,0.9996627431214421,0.9983714138718525,0.9989955628159563,0.9990166612036735,0.9985281522073559,269733,91,90507,440
12,6,SAFARI,None,125,0.9,269733,440,269733,0,5,90233,86,274,0.9996627431214421,0.9983714138718525,0.9989955628159563,0.9990166612036735,0.9985281522073559,269733,91,90507,440
12,6,vg giraffe,Single-stranded,125,0.15,44833,67,44833,0,0,14958,17,40,0.9996209587513936,0.9985077951002227,0.9988677988677989,0.9990640668523678,0.9985980138529583,44833,17,14998,67
12,6,SAFARI,Single-stranded,125,0.15,44833,67,44833,0,0,14958,17,40,0.9996209587513936,0.9985077951002227,0.9988677988677989,0.9990640668523678,0.9985980138529583,44833,17,14998,67
12,6,vg giraffe,Single-stranded,125,0.1,29883,42,29883,0,0,10014,11,19,0.9996320331839165,0.9985964912280701,0.9989048187972919,0.9991139938815427,0.9986739723285546,29883,11,10033,42
12,6,SAFARI,Single-stranded,125,0.1,29883,42,29883,0,0,10014,11,19,0.9996320331839165,0.9985964912280701,0.9989048187972919,0.9991139938815427,0.9986739723285546,29883,11,10033,42
12,6,vg giraffe,Single-stranded,125,0.25,74761,121,74761,0,0,24987,35,75,0.9995320605379967,0.9983841243556529,0.9986054110052994,0.9989577626638517,0.9984396723311896,74761,35,25062,121
12,6,SAFARI,Single-stranded,125,0.25,74761,121,74761,0,0,24987,35,75,0.9995320605379967,0.9983841243556529,0.9986054110052994,0.9989577626638517,0.9984396723311896,74761,35,25062,121
12,6,vg giraffe,Single-stranded,125,0.2,59804,99,59804,0,0,19911,24,52,0.9995988500367721,0.9983473281805586,0.9987992194926703,0.9989726971293984,0.9984603830266616,59804,24,19963,99
12,6,SAFARI,Single-stranded,125,0.2,59804,99,59804,0,0,19911,24,52,0.9995988500367721,0.9983473281805586,0.9987992194926703,0.9989726971293984,0.9984603830266616,59804,24,19963,99
12,6,vg giraffe,Single-stranded,125,0.35,104621,164,104621,0,2,35008,40,98,0.9995987120567918,0.9984348904900511,0.9988050529190851,0.999016462320003,0.9985278669077344,104621,42,35106,164
12,6,SAFARI,Single-stranded,125,0.35,104621,164,104621,0,2,35008,40,98,0.9995987120567918,0.9984348904900511,0.9988050529190851,0.999016462320003,0.9985278669077344,104621,42,35106,164
12,6,vg giraffe,Single-stranded,125,0.3,89516,140,89516,0,1,29884,39,87,0.9995533520925455,0.9984384759525297,0.998667155376362,0.9989956029730153,0.9984958259169194,89516,40,29971,140
12,6,SAFARI,Single-stranded,125,0.3,89516,140,89516,0,1,29884,39,87,0.9995533520925455,0.9984384759525297,0.998667155376362,0.9989956029730153,0.9984958259169194,89516,40,29971,140
12,6,vg giraffe,Single-stranded,125,0.45,134929,217,134929,0,3,45252,46,135,0.9996369778778764,0.9983943290959407,0.9989215599964786,0.9990152670625343,0.9985269849708166,134929,49,45387,217
12,6,SAFARI,Single-stranded,125,0.45,134929,217,134929,0,3,45252,46,135,0.9996369778778764,0.9983943290959407,0.9989215599964786,0.9990152670625343,0.9985269849708166,134929,49,45387,217
12,6,vg giraffe,Single-stranded,125,0.4,119584,191,119584,0,3,40039,43,114,0.9996154810666221,0.9984053433521185,0.9988556929276847,0.999010045738393,0.9985185092577544,119584,46,40153,191
12,6,SAFARI,Single-stranded,125,0.4,119584,191,119584,0,3,40039,43,114,0.9996154810666221,0.9984053433521185,0.9988556929276847,0.999010045738393,0.9985185092577544,119584,46,40153,191
12,6,vg giraffe,Single-stranded,125,0.55,164947,258,164947,0,3,55336,56,158,0.9996424372447063,0.998438303925426,0.9989379511457527,0.9990400077526187,0.9985640384493427,164947,59,55494,258
12,6,SAFARI,Single-stranded,125,0.55,164947,258,164947,0,3,55336,56,158,0.9996424372447063,0.998438303925426,0.9989379511457527,0.9990400077526187,0.9985640384493427,164947,59,55494,258
12,6,vg giraffe,Single-stranded,125,0.5,150022,239,150022,0,3,50378,51,148,0.9996401823076309,0.9984094342510698,0.998932384341637,0.9990244292245045,0.9985411345293043,150022,54,50526,239
12,6,SAFARI,Single-stranded,125,0.5,150022,239,150022,0,3,50378,51,148,0.9996401823076309,0.9984094342510698,0.998932384341637,0.9990244292245045,0.9985411345293043,150022,54,50526,239
12,6,vg giraffe,Single-stranded,125,0.65,195131,300,195131,0,3,65460,68,199,0.9996362742185019,0.9984649313568472,0.9989198235204625,0.9990502594506865,0.9985794203575572,195131,71,65659,300
12,6,SAFARI,Single-stranded,125,0.65,195131,300,195131,0,3,65460,68,199,0.9996362742185019,0.9984649313568472,0.9989198235204625,0.9990502594506865,0.9985794203575572,195131,71,65659,300
12,6,vg giraffe,Single-stranded,125,0.6,180033,276,180033,0,3,60356,63,181,0.9996335348891443,0.9984692943779845,0.9989109450027226,0.9990510754478259,0.9985803945008966,180033,66,60537,276
12,6,SAFARI,Single-stranded,125,0.6,180033,276,180033,0,3,60356,63,181,0.9996335348891443,0.9984692943779845,0.9989109450027226,0.9990510754478259,0.9985803945008966,180033,66,60537,276
12,6,vg giraffe,Single-stranded,125,0.75,224919,357,224919,0,4,75410,78,231,0.9996355571753014,0.9984152772598945,0.998917105767072,0.9990250445836674,0.9985415233937655,224919,82,75641,357
12,6,SAFARI,Single-stranded,125,0.75,224919,357,224919,0,4,75410,78,231,0.9996355571753014,0.9984152772598945,0.998917105767072,0.9990250445836674,0.9985415233937655,224919,82,75641,357
12,6,vg giraffe,Single-stranded,125,0.7,210098,335,210098,0,3,70487,73,220,0.9996383948537878,0.9984080443656651,0.9989262958620008,0.9990228407991308,0.998538489986345,210098,76,70707,335
12,6,SAFARI,Single-stranded,125,0.7,210098,335,210098,0,3,70487,73,220,0.9996383948537878,0.9984080443656651,0.9989262958620008,0.9990228407991308,0.998538489986345,210098,76,70707,335
12,6,vg giraffe,Single-stranded,125,0.85,254891,407,254891,0,5,85287,87,260,0.9996391916323834,0.9984057846124921,0.9989257230934504,0.9990221074270844,0.9985363864878262,254891,92,85547,407
12,6,SAFARI,Single-stranded,125,0.85,254891,407,254891,0,5,85287,87,260,0.9996391916323834,0.9984057846124921,0.9989257230934504,0.9990221074270844,0.9985363864878262,254891,92,85547,407
12,6,vg giraffe,Single-stranded,125,0.8,239768,383,239768,0,5,80295,83,247,0.999633113201254,0.998405170080491,0.9989085948158254,0.9990187643096872,0.998531708548823,239768,88,80542,383
12,6,SAFARI,Single-stranded,125,0.8,239768,383,239768,0,5,80295,83,247,0.999633113201254,0.998405170080491,0.9989085948158254,0.9990187643096872,0.998531708548823,239768,88,80542,383
12,6,vg giraffe,Single-stranded,125,0.95,284720,457,284720,0,6,95213,92,295,0.9996559206229944,0.9983974864733131,0.9989749597305608,0.9990263072483092,0.9985424769488134,284720,98,95508,457
12,6,SAFARI,Single-stranded,125,0.95,284720,457,284720,0,6,95213,92,295,0.9996559206229944,0.9983974864733131,0.9989749597305608,0.9990263072483092,0.9985424769488134,284720,98,95508,457
12,6,vg giraffe,Single-stranded,125,0.9,269747,429,269747,0,5,90234,89,275,0.9996516467104702,0.9984121461565794,0.9989625067602618,0.9990315119709194,0.9985503590840931,269747,94,90509,429
12,6,SAFARI,Single-stranded,125,0.9,269747,429,269747,0,5,90234,89,275,0.9996516467104702,0.9984121461565794,0.9989625067602618,0.9990315119709194,0.9985503590840931,269747,94,90509,429
15,10,vg giraffe,High,125,0.15,41367,65,41367,3464,0,14956,9,49,0.9997824825986079,0.9213961154668567,0.9994005594778207,0.9589901706231455,0.9409447504590218,41367,9,15005,3529
15,10,SAFARI,High,125,0.15,41440,65,41440,3391,0,14956,9,49,0.9997828656903665,0.9230220955096222,0.9994005594778207,0.959870287798946,0.942163244867301,41440,9,15005,3456
15,10,vg giraffe,High,125,0.1,27541,42,27541,2340,0,10014,8,29,0.9997096083342408,0.9203956822511112,0.9992040592975824,0.9584145322939867,0.9402111372392055,27541,8,10043,2382
15,10,SAFARI,High,125,0.1,27586,42,27586,2295,0,10014,8,29,0.9997100819018627,0.921899542158206,0.9992040592975824,0.9592294452075039,0.9413368689648272,27586,8,10043,2337
15,10,vg giraffe,High,125,0.25,68913,112,68913,5855,0,24986,19,95,0.9997243660418964,0.9203125,0.9992430278884462,0.9583762133897032,0.940128025605121,68913,19,25081,5967
15,10,SAFARI,High,125,0.25,69021,112,69021,5747,0,24986,19,95,0.9997247972190034,0.9217548076923077,0.9992430278884462,0.9591578654808227,0.9412082416483296,69021,19,25081,5859
15,10,vg giraffe,High,125,0.2,55170,85,55170,4645,0,19910,13,69,0.9997644202018737,0.9210350584307179,0.9993497398959584,0.9587862673027294,0.9406323536774646,55170,13,19979,4730
15,10,SAFARI,High,125,0.2,55260,85,55260,4555,0,19910,13,69,0.9997648037920865,0.9225375626043406,0.9993497398959584,0.9595999062280222,0.9417588744805487,55260,13,19979,4640
15,10,vg giraffe,High,125,0.35,96446,164,96446,8176,0,35010,22,127,0.9997719451009661,0.9204092149714657,0.9993742711681219,0.9584505152692618,0.9402479545535746,96446,22,35137,8340
15,10,SAFARI,High,125,0.35,96603,164,96603,8019,0,35010,22,127,0.9997723156532988,0.921907506727998,0.9993742711681219,0.959262403741603,0.9413698238593733,96603,22,35137,8183
15,10,vg giraffe,High,125,0.3,82480,132,82480,7044,0,29885,21,114,0.9997454576308166,0.9199607388239494,0.9993004663557629,0.9581951358353131,0.9398626290985661,82480,21,29999,7176
15,10,SAFARI,High,125,0.3,82621,132,82621,6903,0,29885,21,114,0.999745891919363,0.9215334166146159,0.9993004663557629,0.9590476964329243,0.9410408101875063,82621,21,29999,7035
15,10,vg giraffe,High,125,0.45,124279,206,124279,10660,0,45255,27,168,0.9997827940726915,0.919597469384735,0.9994059405940594,0.9580151936203755,0.9396827154683131,124279,27,45423,10866
15,10,SAFARI,High,125,0.45,124479,206,124479,10460,0,45255,27,168,0.9997831429810612,0.9210773613526213,0.9994059405940594,0.958817797736192,0.9407901658406933,124479,27,45423,10666
15,10,vg giraffe,High,125,0.4,110185,181,110185,9407,0,40042,25,142,0.9997731603302785,0.9199485693770716,0.9993782486507996,0.9582012583538784,0.9399119900988862,110185,25,40184,9588
15,10,SAFARI,High,125,0.4,110370,181,110370,9222,0,40042,25,142,0.9997735404683183,0.9214931578903426,0.9993782486507996,0.9590386152723228,0.9410683701916466,110370,25,40184,9403
15,10,vg giraffe,High,125,0.55,151893,249,151893,13062,0,55338,31,195,0.9997959506068824,0.9194268903900632,0.9994420848031099,0.957928659720996,0.9395655167415567,151893,31,55533,13311
15,10,SAFARI,High,125,0.55,152147,249,152147,12808,0,55338,31,195,0.9997962911853224,0.9209643834289727,0.9994420848031099,0.9587626267400168,0.9407160458037397,152147,31,55533,13057
15,10,vg giraffe,High,125,0.5,138177,223,138177,11862,0,50381,30,178,0.9997829342942108,0.9195738110766528,0.9994069857083556,0.9580024196707444,0.9396816545598479,138177,30,50559,12085
15,10,SAFARI,High,125,0.5,138405,223,138405,11634,0,50381,30,178,0.9997832917975945,0.9210911607725173,0.9994069857083556,0.9588253428334897,0.9408168244121264,138405,30,50559,11857
15,10,vg giraffe,High,125,0.65,179665,291,179665,15465,0,65462,36,235,0.9997996672250016,0.919374069317013,0.999452329879969,0.957901695981574,0.9395299325302312,179665,36,65697,15756
15,10,SAFARI,High,125,0.65,179969,291,179969,15161,0,65462,36,235,0.9998000055554013,0.9209296851413104,0.999452329879969,0.9587455317426071,0.9406939966456573,179969,36,65697,15452
15,10,vg giraffe,High,125,0.6,165769,271,165769,14266,0,60358,34,215,0.9997949373654277,0.9193759497742726,0.9994390086953652,0.9579005457818202,0.9395175851863535,165769,34,60573,14537
15,10,SAFARI,High,125,0.6,166050,271,166050,13985,0,60358,34,215,0.9997952843139616,0.9209344115004492,0.9994390086953652,0.9587459222263922,0.9406839813542648,166050,34,60573,14256
15,10,vg giraffe,High,125,0.75,207010,338,207010,17912,0,75413,38,269,0.9998164676789923,0.9189825091005949,0.9994981510829372,0.9576968272620446,0.93923848760715,207010,38,75682,18250
15,10,SAFARI,High,125,0.75,207367,338,207367,17555,0,75413,38,269,0.9998167835876667,0.9205673444020244,0.9994981510829372,0.9585568511434943,0.9404246129310918,207367,38,75682,17893
15,10,vg giraffe,High,125,0.7,193375,316,193375,16726,0,70489,38,257,0.9998035292353668,0.9190084451351365,0.9994631555153707,0.9577049748656613,0.9392605289454874,193375,38,70746,17042
15,10,SAFARI,High,125,0.7,193705,316,193705,16396,0,70489,38,257,0.9998038638815337,0.9205767594823612,0.9994631555153707,0.958556017418844,0.9404340667351823,193705,38,70746,16712
15,10,vg giraffe,High,125,0.85,234624,391,234624,20268,0,85287,44,300,0.9998125010653348,0.9190741255782798,0.9994861673926498,0.9577447540672435,0.9392720744821275,234624,44,85587,20659
15,10,SAFARI,High,125,0.85,235034,391,235034,19858,0,85287,44,300,0.9998128280825939,0.920680186303044,0.9994861673926498,0.9586162031646073,0.9404747238306435,235034,44,85587,20249
15,10,vg giraffe,High,125,0.8,220721,361,220721,19053,0,80297,42,288,0.9998097507281565,0.9191538093155933,0.9994790826894216,0.9577867554209392,0.9393444360616282,220721,42,80585,19414
15,10,SAFARI,High,125,0.8,221107,361,221107,18667,0,80297,42,288,0.9998100827948577,0.9207612384700272,0.9994790826894216,0.9586588739258244,0.9405478205024286,221107,42,80585,19028
15,10,vg giraffe,High,125,0.95,262024,430,262024,22710,0,95215,48,331,0.9998168442260142,0.9188537122497931,0.9994978764357596,0.9576270566994861,0.9391004259923627,262024,48,95546,23140
15,10,SAFARI,High,125,0.95,262498,430,262498,22236,0,95215,48,331,0.999817174895066,0.9205159136496893,0.9994978764357596,0.9585291486370525,0.9403453111950373,262498,48,95546,22666
15,10,vg giraffe,High,125,0.9,248314,414,248314,21435,0,90235,45,315,0.9998188106732593,0.919126601348075,0.9995032838456869,0.9577761406459128,0.9393111171477833,248314,45,90550,21849
15,10,SAFARI,High,125,0.9,248752,414,248752,20997,0,90235,45,315,0.9998191296518849,0.9207478448196089,0.9995032838456869,0.9586557730846309,0.9405252274377838,248752,45,90550,21411
15,10,vg giraffe,Mid,125,0.15,44651,60,44651,187,0,14956,11,49,0.9997537056110339,0.9944986413648715,0.9992674480554076,0.9971192496650291,0.9956938278198751,44651,11,15005,247
15,10,SAFARI,Mid,125,0.15,44653,60,44653,185,0,14956,11,49,0.9997537166397994,0.9945431867789211,0.9992674480554076,0.9971416448940399,0.995727208999566,44653,11,15005,245
15,10,vg giraffe,Mid,125,0.1,29759,44,29759,122,0,10014,8,28,0.999731246010683,0.994452798663325,0.9992039800995025,0.9970850365208068,0.9956472795497185,29759,8,10042,166
15,10,SAFARI,Mid,125,0.1,29760,44,29760,121,0,10014,8,28,0.999731255038968,0.9944862155388471,0.9992039800995025,0.997101837736418,0.9956722951844903,29760,8,10042,165
15,10,vg giraffe,Mid,125,0.25,74458,102,74458,321,0,24986,22,89,0.999704618689581,0.9943510369786728,0.9991234012033311,0.9970206412651228,0.9955490207845726,74458,22,25075,423
15,10,SAFARI,Mid,125,0.25,74462,102,74462,317,0,24986,22,89,0.9997046345523871,0.994404455068709,0.9991234012033311,0.9970475010879388,0.9955890295865091,74462,22,25075,419
15,10,vg giraffe,Mid,125,0.2,59567,80,59567,254,0,19910,16,64,0.9997314670291861,0.9944241331530358,0.9991995997998999,0.9970707375046032,0.9956190309296417,59567,16,19974,334
15,10,SAFARI,Mid,125,0.2,59570,80,59570,251,0,19910,16,64,0.9997314805491223,0.9944742157893858,0.9991995997998999,0.9970959183844267,0.9956565820931018,59570,16,19974,331
15,10,vg giraffe,Mid,125,0.35,104179,156,104179,452,1,35009,25,114,0.9997504918190107,0.9941977535381298,0.9992602919001963,0.996966391058031,0.9954693574205351,104179,26,35123,608
15,10,SAFARI,Mid,125,0.35,104185,156,104185,446,1,35009,25,114,0.9997505061845678,0.9942550125492666,0.9992602919001963,0.9969951865568092,0.9955122341641893,104185,26,35123,602
15,10,vg giraffe,Mid,125,0.3,89135,131,89135,391,0,29885,24,105,0.9997308179768728,0.994177810990776,0.9992003731591924,0.9969465819613457,0.9954374911214914,89135,24,29990,522
15,10,SAFARI,Mid,125,0.3,89139,131,89139,387,0,29885,24,105,0.9997308300528246,0.9942224254659424,0.9992003731591924,0.9969690191253775,0.9954709160949603,89139,24,29990,518
15,10,vg giraffe,Mid,125,0.45,134372,203,134372,569,2,45255,31,153,0.9997544734198877,0.9942875747350973,0.9992737835875091,0.9970135300075311,0.9955422654151784,134372,33,45408,772
15,10,SAFARI,Mid,125,0.45,134378,203,134378,563,2,45255,31,153,0.9997544843799987,0.9943319718226484,0.9992737835875091,0.9970358553912931,0.9955754907661212,134378,33,45408,766
15,10,vg giraffe,Mid,125,0.4,119081,175,119081,517,2,40040,27,131,0.9997565275795484,0.9942224040476568,0.9992786069651741,0.9969817860626332,0.9954929894419683,119081,29,40171,692
15,10,SAFARI,Mid,125,0.4,119087,175,119087,511,2,40040,27,131,0.9997565398435139,0.9942724988102494,0.9992786069651741,0.9970069781362892,0.9955304957711614,119087,29,40171,686
15,10,vg giraffe,Mid,125,0.55,164263,247,164263,694,2,55338,37,182,0.9997626322260228,0.9943040120093944,0.9992980435213017,0.997025850819105,0.9955608503236503,164263,39,55520,941
15,10,SAFARI,Mid,125,0.55,164270,247,164270,687,2,55338,37,182,0.9997626423385207,0.9943463838647975,0.9992980435213017,0.9970471574717842,0.9955925585356242,164270,39,55520,934
15,10,vg giraffe,Mid,125,0.5,149406,227,149406,627,2,50381,36,163,0.9997457241508525,0.9943165180354053,0.9992487446127081,0.9970237300803461,0.9955586978819171,149406,38,50544,854
15,10,SAFARI,Mid,125,0.5,149412,227,149412,621,2,50381,36,163,0.9997457343593175,0.9943564488220418,0.9992487446127081,0.9970438090153815,0.9955885721114109,149412,38,50544,848
15,10,vg giraffe,Mid,125,0.65,194332,294,194332,799,2,65460,43,228,0.9997684911280655,0.9944070615325572,0.9993154123499612,0.9970805691094452,0.995642484626165,194332,45,65688,1093
15,10,SAFARI,Mid,125,0.65,194340,294,194340,791,2,65460,43,228,0.9997685006559148,0.994447997953179,0.9993154123499612,0.9971011518432057,0.9956731174231691,194340,45,65688,1085
15,10,vg giraffe,Mid,125,0.6,179292,268,179292,748,2,60358,40,205,0.9997658001271371,0.9943651973290148,0.9993069878722878,0.9970581856401644,0.9956083731471527,179292,42,60563,1016
15,10,SAFARI,Mid,125,0.6,179300,268,179300,740,2,60358,40,205,0.9997658105742102,0.9944095658539832,0.9993069878722878,0.9970804949256221,0.9956415801554919,179300,42,60563,1008
15,10,vg giraffe,Mid,125,0.75,224009,336,224009,921,2,75411,47,261,0.9997813066259629,0.9944199302158337,0.9993528875741208,0.9970934114358458,0.9956609421669375,224009,49,75672,1257
15,10,SAFARI,Mid,125,0.75,224018,336,224018,912,2,75411,47,261,0.9997813154101228,0.9944598829827848,0.9993528875741208,0.9971134993423585,0.9956908437905956,224018,49,75672,1248
15,10,vg giraffe,Mid,125,0.7,209257,316,209257,850,2,70487,46,250,0.9997706695969996,0.9944587806466023,0.9993218902309812,0.9971076506690046,0.9956829108702455,209257,48,70737,1166
15,10,SAFARI,Mid,125,0.7,209266,316,209266,841,2,70487,46,250,0.999770679457657,0.9945015516364656,0.9993218902309812,0.9971291546849576,0.9957149156496259,209266,48,70737,1157
15,10,vg giraffe,Mid,125,0.85,253845,398,253845,1046,3,85284,52,294,0.9997833792831824,0.994343665414491,0.9993577242418227,0.9970561029401658,0.9956030998292865,253845,55,85578,1444
15,10,SAFARI,Mid,125,0.85,253855,398,253855,1036,3,85284,52,294,0.99978338781458,0.9943828367066344,0.9993577242418227,0.9970757994418685,0.9956324320519063,253855,55,85578,1434
15,10,vg giraffe,Mid,125,0.8,238795,372,238795,974,3,80294,50,278,0.9997781015541265,0.9943949596278853,0.9993426356589147,0.9970792648682955,0.9956385651845894,238795,53,80572,1346
15,10,SAFARI,Mid,125,0.8,238804,372,238804,965,3,80294,50,278,0.9997781099151375,0.994432437609571,0.9993426356589147,0.9970981089691398,0.9956666230211432,238804,53,80572,1337
15,10,vg giraffe,Mid,125,0.95,283563,442,283563,1164,3,95210,57,325,0.9997884515712759,0.9943682518085767,0.999372352110466,0.9970709855272226,0.995624586357954,283563,60,95535,1606
15,10,SAFARI,Mid,125,0.95,283574,442,283574,1153,3,95210,57,325,0.9997884597756264,0.9944068254263262,0.999372352110466,0.9970903810282294,0.9956534756437058,283574,60,95535,1595
15,10,vg giraffe,Mid,125,0.9,268648,416,268648,1104,3,90232,53,309,0.9997915922353221,0.9943738710728139,0.9993818779871299,0.9970753722590893,0.995631505273516,268648,56,90541,1520
15,10,SAFARI,Mid,125,0.9,268658,416,268658,1094,3,90232,53,309,0.9997915999910686,0.9944108850789138,0.9993818779871299,0.9970939834694794,0.995659224148684,268658,56,90541,1510
15,10,vg giraffe,None,125,0.15,44821,72,44821,7,0,14958,10,48,0.9997769400637951,0.9982405345211581,0.9993340436867342,0.999008146571419,0.9985145870885906,44821,10,15006,79
15,10,SAFARI,None,125,0.15,44821,72,44821,7,0,14958,10,48,0.9997769400637951,0.9982405345211581,0.9993340436867342,0.999008146571419,0.9985145870885906,44821,10,15006,79
15,10,vg giraffe,None,125,0.1,29873,46,29873,6,0,10014,7,30,0.9997657295850066,0.9982623224728487,0.9993035518853846,0.9990134604130089,0.9985241144686812,29873,7,10044,52
15,10,SAFARI,None,125,0.1,29873,46,29873,6,0,10014,7,30,0.9997657295850066,0.9982623224728487,0.9993035518853846,0.9990134604130089,0.9985241144686812,29873,7,10044,52
15,10,vg giraffe,None,125,0.25,74760,111,74760,12,0,24988,21,93,0.9997191800056164,0.9983574376026602,0.9991634132738427,0.9990378447722899,0.9985597839675951,74760,21,25081,123
15,10,SAFARI,None,125,0.25,74760,111,74760,12,0,24988,21,93,0.9997191800056164,0.9983574376026602,0.9991634132738427,0.9990378447722899,0.9985597839675951,74760,21,25081,123
15,10,vg giraffe,None,125,0.2,59803,91,59803,9,0,19912,15,67,0.9997492393593902,0.9983306345258167,0.9992497749324798,0.9990394333492035,0.9985606468327972,59803,15,19979,100
15,10,SAFARI,None,125,0.2,59803,91,59803,9,0,19912,15,67,0.9997492393593902,0.9983306345258167,0.9992497749324798,0.9990394333492035,0.9985606468327972,59803,15,19979,100
15,10,vg giraffe,None,125,0.35,104611,154,104611,21,0,35012,25,124,0.9997610764937498,0.9983299295707442,0.9992889849549217,0.9990449904976555,0.9985708875502869,104611,25,35136,175
15,10,SAFARI,None,125,0.35,104611,154,104611,21,0,35012,25,124,0.9997610764937498,0.9983299295707442,0.9992889849549217,0.9990449904976555,0.9985708875502869,104611,25,35136,175
15,10,vg giraffe,None,125,0.3,89507,132,89507,18,0,29887,24,111,0.9997319364242553,0.9983269571812574,0.9992005862367597,0.9990289528316628,0.9985461108465145,89507,24,29998,150
15,10,SAFARI,None,125,0.3,89507,132,89507,18,0,29887,24,111,0.9997319364242553,0.9983269571812574,0.9992005862367597,0.9990289528316628,0.9985461108465145,89507,24,29998,150
15,10,vg giraffe,None,125,0.45,134911,204,134911,28,1,45256,30,165,0.9997702716722741,0.9982832999119451,0.9993179618058611,0.9990262324823667,0.99854370276032,134911,31,45421,232
15,10,SAFARI,None,125,0.45,134911,204,134911,28,1,45256,30,165,0.9997702716722741,0.9982832999119451,0.9993179618058611,0.9990262324823667,0.99854370276032,134911,31,45421,232
15,10,vg giraffe,None,125,0.4,119571,178,119571,23,0,40044,28,139,0.9997658843301366,0.9983218114417393,0.9993036731242695,0.999043326050357,0.9985685979135284,119571,28,40183,201
15,10,SAFARI,None,125,0.4,119571,178,119571,23,0,40044,28,139,0.9997658843301366,0.9983218114417393,0.9993036731242695,0.999043326050357,0.9985685979135284,119571,28,40183,201
15,10,vg giraffe,None,125,0.55,164918,250,164918,35,1,55339,37,189,0.9997696355391741,0.9982748497303318,0.9993161285678293,0.9990216834918932,0.9985369322685703,164918,38,55528,285
15,10,SAFARI,None,125,0.55,164918,250,164918,35,1,55339,37,189,0.9997696355391741,0.9982748497303318,0.9993161285678293,0.9990216834918932,0.9985369322685703,164918,38,55528,285
15,10,vg giraffe,None,125,0.5,149998,229,149998,32,1,50382,35,173,0.9997600543876721,0.9982629992213444,0.9992884109821905,0.9990109659565823,0.998521284540702,149998,36,50555,261
15,10,SAFARI,None,125,0.5,149998,229,149998,32,1,50382,35,173,0.9997600543876721,0.9982629992213444,0.9992884109821905,0.9990109659565823,0.998521284540702,149998,36,50555,261
15,10,vg giraffe,None,125,0.65,195084,302,195084,41,1,65463,42,229,0.9997796307020556,0.9982448689280397,0.999345858370731,0.9990116603593869,0.9985219901823389,195084,43,65692,343
15,10,SAFARI,None,125,0.65,195084,302,195084,41,1,65463,42,229,0.9997796307020556,0.9982448689280397,0.999345858370731,0.9990116603593869,0.9985219901823389,195084,43,65692,343
15,10,vg giraffe,None,125,0.6,179989,279,179989,39,1,60359,39,210,0.9997778135744797,0.99823634135114,0.9993400320084476,0.9990064828382398,0.9985140048813694,179989,40,60569,318
15,10,SAFARI,None,125,0.6,179989,279,179989,39,1,60359,39,210,0.9997778135744797,0.99823634135114,0.9993400320084476,0.9990064828382398,0.9985140048813694,179989,40,60569,318
15,10,vg giraffe,None,125,0.75,224877,349,224877,46,1,75414,45,262,0.9997954855661715,0.9982465641535566,0.9993925147249149,0.999020424482724,0.9985348545153724,224877,46,75676,395
15,10,SAFARI,None,125,0.75,224877,349,224877,46,1,75414,45,262,0.9997954855661715,0.9982465641535566,0.9993925147249149,0.999020424482724,0.9985348545153724,224877,46,75676,395
15,10,vg giraffe,None,125,0.7,210062,322,210062,45,1,70490,44,251,0.9997858234137844,0.9982559438100261,0.9993642810725285,0.99902029790553,0.9985349287911385,210062,45,70741,367
15,10,SAFARI,None,125,0.7,210062,322,210062,45,1,70490,44,251,0.9997858234137844,0.9982559438100261,0.9993642810725285,0.99902029790553,0.9985349287911385,210062,45,70741,367
15,10,vg giraffe,None,125,0.85,254843,402,254843,50,2,85289,54,290,0.9997803051404675,0.9982294992067999,0.9993460617738075,0.9990043003249744,0.9985099580559059,254843,56,85579,452
15,10,SAFARI,None,125,0.85,254843,402,254843,50,2,85289,54,290,0.9997803051404675,0.9982294992067999,0.9993460617738075,0.9990043003249744,0.9985099580559059,254843,56,85579,452
15,10,vg giraffe,None,125,0.8,239721,376,239721,50,1,80298,51,279,0.9997831282087641,0.9982260865220053,0.9993550707561796,0.9990040006667779,0.9985098635808165,239721,52,80577,426
15,10,SAFARI,None,125,0.8,239721,376,239721,50,1,80298,51,279,0.9997831282087641,0.9982260865220053,0.9993550707561796,0.9990040006667779,0.9985098635808165,239721,52,80577,426
15,10,vg giraffe,None,125,0.95,284662,453,284662,59,2,95216,60,319,0.9997822452620784,0.9982046049078808,0.9993514440829733,0.9989928022207483,0.9984925322569208,284662,62,95535,512
15,10,SAFARI,None,125,0.95,284662,453,284662,59,2,95216,60,319,0.9997822452620784,0.9982046049078808,0.9993514440829733,0.9989928022207483,0.9984925322569208,284662,62,95535,512
15,10,vg giraffe,None,125,0.9,269690,432,269690,51,2,90236,56,304,0.9997849845040556,0.9982122565911472,0.9993598092673127,0.9989980015594875,0.9985004337931819,269690,58,90540,483
15,10,SAFARI,None,125,0.9,269690,432,269690,51,2,90236,56,304,0.9997849845040556,0.9982122565911472,0.9993598092673127,0.9989980015594875,0.9985004337931819,269690,58,90540,483
15,10,vg giraffe,Single-stranded,125,0.15,44804,66,44804,30,0,14958,8,49,0.9998214763902527,0.9978619153674833,0.9994671994671994,0.9988407347957909,0.9982642076274723,44804,8,15007,96
15,10,SAFARI,Single-stranded,125,0.15,44804,66,44804,30,0,14958,8,49,0.9998214763902527,0.9978619153674833,0.9994671994671994,0.9988407347957909,0.9982642076274723,44804,8,15007,96
15,10,vg giraffe,Single-stranded,125,0.1,29862,41,29862,22,0,10014,4,26,0.9998660684390277,0.9978947368421053,0.9996017522899243,0.9988794300145507,0.9983237008681728,29862,4,10040,63
15,10,SAFARI,Single-stranded,125,0.1,29862,41,29862,22,0,10014,4,26,0.9998660684390277,0.9978947368421053,0.9996017522899243,0.9988794300145507,0.9983237008681728,29862,4,10040,63
15,10,vg giraffe,Single-stranded,125,0.25,74714,120,74714,48,0,24987,19,91,0.999745761577884,0.9977564701797494,0.9992429374028768,0.998750125321659,0.9981296072175156,74714,19,25078,168
15,10,SAFARI,Single-stranded,125,0.25,74714,120,74714,48,0,24987,19,91,0.999745761577884,0.9977564701797494,0.9992429374028768,0.998750125321659,0.9981296072175156,74714,19,25078,168
15,10,vg giraffe,Single-stranded,125,0.2,59763,98,59763,42,0,19911,13,63,0.9997825214132763,0.9976628883361435,0.9993495772251964,0.9987215802271077,0.998084866691701,59763,13,19974,140
15,10,SAFARI,Single-stranded,125,0.2,59763,98,59763,42,0,19911,13,63,0.9997825214132763,0.9976628883361435,0.9993495772251964,0.9987215802271077,0.998084866691701,59763,13,19974,140
15,10,vg giraffe,Single-stranded,125,0.35,104557,161,104557,67,1,35009,23,115,0.9997705128082539,0.9978241160471442,0.99931717309662,0.9987963661721578,0.9981991381589761,104557,24,35124,228
15,10,SAFARI,Single-stranded,125,0.35,104557,161,104557,67,1,35009,23,115,0.9997705128082539,0.9978241160471442,0.99931717309662,0.9987963661721578,0.9981991381589761,104557,24,35124,228
15,10,vg giraffe,Single-stranded,125,0.3,89459,137,89459,60,0,29885,22,104,0.9997541377499134,0.9978027125903454,0.9992669354569991,0.998777471990711,0.998169921532252,89459,22,29989,197
15,10,SAFARI,Single-stranded,125,0.3,89459,137,89459,60,0,29885,22,104,0.9997541377499134,0.9978027125903454,0.9992669354569991,0.998777471990711,0.998169921532252,89459,22,29989,197
15,10,vg giraffe,Single-stranded,125,0.45,134839,211,134839,96,1,45254,28,153,0.9997849749384583,0.9977283826380359,0.9993617395897526,0.9987556200789588,0.9981393494368209,134839,29,45407,307
15,10,SAFARI,Single-stranded,125,0.45,134839,211,134839,96,1,45254,28,153,0.9997849749384583,0.9977283826380359,0.9993617395897526,0.9987556200789588,0.9981393494368209,134839,29,45407,307
15,10,vg giraffe,Single-stranded,125,0.4,119502,186,119502,87,1,40041,25,132,0.9997824777458002,0.9977207263619287,0.9993532177417349,0.9987505380208355,0.9981309462787703,119502,26,40173,273
15,10,SAFARI,Single-stranded,125,0.4,119502,186,119502,87,1,40041,25,132,0.9997824777458002,0.9977207263619287,0.9993532177417349,0.9987505380208355,0.9981309462787703,119502,26,40173,273
15,10,vg giraffe,Single-stranded,125,0.55,164837,252,164837,116,1,55338,35,179,0.9997816501185761,0.9977724645137859,0.9993519701906288,0.9987760468737692,0.9981699417461655,164837,36,55517,368
15,10,SAFARI,Single-stranded,125,0.55,164837,252,164837,116,1,55338,35,179,0.9997816501185761,0.9977724645137859,0.9993519701906288,0.9987760468737692,0.9981699417461655,164837,36,55517,368
15,10,vg giraffe,Single-stranded,125,0.5,149926,233,149926,102,1,50380,32,167,0.9997799398502257,0.9977705459167715,0.9993475682087781,0.9987742322296982,0.9981677048013105,149926,33,50547,335
15,10,SAFARI,Single-stranded,125,0.5,149926,233,149926,102,1,50380,32,167,0.9997799398502257,0.9977705459167715,0.9993475682087781,0.9987742322296982,0.9981677048013105,149926,33,50547,335
15,10,vg giraffe,Single-stranded,125,0.65,194990,293,194990,148,1,65462,43,224,0.9997743983100382,0.9977434490945654,0.9993305948577514,0.9987578912322488,0.9981429080145964,194990,44,65686,441
15,10,SAFARI,Single-stranded,125,0.65,194990,293,194990,148,1,65462,43,224,0.9997743983100382,0.9977434490945654,0.9993305948577514,0.9987578912322488,0.9981429080145964,194990,44,65686,441
15,10,vg giraffe,Single-stranded,125,0.6,179902,269,179902,138,1,60358,40,204,0.9997721500697443,0.9977427638110133,0.9993234658350246,0.9987564260573155,0.99814039981404,179902,41,60562,407
15,10,SAFARI,Single-stranded,125,0.6,179902,269,179902,138,1,60358,40,204,0.9997721500697443,0.9977427638110133,0.9993234658350246,0.9987564260573155,0.99814039981404,179902,41,60562,407
15,10,vg giraffe,Single-stranded,125,0.75,224746,349,224746,181,1,75413,50,259,0.9997731286449553,0.9976473303858379,0.9993264926112277,0.9987090983018311,0.9980697610291064,224746,51,75672,530
15,10,SAFARI,Single-stranded,125,0.75,224746,349,224746,181,1,75413,50,259,0.9997731286449553,0.9976473303858379,0.9993264926112277,0.9987090983018311,0.9980697610291064,224746,51,75672,530
15,10,vg giraffe,Single-stranded,125,0.7,209936,327,209936,170,1,70489,48,245,0.9997666499988095,0.9976382031335389,0.9993077433847111,0.9987012925231556,0.9980584319526628,209936,49,70734,497
15,10,SAFARI,Single-stranded,125,0.7,209936,327,209936,170,1,70489,48,245,0.9997666499988095,0.9976382031335389,0.9993077433847111,0.9987012925231556,0.9980584319526628,209936,49,70734,497
15,10,vg giraffe,Single-stranded,125,0.85,254679,399,254679,220,1,85291,56,291,0.9997762389297155,0.9975753824941833,0.9993344153948551,0.998674598164044,0.99801722898952,254679,57,85582,619
15,10,SAFARI,Single-stranded,125,0.85,254679,399,254679,220,1,85291,56,291,0.9997762389297155,0.9975753824941833,0.9993344153948551,0.998674598164044,0.99801722898952,254679,57,85582,619
15,10,vg giraffe,Single-stranded,125,0.8,239577,375,239577,199,1,80299,54,276,0.9997704814048207,0.9976098371441301,0.9993178717598908,0.9986889906478553,0.9980391606734813,239577,55,80575,574
15,10,SAFARI,Single-stranded,125,0.8,239577,375,239577,199,1,80299,54,276,0.9997704814048207,0.9976098371441301,0.9993178717598908,0.9986889906478553,0.9980391606734813,239577,55,80575,574
15,10,vg giraffe,Single-stranded,125,0.95,284491,449,284491,237,2,95217,60,327,0.999782114403995,0.9975944764128944,0.999351505135661,0.9986870973970126,0.9980356265904727,284491,62,95544,686
15,10,SAFARI,Single-stranded,125,0.95,284491,449,284491,237,2,95217,60,327,0.999782114403995,0.9975944764128944,0.999351505135661,0.9986870973970126,0.9980356265904727,284491,62,95544,686
15,10,vg giraffe,Single-stranded,125,0.9,269528,421,269528,227,1,90238,57,307,0.9997848552966401,0.9976015634253228,0.9993598445967573,0.9986920161108044,0.9980431233525233,269528,58,90545,648
15,10,SAFARI,Single-stranded,125,0.9,269528,421,269528,227,1,90238,57,307,0.9997848552966401,0.9976015634253228,0.9993598445967573,0.9986920161108044,0.9980431233525233,269528,58,90545,648
15,5,vg giraffe,High,125,0.15,43290,66,43290,1540,0,14956,11,47,0.9997459642964366,0.9642284390591589,0.999267350472892,0.9816660430626891,0.9730095142714071,43290,11,15003,1606
15,5,SAFARI,High,125,0.15,43391,66,43391,1439,0,14956,11,47,0.9997465554582738,0.9664780826799715,0.999267350472892,0.9828308681963351,0.9746953763979302,43391,11,15003,1505
15,5,vg giraffe,High,125,0.1,28821,41,28821,1061,0,10014,9,28,0.999687825182102,0.9631721418306988,0.9991045667097801,0.9810903273024356,0.9722069345074298,28821,9,10042,1102
15,5,SAFARI,High,125,0.1,28885,41,28885,997,0,10014,9,28,0.9996885166470547,0.9653109648096782,0.9991045667097801,0.9821990240916741,0.9738079751838695,28885,9,10042,1038
15,5,vg giraffe,High,125,0.25,72138,116,72138,2626,1,24985,21,93,0.9996951219512196,0.9633814102564102,0.9991235059760957,0.9812023939064201,0.9723544708941788,72138,22,25078,2742
15,5,SAFARI,High,125,0.25,72313,116,72313,2451,1,24985,21,93,0.9996958595424068,0.965718482905983,0.9991235059760957,0.9824134768875455,0.9741048209641928,72313,22,25078,2567
15,5,vg giraffe,High,125,0.2,57735,87,57735,2078,0,19910,15,67,0.9997402597402597,0.9638564273789649,0.9992496998799519,0.981470463238419,0.9727131627697392,57735,15,19977,2165
15,5,SAFARI,High,125,0.2,57876,87,57876,1937,0,19910,15,67,0.9997408923666892,0.9662103505843072,0.9992496998799519,0.9826896791775264,0.9744780453612377,57876,15,19977,2024
15,5,vg giraffe,High,125,0.35,100942,168,100942,3676,1,35009,24,125,0.9997523943466677,0.9633157101139466,0.9992889445092294,0.9811958999382755,0.9723534245596485,100942,25,35134,3844
15,5,SAFARI,High,125,0.35,101177,170,101177,3439,1,35009,24,125,0.9997529693089069,0.9655583761189472,0.9992889445092294,0.9823581956230459,0.9740326556861624,101177,25,35134,3609
15,5,vg giraffe,High,125,0.3,86384,136,86384,3136,1,29884,23,112,0.9997222479400055,0.9635049522619791,0.9992005329780147,0.9812795347146492,0.9724589725592433,86384,24,29996,3272
15,5,SAFARI,High,125,0.3,86588,138,86588,2930,1,29884,23,112,0.9997229021382719,0.9657803158740074,0.9992005329780147,0.9824585290580253,0.974163574985795,86588,24,29996,3068
15,5,vg giraffe,High,125,0.45,130151,212,130151,4782,1,45254,29,166,0.9997695516242769,0.963047097561878,0.9993399339933994,0.9810648032985836,0.9721808466458097,130151,30,45420,4994
15,5,SAFARI,High,125,0.45,130458,211,130458,4476,1,45254,29,166,0.9997700938017289,0.9653187317325835,0.9993399339933994,0.9822424171695534,0.9738807829674133,130458,30,45420,4687
15,5,vg giraffe,High,125,0.4,115330,186,115330,4257,1,40041,27,140,0.9997572773453076,0.9629048283002012,0.9993036384888955,0.9809850678983206,0.9720531059744221,115330,28,40181,4443
15,5,SAFARI,High,125,0.4,115609,188,115609,3976,1,40041,27,140,0.9997578629677353,0.9652342347607558,0.9993036384888955,0.9821927700607451,0.973797052168369,115609,28,40181,4164
15,5,vg giraffe,High,125,0.55,159082,256,159082,5866,1,55337,34,192,0.9997800360740838,0.9629427858889615,0.9993700957454467,0.981015722077818,0.9721109943470068,159082,35,55529,6122
15,5,SAFARI,High,125,0.55,159451,255,159451,5498,1,55337,34,192,0.9997805450008151,0.9651763879809205,0.9993700957454467,0.9821737657457882,0.973782432236556,159451,35,55529,5753
15,5,vg giraffe,High,125,0.5,144702,229,144702,5331,1,50380,33,175,0.9997650895423391,0.9629979635569871,0.9993279171361363,0.9810371595739632,0.9721485080980429,144702,34,50555,5560
15,5,SAFARI,High,125,0.5,145048,228,145048,4986,1,50380,33,175,0.9997656497704747,0.9653006082708868,0.9993279171361363,0.9822308900807195,0.973871178137027,145048,34,50555,5214
15,5,vg giraffe,High,125,0.65,188198,303,188198,6920,1,65461,43,228,0.9997662583270471,0.9630387727009891,0.999330625408851,0.9810588980433349,0.9721735068197309,188198,44,65689,7223
15,5,SAFARI,High,125,0.65,188643,302,188643,6476,1,65461,43,228,0.9997668095841261,0.9653159077069506,0.999330625408851,0.9822393701771376,0.9738774822518514,188643,44,65689,6778
15,5,vg giraffe,High,125,0.6,173632,280,173632,6394,1,60357,39,210,0.9997696807775577,0.9629851474715206,0.9993400102298414,0.9810327195475426,0.9721310182514019,173632,40,60567,6674
15,5,SAFARI,High,125,0.6,174031,279,174031,5996,1,60357,39,210,0.999770208707941,0.9651980522001486,0.9993400102298414,0.9821799947513524,0.973787217792315,174031,40,60567,6275
15,5,vg giraffe,High,125,0.75,216908,353,216908,7999,1,75412,45,262,0.9997879734874674,0.9629228447127763,0.999392498679345,0.9810091946433175,0.9720978138082265,216908,46,75674,8352
15,5,SAFARI,High,125,0.75,217413,352,217413,7495,1,75412,45,262,0.9997884658717275,0.9651646985705407,0.999392498679345,0.9821715354434754,0.9737756661572198,217413,46,75674,7847
15,5,vg giraffe,High,125,0.7,202608,332,202608,7477,1,70488,45,250,0.9997730121290476,0.9628879795833987,0.9993501356238698,0.9809838986518056,0.9720662444301407,202608,46,70738,7809
15,5,SAFARI,High,125,0.7,203086,337,203086,6994,1,70488,45,250,0.9997735462654825,0.9651596591530152,0.9993501356238698,0.9821617269053969,0.9737660961376382,203086,46,70738,7331
15,5,vg giraffe,High,125,0.85,245832,406,245832,9045,1,85286,53,291,0.9997803860325517,0.9629783416835433,0.9993693872546158,0.9810343417090842,0.9721190681520853,245832,54,85577,9451
15,5,SAFARI,High,125,0.85,246388,405,246388,8490,1,85286,53,291,0.9997808815055875,0.9651563167151749,0.9993693872546158,0.9821635358014849,0.9737499780003168,246388,54,85577,8895
15,5,vg giraffe,High,125,0.8,231237,376,231237,8522,1,80296,51,279,0.9997751730518961,0.9629458429633331,0.9993550547583315,0.9810149674178658,0.9720976923700438,231237,52,80575,8898
15,5,SAFARI,High,125,0.8,231771,375,231771,7989,1,80296,51,279,0.9997756909366198,0.9651695921044412,0.9993550547583315,0.9821679047711873,0.9737624780990267,231771,52,80575,8364
15,5,vg giraffe,High,125,0.95,274589,445,274589,10130,1,95214,58,321,0.999785179575311,0.9629160763630753,0.9993828064522878,0.9810043371703359,0.972071499482611,274589,59,95535,10575
15,5,SAFARI,High,125,0.95,275240,444,275240,9480,1,95214,58,321,0.999785687561524,0.9651989732224264,0.9993828064522878,0.982187941041603,0.9737812468812211,275240,59,95535,9924
15,5,vg giraffe,High,125,0.9,260175,430,260175,9558,1,90234,54,306,0.9997886485032471,0.9630297264984472,0.9993929024780617,0.9810649838893047,0.972161393510331,260175,55,90540,9988
15,5,SAFARI,High,125,0.9,260773,429,260773,8961,1,90234,54,306,0.9997891330685356,0.9652432050280756,0.9993929024780617,0.9822125045433915,0.9738190144085509,260773,55,90540,9390
15,5,vg giraffe,Mid,125,0.15,44813,60,44813,25,1,14955,12,48,0.9997099897380984,0.998106819902891,0.9991342567927544,0.9989077615799563,0.9983643221951464,44813,13,15003,85
15,5,SAFARI,Mid,125,0.15,44814,60,44814,24,1,14955,12,48,0.9997099962076427,0.9981290926099158,0.9991342567927544,0.9989189189189188,0.9983810127849918,44814,13,15003,84
15,5,vg giraffe,Mid,125,0.1,29866,44,29866,15,0,10014,8,28,0.9997322086094932,0.9980284043441938,0.9992039800995025,0.9988795799260858,0.9983239524702939,29866,8,10042,59
15,5,SAFARI,Mid,125,0.1,29867,44,29867,14,0,10014,8,28,0.9997322175732217,0.998061821219716,0.9992039800995025,0.9988963210702342,0.9983489681050657,29867,8,10042,58
15,5,vg giraffe,Mid,125,0.25,74739,104,74739,38,2,24984,24,87,0.999652243696917,0.9981036578037152,0.9989640196039368,0.9988773505472917,0.9983196303186701,74739,26,25071,142
15,5,SAFARI,Mid,125,0.25,74740,104,74740,37,2,24984,25,86,0.9996388781146762,0.9981170123262243,0.9989241742040882,0.99887736555116,0.9983196303186701,74740,27,25070,141
15,5,vg giraffe,Mid,125,0.2,59787,81,59787,33,1,19909,17,63,0.999699021820918,0.9980968598187009,0.9990995497748875,0.9988972983810335,0.9983477488077506,59787,18,19972,114
15,5,SAFARI,Mid,125,0.2,59788,81,59788,32,1,19909,18,62,0.9996823114351163,0.9981135540308175,0.9990495247623812,0.9988973168042236,0.9983477488077506,59788,19,19971,113
15,5,vg giraffe,Mid,125,0.35,104575,159,104575,53,3,35007,27,112,0.9997132068256775,0.9979768482731637,0.9991464906540727,0.9988442729426148,0.9982706380059456,104575,30,35119,212
15,5,SAFARI,Mid,125,0.35,104577,159,104577,51,3,35007,28,111,0.9997036555521567,0.9979959346102093,0.9991180403425417,0.9988490651639247,0.998277784129888,104577,31,35118,210
15,5,vg giraffe,Mid,125,0.3,89479,134,89479,44,2,29883,26,103,0.9996871753047247,0.9980146558550922,0.9990671020190578,0.998850215445067,0.9982786138663502,89479,28,29986,178
15,5,SAFARI,Mid,125,0.3,89480,134,89480,43,2,29883,27,102,0.9996760102336077,0.9980258094738838,0.9990337842340241,0.9988502282799192,0.9982786138663502,89480,29,29985,177
15,5,vg giraffe,Mid,125,0.45,134869,209,134869,66,4,45253,33,151,0.9997257349561918,0.9979651334872432,0.999185757355692,0.9988446583965933,0.998272281750976,134869,37,45404,275
15,5,SAFARI,Mid,125,0.45,134873,209,134873,62,4,45253,34,150,0.9997183328268265,0.9979947315456106,0.9991637507977377,0.9988557886356483,0.9982888944264474,134873,38,45403,271
15,5,vg giraffe,Mid,125,0.4,119536,179,119536,58,4,40038,29,129,0.9997240087313601,0.9980212568775935,0.9991791044776119,0.9988719071454237,0.9983122151863126,119536,33,40167,237
15,5,SAFARI,Mid,125,0.4,119538,179,119538,56,4,40038,30,128,0.9997156524938949,0.9980379551317909,0.9991542288557214,0.9988760993544883,0.9983184662411781,119538,34,40166,235
15,5,vg giraffe,Mid,125,0.55,164863,254,164863,87,4,55336,40,179,0.999733182945539,0.997935885329653,0.9992080491009557,0.9988337256256229,0.998256048341434,164863,44,55515,341
15,5,SAFARI,Mid,125,0.55,164869,254,164869,81,4,55336,41,178,0.9997271305043841,0.9979722040628556,0.9991900502168866,0.9988488964552069,0.9982786970642725,164869,45,55514,335
15,5,vg giraffe,Mid,125,0.5,149949,233,149949,78,4,50379,38,161,0.9997199831989919,0.9979302542260082,0.9991696650982563,0.9988243169881199,0.998242399498113,149949,42,50540,311
15,5,SAFARI,Mid,125,0.5,149953,233,149953,74,4,50379,39,160,0.999713325688685,0.9979568747504326,0.9991498952196434,0.9988343280400724,0.9982573366128599,149953,43,50539,307
15,5,vg giraffe,Mid,125,0.65,195023,305,195023,97,4,65458,49,222,0.9997283110172446,0.9979429448637585,0.9991937078788432,0.998834830128476,0.9982577596703911,195023,53,65680,402
15,5,SAFARI,Mid,125,0.65,195029,305,195029,91,4,65458,50,221,0.9997231947427505,0.9979736471792248,0.9991784948199535,0.9988476548495806,0.9982769051685186,195029,54,65679,396
15,5,vg giraffe,Mid,125,0.6,179939,277,179939,92,4,60356,45,200,0.9997277596284196,0.9979535017858331,0.9991914858510024,0.9988398427959233,0.9982649338142815,179939,49,60556,369
15,5,SAFARI,Mid,125,0.6,179945,277,179945,86,4,60356,46,199,0.9997222145059586,0.9979867781795594,0.9991749855622474,0.9988537425444695,0.9982856881944935,179945,50,60555,363
15,5,vg giraffe,Mid,125,0.75,224807,347,224807,112,4,75409,53,255,0.9997465134481286,0.9979624088854954,0.9992472365658139,0.9988536644969231,0.9982856402435986,224807,57,75664,459
15,5,SAFARI,Mid,125,0.75,224814,347,224814,105,4,75409,54,254,0.9997420754918354,0.9979934832597906,0.9992340301897756,0.9988670141156712,0.9983055746593706,224814,58,75663,452
15,5,vg giraffe,Mid,125,0.7,209993,327,209993,103,4,70485,52,244,0.9997333955410405,0.9979564971509769,0.9992088719361447,0.9988441560912498,0.9982717419134591,209993,56,70729,430
15,5,SAFARI,Mid,125,0.7,210000,327,210000,96,4,70485,53,243,0.9997286450820492,0.9979897634764261,0.9991947446492901,0.9988584474885844,0.998293078433046,210000,57,70728,423
15,5,vg giraffe,Mid,125,0.85,254746,409,254746,134,5,85282,59,287,0.9997488324634041,0.9978729988366126,0.9992526245723027,0.998810034914791,0.998219534086976,254746,64,85569,543
15,5,SAFARI,Mid,125,0.85,254753,409,254753,127,5,85282,60,286,0.999744915979248,0.997900418741113,0.999240946831245,0.9988218158151133,0.9982371334205478,254753,65,85568,536
15,5,vg giraffe,Mid,125,0.8,239635,383,239635,123,5,80292,57,271,0.9997413401085538,0.9978929045852228,0.999231007751938,0.9988162671568321,0.9982292387597189,239635,62,80563,506
15,5,SAFARI,Mid,125,0.8,239642,383,239642,116,5,80292,58,270,0.9997371769466636,0.997922054126534,0.9992186046511627,0.9988287909037483,0.9982479439840881,239642,63,80562,499
15,5,vg giraffe,Mid,125,0.95,284569,453,284569,147,5,95208,65,317,0.9997540744592273,0.9978959844863923,0.999267744128877,0.9988241653328839,0.9982403798678446,284569,70,95525,600
15,5,SAFARI,Mid,125,0.95,284576,453,284576,140,5,95208,66,316,0.9997505682476893,0.997920531334051,0.9992572833307182,0.9988347115560111,0.9982561376600729,284576,71,95524,593
15,5,vg giraffe,Mid,125,0.9,269597,427,269597,144,5,90230,60,302,0.9997589575097715,0.9978865002516952,0.9992825369493471,0.9988218513235648,0.9982370795393123,269597,65,90532,571
15,5,SAFARI,Mid,125,0.9,269604,427,269604,137,5,90230,61,301,0.9997552564245189,0.9979124100559652,0.9992714990562601,0.9988329832283019,0.9982537108644132,269604,66,90531,564
15,5,vg giraffe,None,125,0.15,44825,73,44825,2,0,14958,11,47,0.9997546614327772,0.9983296213808464,0.9992674480554076,0.999041633235268,0.998564657186728,44825,11,15005,75
15,5,SAFARI,None,125,0.15,44825,73,44825,2,0,14958,11,47,0.9997546614327772,0.9983296213808464,0.9992674480554076,0.999041633235268,0.998564657186728,44825,11,15005,75
15,5,vg giraffe,None,125,0.1,29876,47,29876,2,0,10014,7,30,0.9997657531037714,0.9983625730994152,0.9993035518853846,0.999063670411985,0.9985991594956974,29876,7,10044,49
15,5,SAFARI,None,125,0.1,29876,47,29876,2,0,10014,7,30,0.9997657531037714,0.9983625730994152,0.9993035518853846,0.999063670411985,0.9985991594956974,29876,7,10044,49
15,5,vg giraffe,None,125,0.25,74766,114,74766,3,0,24988,23,91,0.9996924681437109,0.9984375625976524,0.999083738347542,0.9990646213052541,0.9985997899684953,74766,23,25079,117
15,5,SAFARI,None,125,0.25,74766,114,74766,3,0,24988,23,91,0.9996924681437109,0.9984375625976524,0.999083738347542,0.9990646213052541,0.9985997899684953,74766,23,25079,117
15,5,vg giraffe,None,125,0.2,59808,92,59808,3,0,19912,16,66,0.9997325488098422,0.9984141027995259,0.9991997599279784,0.9990728908266306,0.9986107112907869,59808,16,19978,95
15,5,SAFARI,None,125,0.2,59808,92,59808,3,0,19912,16,66,0.9997325488098422,0.9984141027995259,0.9991997599279784,0.9990728908266306,0.9986107112907869,59808,16,19978,95
15,5,vg giraffe,None,125,0.35,104625,158,104625,3,0,35012,27,122,0.9997420020639834,0.9984635352050847,0.9992321037513153,0.9991023596482014,0.9986566342972697,104625,27,35134,161
15,5,SAFARI,None,125,0.35,104625,158,104625,3,0,35012,27,122,0.9997420020639834,0.9984635352050847,0.9992321037513153,0.9991023596482014,0.9986566342972697,104625,27,35134,161
15,5,vg giraffe,None,125,0.3,89518,136,89518,3,0,29887,26,109,0.9997096399535423,0.9984496469879652,0.9991339684231564,0.9990792462095635,0.9986213120096258,89518,26,29996,139
15,5,SAFARI,None,125,0.3,89518,136,89518,3,0,29887,26,109,0.9997096399535423,0.9984496469879652,0.9991339684231564,0.9990792462095635,0.9986213120096258,89518,26,29996,139
15,5,vg giraffe,None,125,0.45,134932,208,134932,3,1,45256,32,163,0.9997554921646353,0.9984386908681915,0.9992739593417231,0.9990966576332431,0.9986489105456962,134932,33,45419,211
15,5,SAFARI,None,125,0.45,134932,208,134932,3,1,45256,32,163,0.9997554921646353,0.9984386908681915,0.9992739593417231,0.9990966576332431,0.9986489105456962,134932,33,45419,211
15,5,vg giraffe,None,125,0.4,119587,182,119587,3,0,40044,30,137,0.9997491995284951,0.9984553985906556,0.9992539354902887,0.9991018802033511,0.9986561072113912,119587,30,40181,185
15,5,SAFARI,None,125,0.4,119587,182,119587,3,0,40044,30,137,0.9997491995284951,0.9984553985906556,0.9992539354902887,0.9991018802033511,0.9986561072113912,119587,30,40181,185
15,5,vg giraffe,None,125,0.55,164944,255,164944,4,1,55339,40,186,0.9997514925599297,0.9984322318601963,0.999262138717921,0.9990914267023635,0.9986411135621396,164944,41,55525,259
15,5,SAFARI,None,125,0.55,164944,255,164944,4,1,55339,40,186,0.9997514925599297,0.9984322318601963,0.999262138717921,0.9990914267023635,0.9986411135621396,164944,41,55525,259
15,5,vg giraffe,None,125,0.5,150022,233,150022,4,1,50382,37,171,0.9997467679594829,0.998422723430876,0.9992488782589789,0.9990843070202019,0.9986308190191685,150022,38,50553,237
15,5,SAFARI,None,125,0.5,150022,233,150022,4,1,50382,37,171,0.9997467679594829,0.998422723430876,0.9992488782589789,0.9990843070202019,0.9986308190191685,150022,38,50553,237
15,5,vg giraffe,None,125,0.65,195114,309,195114,4,1,65463,48,223,0.99974892781931,0.9983983789343336,0.9992545827945539,0.9990731969584475,0.9986138871658204,195114,49,65686,313
15,5,SAFARI,None,125,0.65,195114,309,195114,4,1,65463,48,223,0.99974892781931,0.9983983789343336,0.9992545827945539,0.9990731969584475,0.9986138871658204,195114,49,65686,313
15,5,vg giraffe,None,125,0.6,180018,285,180018,4,1,60359,43,206,0.999755639724095,0.9983971781461618,0.9992740352092924,0.9990759471541669,0.9986177754902124,180018,44,60565,289
15,5,SAFARI,None,125,0.6,180018,285,180018,4,1,60359,43,206,0.999755639724095,0.9983971781461618,0.9992740352092924,0.9990759471541669,0.9986177754902124,180018,44,60565,289
15,5,vg giraffe,None,125,0.75,224910,356,224910,6,1,75414,51,256,0.9997688498501969,0.9983930537306013,0.9993132775151211,0.9990804781513613,0.9986245573001455,224910,52,75670,362
15,5,SAFARI,None,125,0.75,224910,356,224910,6,1,75414,51,256,0.9997688498501969,0.9983930537306013,0.9993132775151211,0.9990804781513613,0.9986245573001455,224910,52,75670,362
15,5,vg giraffe,None,125,0.7,210095,329,210095,5,1,70490,50,245,0.9997573115833753,0.9984127663012228,0.9992795185488655,0.9990845865778993,0.998630940739292,210095,51,70735,334
15,5,SAFARI,None,125,0.7,210095,329,210095,5,1,70490,50,245,0.9997573115833753,0.9984127663012228,0.9992795185488655,0.9990845865778993,0.998630940739292,210095,51,70735,334
15,5,vg giraffe,None,125,0.85,254880,409,254880,6,2,85289,62,282,0.9997489644784737,0.9983744295814646,0.9992526420272085,0.9990612242498124,0.9985950195054704,254880,64,85571,415
15,5,SAFARI,None,125,0.85,254880,409,254880,6,2,85289,62,282,0.9997489644784737,0.9983744295814646,0.9992526420272085,0.9990612242498124,0.9985950195054704,254880,64,85571,415
15,5,vg giraffe,None,125,0.8,239758,383,239758,6,1,80298,58,272,0.999753979075712,0.9983801588193898,0.999268253357973,0.9990665966614163,0.9986033867870414,239758,59,80570,389
15,5,SAFARI,None,125,0.8,239758,383,239758,6,1,80298,58,272,0.999753979075712,0.9983801588193898,0.999268253357973,0.9990665966614163,0.9986033867870414,239758,59,80570,389
15,5,vg giraffe,None,125,0.95,284707,460,284707,7,2,95216,69,310,0.9997506829881522,0.9983624033046491,0.9992572988692113,0.9990560608612654,0.9985870772721662,284707,71,95526,467
15,5,SAFARI,None,125,0.95,284707,460,284707,7,2,95216,69,310,0.9997506829881522,0.9983624033046491,0.9992572988692113,0.9990560608612654,0.9985870772721662,284707,71,95526,467
15,5,vg giraffe,None,125,0.9,269728,439,269728,6,2,90236,64,296,0.9997553689110952,0.9983529072113053,0.999271507097287,0.9990536458709514,0.9985835890357041,269728,66,90532,445
15,5,SAFARI,None,125,0.9,269728,439,269728,6,2,90236,64,296,0.9997553689110952,0.9983529072113053,0.999271507097287,0.9990536458709514,0.9985835890357041,269728,66,90532,445
15,5,vg giraffe,Single-stranded,125,0.15,44832,67,44832,1,0,14958,9,48,0.9997992908275908,0.9984855233853007,0.9994005994005994,0.9991419752398569,0.9987148460318785,44832,9,15006,68
15,5,SAFARI,Single-stranded,125,0.15,44832,67,44832,1,0,14958,9,48,0.9997992908275908,0.9984855233853007,0.9994005994005994,0.9991419752398569,0.9987148460318785,44832,9,15006,68
15,5,vg giraffe,Single-stranded,125,0.1,29882,42,29882,1,0,10014,4,26,0.9998661580673225,0.998563074352548,0.9996017522899243,0.9992141913694805,0.9988240886687183,29882,4,10040,43
15,5,SAFARI,Single-stranded,125,0.1,29882,42,29882,1,0,10014,4,26,0.9998661580673225,0.998563074352548,0.9996017522899243,0.9992141913694805,0.9988240886687183,29882,4,10040,43
15,5,vg giraffe,Single-stranded,125,0.25,74759,121,74759,2,0,24987,21,89,0.9997191762503344,0.9983574156673166,0.9991632466031797,0.9990378319145808,0.9985596975364827,74759,21,25076,123
15,5,SAFARI,Single-stranded,125,0.25,74759,121,74759,2,0,24987,21,89,0.9997191762503344,0.9983574156673166,0.9991632466031797,0.9990378319145808,0.9985596975364827,74759,21,25076,123
15,5,vg giraffe,Single-stranded,125,0.2,59802,99,59802,2,0,19911,14,62,0.9997659489099906,0.998313940871075,0.9992995447040577,0.9990394173021827,0.9985605207159844,59802,14,19973,101
15,5,SAFARI,Single-stranded,125,0.2,59802,99,59802,2,0,19911,14,62,0.9997659489099906,0.998313940871075,0.9992995447040577,0.9990394173021827,0.9985605207159844,59802,14,19973,101
15,5,vg giraffe,Single-stranded,125,0.35,104618,164,104618,3,1,35009,25,113,0.9997515385497496,0.9984062604380398,0.9992602708546717,0.9990784466334652,0.9986207685106444,104618,26,35122,167
15,5,SAFARI,Single-stranded,125,0.35,104618,164,104618,3,1,35009,25,113,0.9997515385497496,0.9984062604380398,0.9992602708546717,0.9990784466334652,0.9986207685106444,104618,26,35122,167
15,5,vg giraffe,Single-stranded,125,0.3,89514,140,89514,2,0,29885,24,102,0.9997319573812237,0.9984161684661372,0.9992002932258172,0.9990736296974229,0.9986128172344924,89514,24,29987,142
15,5,SAFARI,Single-stranded,125,0.3,89514,140,89514,2,0,29885,24,102,0.9997319573812237,0.9984161684661372,0.9992002932258172,0.9990736296974229,0.9986128172344924,89514,24,29987,142
15,5,vg giraffe,Single-stranded,125,0.45,134923,217,134923,6,1,45254,30,151,0.9997702920995302,0.9983499326654137,0.9993177216304252,0.9990596075527582,0.9985934367766444,134923,31,45405,223
15,5,SAFARI,Single-stranded,125,0.45,134923,217,134923,6,1,45254,30,151,0.9997702920995302,0.9983499326654137,0.9993177216304252,0.9990596075527582,0.9985934367766444,134923,31,45405,223
15,5,vg giraffe,Single-stranded,125,0.4,119580,191,119580,4,1,40041,27,130,0.9997659019463581,0.9983719474013776,0.9993034652603299,0.9990684384438326,0.9986060234788153,119580,28,40171,195
15,5,SAFARI,Single-stranded,125,0.4,119580,191,119580,4,1,40041,27,130,0.9997659019463581,0.9983719474013776,0.9993034652603299,0.9990684384438326,0.9986060234788153,119580,28,40171,195
15,5,vg giraffe,Single-stranded,125,0.55,164939,258,164939,8,1,55338,39,175,0.9997575448996538,0.998389879240943,0.9992799668784764,0.9990732440094008,0.9986138667681352,164939,40,55513,266
15,5,SAFARI,Single-stranded,125,0.55,164939,258,164939,8,1,55338,39,175,0.9997575448996538,0.998389879240943,0.9992799668784764,0.9990732440094008,0.9986138667681352,164939,40,55513,266
15,5,vg giraffe,Single-stranded,125,0.5,150016,239,150016,6,1,50380,35,164,0.9997600831711674,0.9983695037301762,0.999288256227758,0.9990643095703483,0.9986008832857833,150016,36,50544,245
15,5,SAFARI,Single-stranded,125,0.5,150016,239,150016,6,1,50380,35,164,0.9997600831711674,0.9983695037301762,0.999288256227758,0.9990643095703483,0.9986008832857833,150016,36,50544,245
15,5,vg giraffe,Single-stranded,125,0.65,195121,300,195121,10,1,65462,51,216,0.999733569704826,0.9984137624020755,0.9992088848318881,0.9990732301768543,0.9986138818583172,195121,52,65678,310
15,5,SAFARI,Single-stranded,125,0.65,195121,300,195121,10,1,65462,51,216,0.999733569704826,0.9984137624020755,0.9992088848318881,0.9990732301768543,0.9986138818583172,195121,52,65678,310
15,5,vg giraffe,Single-stranded,125,0.6,180024,276,180024,9,1,60358,46,198,0.9997389918421067,0.998419380064223,0.9992244608352722,0.9990787502081135,0.9986219034336189,180024,47,60556,285
15,5,SAFARI,Single-stranded,125,0.6,180024,276,180024,9,1,60358,46,198,0.9997389918421067,0.998419380064223,0.9992244608352722,0.9990787502081135,0.9986219034336189,180024,47,60556,285
15,5,vg giraffe,Single-stranded,125,0.75,224907,357,224907,12,1,75413,58,251,0.9997377381470978,0.9983620092686305,0.9992208443933811,0.9990494001003905,0.9985780683656756,224907,59,75664,369
15,5,SAFARI,Single-stranded,125,0.75,224907,357,224907,12,1,75413,58,251,0.9997377381470978,0.9983620092686305,0.9992208443933811,0.9990494001003905,0.9985780683656756,224907,59,75664,369
15,5,vg giraffe,Single-stranded,125,0.7,210087,335,210087,11,1,70489,56,237,0.999728757423481,0.9983557711955824,0.9991947218965006,0.9990417925849487,0.9985669378698225,210087,57,70726,346
15,5,SAFARI,Single-stranded,125,0.7,210087,335,210087,11,1,70489,56,237,0.999728757423481,0.9983557711955824,0.9991947218965006,0.9990417925849487,0.9985669378698225,210087,57,70726,346
15,5,vg giraffe,Single-stranded,125,0.85,254876,407,254876,15,1,85291,65,282,0.9997411175875297,0.9983470297456306,0.9992293230887797,0.9990435873314518,0.9985686505131447,254876,66,85573,422
15,5,SAFARI,Single-stranded,125,0.85,254876,407,254876,15,1,85291,65,282,0.9997411175875297,0.9983470297456306,0.9992293230887797,0.9990435873314518,0.9985686505131447,254876,66,85573,422
15,5,vg giraffe,Single-stranded,125,0.8,239756,383,239756,12,1,80299,63,267,0.9997331331832208,0.9983552015190442,0.9992062507751457,0.9990436922230718,0.9985691172482161,239756,64,80566,395
15,5,SAFARI,Single-stranded,125,0.8,239756,383,239756,12,1,80299,63,267,0.9997331331832208,0.9983552015190442,0.9992062507751457,0.9990436922230718,0.9985691172482161,239756,64,80566,395
15,5,vg giraffe,Single-stranded,125,0.95,284704,457,284704,16,2,95217,69,318,0.999750680361689,0.9983413809669083,0.9992573687843859,0.9990455336589747,0.9985713647930711,284704,71,95535,473
15,5,SAFARI,Single-stranded,125,0.95,284704,457,284704,16,2,95217,69,318,0.999750680361689,0.9983413809669083,0.9992573687843859,0.9990455336589747,0.9985713647930711,284704,71,95535,473
15,5,vg giraffe,Single-stranded,125,0.9,269732,429,269732,15,1,90238,66,298,0.999751666981716,0.9983566267914249,0.9992605101376334,0.9990536598916617,0.9985836204435402,269732,67,90536,444
15,5,SAFARI,Single-stranded,125,0.9,269732,429,269732,15,1,90238,66,298,0.999751666981716,0.9983566267914249,0.9992605101376334,0.9990536598916617,0.9985836204435402,269732,67,90536,444
20,10,vg giraffe,High,125,0.15,35599,50,35599,9247,0,14956,5,53,0.9998595663408606,0.7929214183891661,0.9996669774876782,0.8844472049689441,0.8447337673176432,35599,5,15009,9297
20,10,SAFARI,High,125,0.15,35632,50,35632,9214,0,14956,5,53,0.9998596963829728,0.7936564504632929,0.9996669774876782,0.8849043249351197,0.8452845935570021,35632,5,15009,9264
20,10,vg giraffe,High,125,0.1,23760,32,23760,6131,0,10014,5,32,0.9997896065642752,0.7940380309460949,0.9995025370609889,0.8851139919535091,0.8456997048081253,23760,5,10046,6163
20,10,SAFARI,High,125,0.1,23779,32,23779,6112,0,10014,5,32,0.9997897746384123,0.7946729940179795,0.9995025370609889,0.8855084067253803,0.8461750137589433,23779,5,10046,6144
20,10,vg giraffe,High,125,0.25,59254,86,59254,15540,0,24986,9,105,0.9998481345865042,0.7913194444444445,0.9996414342629482,0.8834452785460292,0.843618723744749,59254,9,25091,15626
20,10,SAFARI,High,125,0.25,59314,86,59314,15480,0,24986,9,105,0.999848288185021,0.7921207264957265,0.9996414342629482,0.8839444721802046,0.8442188437687538,59314,9,25091,15566
20,10,vg giraffe,High,125,0.2,47516,66,47516,12318,0,19910,8,74,0.9998316640013467,0.7932554257095159,0.9995998399359743,0.8846440274054216,0.8448906023131227,47516,8,19984,12384
20,10,SAFARI,High,125,0.2,47563,66,47563,12271,0,19910,8,74,0.9998318303167897,0.7940400667779632,0.9995998399359743,0.8851318029980181,0.8454788965102888,47563,8,19984,12337
20,10,vg giraffe,High,125,0.35,82932,126,82932,21728,0,35010,10,139,0.9998794338212245,0.7914416047945336,0.9997155778036918,0.8835336231142931,0.8437671942548859,82932,10,35149,21854
20,10,SAFARI,High,125,0.35,83043,126,83043,21617,0,35010,10,139,0.9998795949574368,0.7925009066096615,0.9997155778036918,0.8841933783719035,0.8445603629997499,83043,10,35149,21743
20,10,vg giraffe,High,125,0.3,70906,100,70906,18650,0,29885,10,125,0.9998589880985955,0.7908673150709378,0.9996668887408394,0.8831676755598735,0.843243423911227,70906,10,30010,18750
20,10,SAFARI,High,125,0.3,70988,100,70988,18568,0,29885,10,125,0.999859150961999,0.7917819220130276,0.9996668887408394,0.8837377220610754,0.8439286072395468,70988,10,30010,18668
20,10,vg giraffe,High,125,0.45,106867,159,106867,28119,0,45255,12,183,0.999887723500407,0.7907580746605498,0.9997359735973598,0.8831107658744587,0.8433511448268225,106867,12,45438,28278
20,10,SAFARI,High,125,0.45,106998,159,106998,27988,0,45255,12,183,0.999887860947575,0.7917274038995153,0.9997359735973598,0.8837149759451591,0.8440765248207315,106998,12,45438,28147
20,10,vg giraffe,High,125,0.4,94763,140,94763,24870,0,40042,11,156,0.9998839344123915,0.7911883312599668,0.9997264294063518,0.8833775349923326,0.8436011551299522,94763,11,40198,25010
20,10,SAFARI,High,125,0.4,94884,140,94884,24749,0,40042,11,156,0.9998840824068708,0.7921985756389169,0.9997264294063518,0.8840069316339649,0.8443574902176495,94884,11,40198,24889
20,10,vg giraffe,High,125,0.55,130558,188,130558,34458,0,55338,13,213,0.9999004373099692,0.7902835282438682,0.9997660355625945,0.8828197109289155,0.8430071387157559,130558,13,55551,34646
20,10,SAFARI,High,125,0.55,130717,188,130717,34299,0,55338,13,213,0.999900558402815,0.7912459746737367,0.9997660355625945,0.8834199517459974,0.8437273517901145,130717,13,55551,34487
20,10,vg giraffe,High,125,0.5,118805,171,118805,31286,0,50381,13,195,0.9998905889680014,0.7906523272683712,0.9997430271402874,0.8830459342946335,0.84331668749471,118805,13,50576,31457
20,10,SAFARI,High,125,0.5,118942,171,118942,31149,0,50381,13,195,0.9998907149762515,0.7915640680943952,0.9997430271402874,0.8836143334187663,0.8439987851691054,118942,13,50576,31320
20,10,vg giraffe,High,125,0.65,154520,224,154520,40677,0,65462,15,256,0.9999029346102825,0.790703148586897,0.9997718041166538,0.8830824446501847,0.8433261600434993,154520,15,65718,40901
20,10,SAFARI,High,125,0.65,154709,224,154709,40488,0,65462,15,256,0.9999030531785631,0.7916702913197661,0.9997718041166538,0.8836853303631353,0.8440498709573662,154709,15,65718,40712
20,10,vg giraffe,High,125,0.6,142568,207,142568,37531,0,60358,14,235,0.9999018108877699,0.790700254012623,0.9997690035804445,0.8830802011843116,0.8432961276477401,142568,14,60593,37738
20,10,SAFARI,High,125,0.6,142741,207,142741,37358,0,60358,14,235,0.9999019298798641,0.7916597340077424,0.9997690035804445,0.8836783146216969,0.8440142292030733,142741,14,60593,37565
20,10,vg giraffe,High,125,0.75,178022,259,178022,46979,0,75413,17,290,0.9999045153028269,0.7902956583503508,0.9997754886423666,0.8828288689037166,0.8429962123729151,178022,17,75703,47238
20,10,SAFARI,High,125,0.75,178238,259,178238,46763,0,75413,17,290,0.9999046310061429,0.7912545502974341,0.9997754886423666,0.8834268862371907,0.8437138680310984,178238,17,75703,47022
20,10,vg giraffe,High,125,0.7,166299,242,166299,43876,0,70489,17,278,0.9998977849395128,0.7903306291792013,0.9997598327305606,0.8828480648098255,0.8430482110661057,166299,17,70767,44118
20,10,SAFARI,High,125,0.7,166504,242,166504,43671,0,70489,17,278,0.9998979107740165,0.7913048850615683,0.9997598327305606,0.88345563461365,0.8437772269657647,166504,17,70767,43913
20,10,vg giraffe,High,125,0.85,201786,298,201786,53199,0,85287,19,325,0.9999058497063997,0.7904404131885006,0.9997781177377352,0.8829197003640437,0.8430219938166224,201786,19,85612,53497
20,10,SAFARI,High,125,0.85,202030,298,202030,52955,0,85287,19,325,0.9999059634049167,0.7913962151807994,0.9997781177377352,0.8835156953810361,0.8437377168435441,202030,19,85612,53253
20,10,vg giraffe,High,125,0.8,189810,279,189810,50046,0,80297,19,311,0.9998999099189271,0.7904303829096133,0.9997643469309289,0.8829111274432278,0.8430487401874287,189810,19,80608,50325
20,10,SAFARI,High,125,0.8,190041,279,190041,49815,0,80297,19,311,0.9999000315689782,0.7913923418077331,0.9997643469309289,0.8835109659572985,0.843768900306146,190041,19,80608,50094
20,10,vg giraffe,High,125,0.95,225354,329,225354,59481,0,95215,21,358,0.9999068219633943,0.7902610427683718,0.9997803209406448,0.8828081694052756,0.842863446073359,225354,21,95573,59810
20,10,SAFARI,High,125,0.95,225608,329,225608,59227,0,95215,21,358,0.9999069268578064,0.7911517582864597,0.9997803209406448,0.8833637109357411,0.8435305364562268,225608,21,95573,59556
20,10,vg giraffe,High,125,0.9,213541,317,213541,56305,0,90235,19,341,0.9999110320284698,0.7904154158785622,0.9997902754015122,0.8829061260266724,0.842994472749045,213541,19,90576,56622
20,10,SAFARI,High,125,0.9,213783,317,213783,56063,0,90235,19,341,0.9999111327302832,0.7913111714039303,0.9997902754015122,0.8834647133573709,0.8436652825439769,213783,19,90576,56380
20,10,vg giraffe,Mid,125,0.15,44022,53,44022,823,0,14956,6,54,0.9998637230853094,0.9804891086462648,0.9996004262120405,0.990081640914918,0.9852788997563174,44022,6,15010,876
20,10,SAFARI,Mid,125,0.15,44023,53,44023,822,0,14956,6,54,0.9998637261804719,0.9805113813532896,0.9996004262120405,0.9900929976272673,0.9852955903461629,44023,6,15010,875
20,10,vg giraffe,Mid,125,0.1,29351,39,29351,535,0,10014,6,30,0.9997956194434037,0.9808187134502924,0.9994029850746269,0.9902162545123309,0.9854909318323952,29351,6,10044,574
20,10,SAFARI,Mid,125,0.1,29352,39,29352,534,0,10014,6,30,0.9997956264050685,0.9808521303258145,0.9994029850746269,0.9902332877890794,0.985515947467167,29352,6,10044,573
20,10,vg giraffe,Mid,125,0.25,73423,88,73423,1370,0,24986,13,98,0.9998229751075767,0.9805291061818084,0.9994820098019683,0.9900820539789774,0.9852867630878793,73423,13,25084,1458
20,10,SAFARI,Mid,125,0.25,73424,88,73424,1369,0,24986,13,98,0.9998229775181448,0.9805424607043175,0.9994820098019683,0.9900888631184347,0.9852967652883634,73424,13,25084,1457
20,10,vg giraffe,Mid,125,0.2,58723,69,58723,1109,0,19910,10,70,0.9998297379667308,0.9803342181265755,0.9994997498749375,0.9899860073840551,0.985129739269755,58723,10,19980,1178
20,10,SAFARI,Mid,125,0.2,58724,69,58724,1108,0,19910,10,70,0.9998297408655974,0.9803509123386922,0.9994997498749375,0.98999452100982,0.9851422563242418,58724,10,19980,1177
20,10,vg giraffe,Mid,125,0.35,102727,131,102727,1929,0,35010,16,123,0.9998442716292107,0.9803410728430053,0.9995447950155054,0.9899966269936875,0.9851646466956323,102727,16,35133,2060
20,10,SAFARI,Mid,125,0.35,102731,131,102731,1925,0,35010,16,123,0.9998442776918061,0.9803792455170965,0.9995447950155054,0.9900160937484942,0.9851932311914018,102731,16,35133,2056
20,10,vg giraffe,Mid,125,0.3,87912,113,87912,1632,0,29885,15,114,0.9998294039373571,0.9805369352086284,0.9995002332244952,0.9900891972249751,0.985293011673672,87912,15,29999,1745
20,10,SAFARI,Mid,125,0.3,87914,113,87914,1630,0,29885,15,114,0.999829407817671,0.9805592424462116,0.9995002332244952,0.9901005709909565,0.9853097241604064,87914,15,29999,1743
20,10,vg giraffe,Mid,125,0.45,132510,173,132510,2461,0,45257,18,166,0.9998641796450561,0.9805096785650861,0.9996038819568231,0.9900923518335873,0.985314394883296,132510,18,45423,2634
20,10,SAFARI,Mid,125,0.45,132515,173,132515,2456,0,45257,18,166,0.9998641847690763,0.9805466761380454,0.9996038819568231,0.990111216129888,0.9853420826757483,132515,18,45423,2629
20,10,vg giraffe,Mid,125,0.4,117426,150,117426,2197,0,40042,17,141,0.9998552489292678,0.980404598699206,0.9995771144278607,0.9900343990287334,0.9852225062979377,117426,17,40183,2347
20,10,SAFARI,Mid,125,0.4,117430,150,117430,2193,0,40042,17,141,0.9998552538591875,0.980437995207601,0.9995771144278607,0.9900514290531994,0.9852475105173998,117430,17,40183,2343
20,10,vg giraffe,Mid,125,0.55,161965,209,161965,3030,0,55340,19,200,0.9998827044646384,0.9803939371928041,0.9996580212026854,0.9900424220937197,0.985242092198421,161965,19,55540,3239
20,10,SAFARI,Mid,125,0.55,161972,209,161972,3023,0,55340,19,200,0.9998827095332457,0.9804363090482071,0.9996580212026854,0.990064029095799,0.9852738004103948,161972,19,55540,3232
20,10,vg giraffe,Mid,125,0.5,147323,193,147323,2744,0,50383,19,180,0.9998710483093755,0.9804538799414348,0.999624372306354,0.990067271053286,0.9852819629360393,147323,19,50563,2937
20,10,SAFARI,Mid,125,0.5,147330,193,147330,2737,0,50383,19,180,0.999871054435388,0.9805004658591774,0.999624372306354,0.9900910254730199,0.9853168162037821,147330,19,50563,2930
20,10,vg giraffe,Mid,125,0.65,191622,251,191622,3552,0,65462,22,249,0.9998852038154077,0.9805398490469489,0.9996653127044255,0.9901180409694396,0.9853536939324087,191622,22,65711,3803
20,10,SAFARI,Mid,125,0.65,191629,251,191629,3545,0,65462,22,249,0.9998852080083067,0.980575668414993,0.9996653127044255,0.990136303981647,0.9853804976297873,191629,22,65711,3796
20,10,vg giraffe,Mid,125,0.6,176790,228,176790,3290,0,60360,21,224,0.9998812291090486,0.9804889411451516,0.9996534939361439,0.9900901380212198,0.9853100496859862,176790,21,60584,3518
20,10,SAFARI,Mid,125,0.6,176797,228,176797,3283,0,60360,21,224,0.9998812338110373,0.980527763604499,0.9996534939361439,0.9901099331888465,0.985339105818283,176797,21,60584,3511
20,10,vg giraffe,Mid,125,0.75,220871,285,220871,4110,0,75413,25,283,0.999886824569028,0.9804897321388936,0.9996698405990412,0.9900932845020418,0.9853149803812125,220871,25,75696,4395
20,10,SAFARI,Mid,125,0.75,220878,285,220878,4103,0,75413,25,283,0.9998868281553442,0.9805208065131888,0.9996698405990412,0.990109129051996,0.9853382371996132,220878,25,75696,4388
20,10,vg giraffe,Mid,125,0.7,206341,269,206341,3813,0,70489,24,272,0.9998837012090228,0.9806009799309011,0.9996609451154905,0.9901484687658954,0.9853987084293476,206341,24,70761,4082
20,10,SAFARI,Mid,125,0.7,206348,269,206348,3806,0,70489,24,272,0.9998837051538,0.9806342462563503,0.9996609451154905,0.9901654290478533,0.9854236010355324,206348,24,70761,4075
20,10,vg giraffe,Mid,125,0.85,250262,336,250262,4691,0,85287,26,320,0.99989611967014,0.9803085914395058,0.999696378732498,0.9900054788884779,0.9851784279101965,250262,26,85607,5027
20,10,SAFARI,Mid,125,0.85,250270,336,250270,4683,0,85287,26,320,0.9998961229903794,0.9803399284732206,0.999696378732498,0.9900214602885766,0.9852018936882924,250270,26,85607,5019
20,10,vg giraffe,Mid,125,0.8,235420,315,235420,4406,0,80297,26,302,0.9998895712817376,0.9803407164957254,0.999677519379845,0.990018650635951,0.9852010499865946,235420,26,80599,4721
20,10,SAFARI,Mid,125,0.8,235427,315,235427,4399,0,80297,26,302,0.9998895745647751,0.9803698660370366,0.999677519379845,0.9900335159821192,0.9852228727483586,235427,26,80599,4714
20,10,vg giraffe,Mid,125,0.95,279571,372,279571,5226,0,95213,30,352,0.9998927042464083,0.9803695352580399,0.999686176055233,0.990034881456168,0.9852191908898951,279571,30,95565,5598
20,10,SAFARI,Mid,125,0.95,279580,372,279580,5217,0,95213,30,352,0.9998927077000107,0.9804010954907441,0.999686176055233,0.9900509756913766,0.9852428275782374,279580,30,95565,5589
20,10,vg giraffe,Mid,125,0.9,264856,349,264856,4963,0,90235,26,336,0.9999018430848453,0.9803381599597287,0.9997130147797388,0.9900233623025885,0.9852036644352972,264856,26,90571,5312
20,10,SAFARI,Mid,125,0.9,264865,349,264865,4954,0,90235,26,336,0.9999018464198481,0.9803714725652187,0.9997130147797388,0.9900403506902977,0.9852286114229485,264865,26,90571,5303
20,10,vg giraffe,None,125,0.15,44771,56,44771,73,0,14958,6,52,0.9998660026352815,0.9971269487750557,0.9996004262120405,0.9984945972768937,0.9977468455838173,44771,6,15010,129
20,10,SAFARI,None,125,0.15,44771,56,44771,73,0,14958,6,52,0.9998660026352815,0.9971269487750557,0.9996004262120405,0.9984945972768937,0.9977468455838173,44771,6,15010,129
20,10,vg giraffe,None,125,0.1,29842,37,29842,46,0,10014,5,32,0.9998324789761115,0.9972263993316625,0.9995025370609889,0.9985277387405473,0.9977986792075245,29842,5,10046,83
20,10,SAFARI,None,125,0.1,29842,37,29842,46,0,10014,5,32,0.9998324789761115,0.9972263993316625,0.9995025370609889,0.9985277387405473,0.9977986792075245,29842,5,10046,83
20,10,vg giraffe,None,125,0.25,74675,90,74675,118,0,24988,13,101,0.9998259425878321,0.9972223335069375,0.9994821129790455,0.9985224408474904,0.9977896684502675,74675,13,25089,208
20,10,SAFARI,None,125,0.25,74675,90,74675,118,0,24988,13,101,0.9998259425878321,0.9972223335069375,0.9994821129790455,0.9985224408474904,0.9977896684502675,74675,13,25089,208
20,10,vg giraffe,None,125,0.2,59737,71,59737,95,0,19912,10,72,0.9998326275796274,0.9972288533128558,0.9994998499549865,0.9985290430422066,0.9977971638484548,59737,10,19984,166
20,10,SAFARI,None,125,0.2,59737,71,59737,95,0,19912,10,72,0.9998326275796274,0.9972288533128558,0.9994998499549865,0.9985290430422066,0.9977971638484548,59737,10,19984,166
20,10,vg giraffe,None,125,0.35,104493,129,104493,164,0,35012,15,134,0.9998564703180618,0.997203824938446,0.999573390972953,0.9985283859069061,0.9977991668274419,104493,15,35146,293
20,10,SAFARI,None,125,0.35,104493,129,104493,164,0,35012,15,134,0.9998564703180618,0.997203824938446,0.999573390972953,0.9985283859069061,0.9977991668274419,104493,15,35146,293
20,10,vg giraffe,None,125,0.3,89401,110,89401,146,0,29887,15,120,0.9998322447884047,0.9971446735893461,0.9995003663979748,0.9984866506955263,0.9977356094218701,89401,15,30007,256
20,10,SAFARI,None,125,0.3,89401,110,89401,146,0,29887,15,120,0.9998322447884047,0.9971446735893461,0.9995003663979748,0.9984866506955263,0.9977356094218701,89401,15,30007,256
20,10,vg giraffe,None,125,0.45,134764,171,134764,208,0,45257,18,177,0.9998664510097788,0.9971955632182207,0.9996039778227581,0.9985292210799297,0.9978017110108254,134764,18,45434,379
20,10,SAFARI,None,125,0.45,134764,171,134764,208,0,45257,18,177,0.9998664510097788,0.9971955632182207,0.9996039778227581,0.9985292210799297,0.9978017110108254,134764,18,45434,379
20,10,vg giraffe,None,125,0.4,119436,150,119436,186,0,40044,17,150,0.999857684612358,0.9971946698727583,0.9995772301111636,0.9985244017138677,0.9977935155610284,119436,17,40194,336
20,10,SAFARI,None,125,0.4,119436,150,119436,186,0,40044,17,150,0.999857684612358,0.9971946698727583,0.9995772301111636,0.9985244017138677,0.9977935155610284,119436,17,40194,336
20,10,vg giraffe,None,125,0.55,164734,210,164734,259,0,55340,19,207,0.9998846758480877,0.9971610685035986,0.9996580642839146,0.9985210149232018,0.9977895447277471,164734,19,55547,469
20,10,SAFARI,None,125,0.55,164734,210,164734,259,0,55340,19,207,0.9998846758480877,0.9971610685035986,0.9996580642839146,0.9985210149232018,0.9977895447277471,164734,19,55547,469
20,10,vg giraffe,None,125,0.5,149831,191,149831,237,0,50383,19,189,0.9998732065398732,0.9971515849300209,0.9996244391294894,0.9985105411700415,0.9977744585511575,149831,19,50572,428
20,10,SAFARI,None,125,0.5,149831,191,149831,237,0,50383,19,189,0.9998732065398732,0.9971515849300209,0.9996244391294894,0.9985105411700415,0.9977744585511575,149831,19,50572,428
20,10,vg giraffe,None,125,0.65,194871,254,194871,302,0,65464,21,250,0.9998922480142849,0.9971549478833529,0.9996805354833802,0.9985217219761272,0.9977906433554652,194871,21,65714,556
20,10,SAFARI,None,125,0.65,194871,254,194871,302,0,65464,21,250,0.9998922480142849,0.9971549478833529,0.9996805354833802,0.9985217219761272,0.9977906433554652,194871,21,65714,556
20,10,vg giraffe,None,125,0.6,179789,235,179789,283,0,60360,20,229,0.9998887708624151,0.9971271220751274,0.9996700160042238,0.9985060369436515,0.9977668564977005,179789,20,60589,518
20,10,SAFARI,None,125,0.6,179789,235,179789,283,0,60360,20,229,0.9998887708624151,0.9971271220751274,0.9996700160042238,0.9985060369436515,0.9977668564977005,179789,20,60589,518
20,10,vg giraffe,None,125,0.75,224638,292,224638,342,0,75415,22,285,0.9999020742455266,0.997185624489506,0.9997094635640897,0.9985420019025097,0.9978205545625494,224638,22,75700,634
20,10,SAFARI,None,125,0.75,224638,292,224638,342,0,75415,22,285,0.9999020742455266,0.997185624489506,0.9997094635640897,0.9985420019025097,0.9978205545625494,224638,22,75700,634
20,10,vg giraffe,None,125,0.7,209836,269,209836,324,0,70491,22,273,0.9998951672083027,0.997181947355165,0.9996892040799028,0.9985367141976793,0.9978130611809469,209836,22,70764,593
20,10,SAFARI,None,125,0.7,209836,269,209836,324,0,70491,22,273,0.9998951672083027,0.997181947355165,0.9996892040799028,0.9985367141976793,0.9978130611809469,209836,22,70764,593
20,10,vg giraffe,None,125,0.85,254571,337,254571,387,0,85291,26,318,0.9998978778225981,0.9971640651011575,0.9996963858235535,0.9985291002800594,0.9978001349250579,254571,26,85609,724
20,10,SAFARI,None,125,0.85,254571,337,254571,387,0,85291,26,318,0.9998978778225981,0.9971640651011575,0.9996963858235535,0.9985291002800594,0.9978001349250579,254571,26,85609,724
20,10,vg giraffe,None,125,0.8,239465,315,239465,367,0,80299,26,304,0.9998914364214104,0.9971600727887502,0.9996775353780898,0.9985238867646016,0.9977928523330922,239465,26,80603,682
20,10,SAFARI,None,125,0.8,239465,315,239465,367,0,80299,26,304,0.9998914364214104,0.9971600727887502,0.9996775353780898,0.9985238867646016,0.9977928523330922,239465,26,80603,682
20,10,vg giraffe,None,125,0.95,284367,380,284367,427,0,95218,31,348,0.999890997826989,0.9971701487512887,0.9996757220414867,0.9985287198106648,0.9977992021451213,284367,31,95566,807
20,10,SAFARI,None,125,0.95,284367,380,284367,427,0,95218,31,348,0.999890997826989,0.9971701487512887,0.9996757220414867,0.9985287198106648,0.9977992021451213,284367,31,95566,807
20,10,vg giraffe,None,125,0.9,269407,363,269407,403,0,90238,27,333,0.9998997899300014,0.9971647796041796,0.9997019801761629,0.9985304119479547,0.9978019297559948,269407,27,90571,766
20,10,SAFARI,None,125,0.9,269407,363,269407,403,0,90238,27,333,0.9998997899300014,0.9971647796041796,0.9997019801761629,0.9985304119479547,0.9978019297559948,269407,27,90571,766
20,10,vg giraffe,Single-stranded,125,0.15,44630,55,44630,215,0,14958,4,53,0.9999103822198324,0.9939866369710467,0.9997335997335998,0.9969397100542811,0.9954268547108404,44630,4,15011,270
20,10,SAFARI,Single-stranded,125,0.15,44630,55,44630,215,0,14958,4,53,0.9999103822198324,0.9939866369710467,0.9997335997335998,0.9969397100542811,0.9954268547108404,44630,4,15011,270
20,10,vg giraffe,Single-stranded,125,0.1,29740,35,29740,150,0,10014,3,27,0.9998991359311434,0.9938178780284044,0.9997013142174432,0.9968492324193873,0.995296354674873,29740,3,10041,185
20,10,SAFARI,Single-stranded,125,0.1,29740,35,29740,150,0,10014,3,27,0.9998991359311434,0.9938178780284044,0.9997013142174432,0.9968492324193873,0.995296354674873,29740,3,10041,185
20,10,vg giraffe,Single-stranded,125,0.25,74454,98,74454,330,0,24987,11,99,0.9998522795944403,0.9942843406960284,0.9995617006016655,0.9970605368705096,0.9956090779063603,74454,11,25086,428
20,10,SAFARI,Single-stranded,125,0.25,74454,98,74454,330,0,24987,11,99,0.9998522795944403,0.9942843406960284,0.9995617006016655,0.9970605368705096,0.9956090779063603,74454,11,25086,428
20,10,vg giraffe,Single-stranded,125,0.2,59545,81,59545,277,0,19911,9,67,0.9998488766497632,0.9940236716024239,0.9995497073097513,0.9969277648023975,0.9954061835023157,59545,9,19978,358
20,10,SAFARI,Single-stranded,125,0.2,59545,81,59545,277,0,19911,9,67,0.9998488766497632,0.9940236716024239,0.9995497073097513,0.9969277648023975,0.9954061835023157,59545,9,19978,358
20,10,vg giraffe,Single-stranded,125,0.35,104201,131,104201,453,0,35010,14,124,0.9998656623326776,0.9944266832084745,0.9996016843063616,0.9971387559808612,0.9957265262661417,104201,14,35134,584
20,10,SAFARI,Single-stranded,125,0.35,104201,131,104201,453,0,35010,14,124,0.9998656623326776,0.9944266832084745,0.9996016843063616,0.9971387559808612,0.9957265262661417,104201,14,35134,584
20,10,vg giraffe,Single-stranded,125,0.3,89158,112,89158,386,0,29885,13,113,0.9998542126924673,0.9944454358882842,0.9995668254973177,0.9971424896687859,0.995729816908588,89158,13,29998,498
20,10,SAFARI,Single-stranded,125,0.3,89158,112,89158,386,0,29885,13,113,0.9998542126924673,0.9944454358882842,0.9995668254973177,0.9971424896687859,0.995729816908588,89158,13,29998,498
20,10,vg giraffe,Single-stranded,125,0.45,134362,171,134362,613,0,45255,16,165,0.9998809328908006,0.9941988664111405,0.9996478563253808,0.9970318042178061,0.9955698796114785,134362,16,45420,784
20,10,SAFARI,Single-stranded,125,0.45,134362,171,134362,613,0,45255,16,165,0.9998809328908006,0.9941988664111405,0.9996478563253808,0.9970318042178061,0.9955698796114785,134362,16,45420,784
20,10,vg giraffe,Single-stranded,125,0.4,119091,151,119091,533,0,40042,15,142,0.9998740617601128,0.9942892924232937,0.9996268563894625,0.9970738568575985,0.995630539962744,119091,15,40184,684
20,10,SAFARI,Single-stranded,125,0.4,119091,151,119091,533,0,40042,15,142,0.9998740617601128,0.9942892924232937,0.9996268563894625,0.9970738568575985,0.995630539962744,119091,15,40184,684
20,10,vg giraffe,Single-stranded,125,0.55,164268,207,164268,730,0,55339,16,198,0.9999026076793844,0.9943282588299386,0.9997119867513906,0.9971076424402636,0.9956830556537023,164268,16,55537,937
20,10,SAFARI,Single-stranded,125,0.55,164268,207,164268,730,0,55339,16,198,0.9999026076793844,0.9943282588299386,0.9997119867513906,0.9971076424402636,0.9956830556537023,164268,16,55537,937
20,10,vg giraffe,Single-stranded,125,0.5,149399,192,149399,670,0,50381,16,183,0.9998929157045812,0.9942633151649464,0.9996836694345591,0.9970701691159786,0.9956283826509528,149399,16,50564,862
20,10,SAFARI,Single-stranded,125,0.5,149399,192,149399,670,0,50381,16,183,0.9998929157045812,0.9942633151649464,0.9996836694345591,0.9970701691159786,0.9956283826509528,149399,16,50564,862
20,10,vg giraffe,Single-stranded,125,0.65,194348,241,194348,842,0,65463,20,247,0.9998971024036879,0.9944584021982183,0.9996957249353415,0.9971703365067639,0.9957765516290717,194348,20,65710,1083
20,10,SAFARI,Single-stranded,125,0.65,194348,241,194348,842,0,65463,20,247,0.9998971024036879,0.9944584021982183,0.9996957249353415,0.9971703365067639,0.9957765516290717,194348,20,65710,1083
20,10,vg giraffe,Single-stranded,125,0.6,179295,221,179295,793,0,60359,19,225,0.9998940406214797,0.9943763206495516,0.9996864841674504,0.9971275474594228,0.9957121272497842,179295,19,60584,1014
20,10,SAFARI,Single-stranded,125,0.6,179295,221,179295,793,0,60359,19,225,0.9998940406214797,0.9943763206495516,0.9996864841674504,0.9971275474594228,0.9957121272497842,179295,19,60584,1014
20,10,vg giraffe,Single-stranded,125,0.75,224002,289,224002,985,0,75414,25,284,0.9998884063081682,0.9943447149274668,0.9996698493192293,0.997108855271387,0.9956843710444221,224002,25,75698,1274
20,10,SAFARI,Single-stranded,125,0.75,224002,289,224002,985,0,75414,25,284,0.9998884063081682,0.9943447149274668,0.9996698493192293,0.997108855271387,0.9956843710444221,224002,25,75698,1274
20,10,vg giraffe,Single-stranded,125,0.7,209244,271,209244,918,0,70490,24,269,0.9998853145249155,0.9943497455247038,0.9996609355353686,0.9971098472483982,0.9956865896677287,209244,24,70759,1189
20,10,SAFARI,Single-stranded,125,0.7,209244,271,209244,918,0,70490,24,269,0.9998853145249155,0.9943497455247038,0.9996609355353686,0.9971098472483982,0.9956865896677287,209244,24,70759,1189
20,10,vg giraffe,Single-stranded,125,0.85,253835,332,253835,1131,0,85292,28,319,0.9998897042893214,0.9942694419854444,0.9996730461588762,0.9970716531706081,0.9956267580227433,253835,28,85611,1463
20,10,SAFARI,Single-stranded,125,0.85,253835,332,253835,1131,0,85292,28,319,0.9998897042893214,0.9942694419854444,0.9996730461588762,0.9970716531706081,0.9956267580227433,253835,28,85611,1463
20,10,vg giraffe,Single-stranded,125,0.8,238772,312,238772,1067,0,80300,27,303,0.9998869341998919,0.9942577794804103,0.9996651370457647,0.9970644117340014,0.9956169473877817,238772,27,80603,1379
20,10,SAFARI,Single-stranded,125,0.8,238772,312,238772,1067,0,80300,27,303,0.9998869341998919,0.9942577794804103,0.9996651370457647,0.9970644117340014,0.9956169473877817,238772,27,80603,1379
20,10,vg giraffe,Single-stranded,125,0.95,283553,372,283553,1252,0,95219,30,357,0.9998942108659545,0.9943052910999134,0.9996862121624166,0.9970919192629579,0.9956563186906978,283553,30,95576,1624
20,10,SAFARI,Single-stranded,125,0.95,283553,372,283553,1252,0,95219,30,357,0.9998942108659545,0.9943052910999134,0.9996862121624166,0.9970919192629579,0.9956563186906978,283553,30,95576,1624
20,10,vg giraffe,Single-stranded,125,0.9,268632,350,268632,1194,0,90239,28,336,0.9998957790515893,0.99428520668009,0.9996909594605036,0.9970826002716967,0.9956427619124173,268632,28,90575,1544
20,10,SAFARI,Single-stranded,125,0.9,268632,350,268632,1194,0,90239,28,336,0.9998957790515893,0.99428520668009,0.9996909594605036,0.9970826002716967,0.9956427619124173,268632,28,90575,1544
20,2,vg giraffe,High,125,0.15,40538,63,40538,4295,0,14956,7,51,0.9998273523245776,0.9029312188168211,0.9995337684827494,0.948912114792664,0.9271407110665999,40538,7,15007,4358
20,2,SAFARI,High,125,0.15,40686,63,40686,4147,0,14956,8,50,0.9998034108222342,0.9062277263007841,0.9994671639802851,0.9507185418857343,0.9295943915873811,40686,8,15006,4210
20,2,vg giraffe,High,125,0.1,26974,40,26974,2909,0,10014,6,31,0.9997776130467012,0.9014470474217158,0.9994030444731867,0.9480695218178304,0.9260769500175113,26974,6,10045,2949
20,2,SAFARI,High,125,0.1,27071,40,27071,2812,0,10014,7,30,0.9997414875544722,0.9046887009992314,0.9993035518853846,0.9498429852107858,0.9284785110321709,27071,7,10044,2852
20,2,vg giraffe,High,125,0.25,67540,107,67540,7233,0,24986,15,99,0.9997779587003183,0.9019764957264957,0.999402390438247,0.9483624109242813,0.9264352870574115,67540,15,25085,7340
20,2,SAFARI,High,125,0.25,67788,107,67788,6985,0,24986,18,96,0.9997345367666578,0.9052884615384615,0.9992828685258964,0.9501703040242211,0.9288857771554311,67788,18,25082,7092
20,2,vg giraffe,High,125,0.2,54091,82,54091,5727,0,19910,10,72,0.9998151605330771,0.9030217028380635,0.999499799919968,0.9489565881001044,0.9271641716317028,54091,10,19982,5809
20,2,SAFARI,High,125,0.2,54277,82,54277,5541,0,19910,12,70,0.9997789607471127,0.9061268781302171,0.9993997599039616,0.9506519892458994,0.9294672808291193,54277,12,19980,5623
20,2,vg giraffe,High,125,0.35,94476,159,94476,10151,0,35010,18,131,0.9998095117150295,0.9016089935678431,0.9994880400466453,0.9481734243275793,0.9261995784058022,94476,18,35141,10310
20,2,SAFARI,High,125,0.35,94895,159,94895,9732,0,35010,22,127,0.9997682185488374,0.9056076193384612,0.9993742711681219,0.950361286510468,0.9291650291185823,94895,22,35137,9891
20,2,vg giraffe,High,125,0.3,80807,127,80807,8722,0,29885,17,118,0.9997896664357122,0.9013005264566789,0.999433710859427,0.9479938995776631,0.9259166415989839,80807,17,30003,8849
20,2,SAFARI,High,125,0.3,81150,127,81150,8379,0,29885,20,115,0.9997536035481089,0.9051262603729812,0.9993337774816788,0.9500895648203436,0.9287576456432367,81150,20,30000,8506
20,2,vg giraffe,High,125,0.45,121781,201,121781,13163,0,45255,22,173,0.9998193804750294,0.9011136187058345,0.9995159515951595,0.9479038560331274,0.9258783465765941,121781,22,45428,13364
20,2,SAFARI,High,125,0.45,122334,201,122334,12610,0,45255,26,169,0.9997875122589082,0.9052055199970402,0.9994279427942794,0.950148540805033,0.9289182978487777,122334,26,45424,12811
20,2,vg giraffe,High,125,0.4,107937,177,107937,11659,0,40042,21,146,0.9998054799088535,0.9011797316590551,0.9994777288666716,0.9479341855083411,0.9258854121088622,107937,21,40188,11836
20,2,SAFARI,High,125,0.4,108428,177,108428,11168,0,40042,25,142,0.9997694853992052,0.9052791530645471,0.9993782486507996,0.9501809609772768,0.928929504569264,108428,25,40184,11345
20,2,vg giraffe,High,125,0.55,148905,242,148905,16057,0,55338,25,201,0.9998321359027731,0.9013401612551755,0.9995500683896048,0.9480349150362585,0.9260581243658501,148905,25,55539,16299
20,2,SAFARI,High,125,0.55,149591,242,149591,15371,0,55338,30,196,0.9997994933866236,0.905492603084671,0.9994600820675258,0.9503120781386484,0.9291428105522539,149591,30,55534,15613
20,2,vg giraffe,High,125,0.5,135457,217,135457,14588,0,50381,24,184,0.9998228533890361,0.9014720954066896,0.9995255885666845,0.9481037155765846,0.9261691502656197,135457,24,50565,14805
20,2,SAFARI,High,125,0.5,136072,217,136072,13973,0,50381,28,180,0.9997942689199119,0.9055649465600085,0.9994465199944652,0.9503495575530273,0.9292112063171206,136072,28,50561,14190
20,2,vg giraffe,High,125,0.65,176143,284,176143,18994,0,65462,29,242,0.9998353881434053,0.9013514412473582,0.9995588212921972,0.9480426165186103,0.9260704411956164,176143,29,65704,19278
20,2,SAFARI,High,125,0.65,176962,284,176962,18175,0,65462,34,237,0.9998079052633958,0.9055423930897908,0.9994827559977485,0.950343297969749,0.9291873760310009,176962,34,65699,18459
20,2,vg giraffe,High,125,0.6,162523,264,162523,17519,0,60358,27,222,0.9998338972623808,0.9013732210797201,0.999554506905143,0.9480539935133117,0.9260728976850564,162523,27,60580,17783
20,2,SAFARI,High,125,0.6,163275,264,163275,16767,0,60358,32,217,0.9998040500407208,0.9055439086885628,0.9994720081838732,0.9503423910038329,0.9291736020887208,163275,32,60575,17031
20,2,vg giraffe,High,125,0.75,202998,331,202998,21931,0,75413,31,276,0.9998473124529008,0.9011719790464352,0.9995905969360803,0.9479486981921086,0.9259319556116685,202998,31,75689,22262
20,2,SAFARI,High,125,0.75,203943,331,203943,20986,0,75413,36,271,0.9998235112438045,0.905367131314925,0.9995245641838352,0.9502538212976919,0.9290550867167253,203943,36,75684,21317
20,2,vg giraffe,High,125,0.7,189606,309,189606,20502,0,70489,31,264,0.9998365297911272,0.9010963943027417,0.999562047920434,0.9479020332255145,0.9258821981429654,189606,31,70753,20811
20,2,SAFARI,High,125,0.7,190492,309,190492,19616,0,70489,36,259,0.9998110513940208,0.9053070807016543,0.999491410488246,0.9502151167865917,0.9290151884239387,190492,36,70748,19925
20,2,vg giraffe,High,125,0.85,230131,384,230131,24768,0,85287,35,309,0.9998479358376129,0.9014740503676312,0.9995912695168806,0.9481160739851149,0.9261191972168934,230131,35,85596,25152
20,2,SAFARI,High,125,0.85,231224,384,231224,23675,0,85287,40,304,0.9998270374982704,0.905755573226576,0.9995328794478635,0.950469327731956,0.9293106179271019,231224,40,85591,24059
20,2,vg giraffe,High,125,0.8,216448,354,216448,23333,0,80297,34,296,0.9998429430622408,0.901359651862494,0.9995783050342937,0.9480505544033622,0.926047973263666,216448,34,80593,23687
20,2,SAFARI,High,125,0.8,217466,354,217466,22315,0,80297,39,291,0.9998206937771545,0.9055989339329961,0.9995162910687487,0.9503802115199721,0.929206078026699,217466,39,80588,22669
20,2,vg giraffe,High,125,0.95,257020,422,257020,27722,0,95215,38,341,0.9998521734394572,0.901305915192661,0.999602485511643,0.9480249786987617,0.9259844835827481,257020,38,95556,28144
20,2,SAFARI,High,125,0.95,258241,422,258241,26501,0,95215,43,336,0.9998335165941367,0.9055876618366975,0.9995501809737013,0.9503797971471051,0.9291781131322258,258241,43,95551,26923
20,2,vg giraffe,High,125,0.9,243564,407,243564,26192,0,90235,35,325,0.9998563212492663,0.9015446230608929,0.999613665213312,0.948158875121165,0.9261721153792847,243564,35,90560,26599
20,2,SAFARI,High,125,0.9,244702,407,244702,25054,0,90235,40,320,0.9998365625842724,0.9057568949115904,0.9995584745294994,0.9504743593478409,0.9293127248737381,244702,40,90555,25461
20,2,vg giraffe,Mid,125,0.15,44608,60,44608,230,0,14956,8,52,0.9998206921283844,0.9935409149628046,0.9994672349493873,0.9966709118126774,0.9950262042260574,44608,8,15008,290
20,2,SAFARI,Mid,125,0.15,44612,60,44612,226,0,14956,9,51,0.9997983012482912,0.9936300057909039,0.9994006393180608,0.9967046101944839,0.9950762759955937,44612,9,15007,286
20,2,vg giraffe,Mid,125,0.1,29735,44,29735,146,0,10014,6,30,0.9997982582966276,0.9936507936507937,0.9994029850746269,0.9967150470954983,0.9950969355847404,29735,6,10044,190
20,2,SAFARI,Mid,125,0.1,29739,44,29739,142,0,10014,7,29,0.9997646742419148,0.9937844611528822,0.9993034825870647,0.9967655980291935,0.9951719824890557,29739,7,10043,186
20,2,vg giraffe,Mid,125,0.25,74420,102,74420,359,0,24986,18,93,0.9997581880222467,0.993843565123329,0.9992827828027254,0.9967921028134398,0.9952089459681129,74420,18,25079,461
20,2,SAFARI,Mid,125,0.25,74427,102,74427,352,0,24986,19,92,0.9997447814523278,0.9939370467808923,0.9992429374028768,0.996832454947866,0.9952689591710177,74427,19,25078,454
20,2,vg giraffe,Mid,125,0.2,59527,80,59527,294,0,19910,13,67,0.9997816593886463,0.9937563646683695,0.9993496748374187,0.9967599065647474,0.9951558999136323,59527,13,19977,374
20,2,SAFARI,Mid,125,0.2,59533,80,59533,288,0,19910,14,66,0.9997648915982333,0.9938565299410694,0.9992996498249125,0.9968019556627152,0.995218485186066,59533,14,19976,368
20,2,vg giraffe,Mid,125,0.35,104131,156,104131,500,0,35010,21,118,0.9997983716107228,0.9937396814490347,0.9994025434578508,0.9967598198517271,0.995162074091013,104131,21,35128,656
20,2,SAFARI,Mid,125,0.35,104140,156,104140,491,0,35010,22,117,0.9997887905378161,0.99382556996574,0.99937409314632,0.9967982617767972,0.995219243082552,104140,22,35127,647
20,2,vg giraffe,Mid,125,0.3,89101,131,89101,425,0,29885,20,109,0.9997755860010548,0.9937985879518609,0.999333644299327,0.9967781270626139,0.9951868038204744,89101,20,29994,556
20,2,SAFARI,Mid,125,0.3,89109,131,89109,417,0,29885,21,108,0.999764389094581,0.993887816902194,0.9993003265142933,0.9968174419840369,0.9952452975240451,89109,21,29993,548
20,2,vg giraffe,Mid,125,0.45,134301,204,134301,639,0,45257,25,159,0.9998138856215476,0.9937622091990765,0.9994498360511432,0.9967788622110068,0.9951933992302794,134301,25,45416,843
20,2,SAFARI,Mid,125,0.45,134310,204,134310,630,0,45257,26,158,0.9998064554549786,0.9938288048304031,0.999427829493189,0.9968086685468309,0.9952376996982031,134310,26,45415,834
20,2,vg giraffe,Mid,125,0.4,119022,176,119022,575,0,40042,23,135,0.9998067957495065,0.9937298055488298,0.9994278606965175,0.9967590382634476,0.9951616835340964,119022,23,40177,751
20,2,SAFARI,Mid,125,0.4,119031,176,119031,566,0,40042,24,134,0.999798412498425,0.9938049476927188,0.9994029850746269,0.9967926708761117,0.9952116919730204,119031,24,40176,742
20,2,vg giraffe,Mid,125,0.55,164181,248,164181,775,0,55340,30,189,0.9998173082193033,0.9938076559889591,0.9994600334779243,0.9968034242520832,0.9952301789702078,164181,30,55529,1023
20,2,SAFARI,Mid,125,0.55,164193,248,164193,763,0,55340,32,187,0.9998051453798142,0.9938802934553643,0.999424035709786,0.996833915654056,0.9952754764158849,164193,32,55527,1011
20,2,vg giraffe,Mid,125,0.5,149332,228,149332,700,0,50383,29,170,0.9998058395431204,0.9938240383335551,0.9994266735202246,0.996805964868951,0.995235060395734,149332,29,50553,928
20,2,SAFARI,Mid,125,0.5,149344,228,149344,688,0,50383,31,168,0.9997924686192469,0.9939038999068281,0.9993871337629987,0.9968394880437866,0.9952848507782237,149344,31,50551,916
20,2,vg giraffe,Mid,125,0.65,194237,296,194237,892,0,65462,36,235,0.9998146937556943,0.9939209415376743,0.999452329879969,0.9968591062823007,0.9953131820583708,194237,36,65697,1188
20,2,SAFARI,Mid,125,0.65,194251,296,194251,878,0,65462,38,233,0.9998044150723921,0.9939925802737624,0.9994219037621894,0.9968900270454744,0.995359131253877,194251,38,65695,1174
20,2,vg giraffe,Mid,125,0.6,179196,270,179196,842,0,60360,33,212,0.999815878010813,0.9938327750293942,0.9994554904710833,0.9968153486289311,0.9952472469314649,179196,33,60572,1112
20,2,SAFARI,Mid,125,0.6,179210,270,179210,828,0,60360,35,210,0.9998047365337945,0.9939104199480888,0.9994224898935732,0.9968488651186335,0.9952970574439736,179210,35,60570,1098
20,2,vg giraffe,Mid,125,0.75,223889,338,223889,1039,0,75413,40,268,0.9998213719527171,0.9938872266564861,0.9994717449584659,0.9968454680038735,0.9952921554751534,223889,40,75681,1377
20,2,SAFARI,Mid,125,0.75,223907,338,223907,1021,0,75413,42,266,0.9998124573005461,0.9939671321903882,0.9994453322063892,0.9968812261389313,0.9953453139172124,223907,42,75679,1359
20,2,vg giraffe,Mid,125,0.7,209143,318,209143,962,0,70489,39,257,0.9998135594840857,0.9939170147750008,0.9994490358126722,0.9968565674860881,0.9953095217774743,209143,39,70746,1280
20,2,SAFARI,Mid,125,0.7,209157,318,209157,948,0,70489,41,255,0.9998040134226904,0.9939835474258992,0.999420781238963,0.9968852845782266,0.9953521948166482,209157,41,70744,1266
20,2,vg giraffe,Mid,125,0.85,253703,400,253703,1186,0,85287,43,303,0.9998305392006179,0.9937874330660545,0.9994978571345159,0.9967998271238716,0.9952217809352286,253703,43,85590,1586
20,2,SAFARI,Mid,125,0.85,253725,400,253725,1164,0,85287,45,301,0.9998226740749497,0.99387360990877,0.9994745016524004,0.9968392661754335,0.9952804453804682,253725,45,85588,1564
20,2,vg giraffe,Mid,125,0.8,238658,374,238658,1109,0,80297,42,286,0.9998240469208212,0.9938244614622243,0.9994790697674418,0.9968152267662962,0.9952457554728369,238658,42,80583,1483
20,2,SAFARI,Mid,125,0.8,238677,374,238677,1090,0,80297,44,284,0.999815684418212,0.9939035816457831,0.9994542635658915,0.9968508672644728,0.9952987536085496,238677,44,80581,1464
20,2,vg giraffe,Mid,125,0.95,283407,444,283407,1318,0,95213,48,334,0.9998306609514738,0.9938212077750387,0.9994978816883728,0.9968168772334619,0.9952463993444759,283407,48,95547,1762
20,2,SAFARI,Mid,125,0.95,283430,444,283430,1295,0,95213,50,332,0.9998236207139833,0.9939018617030603,0.999476960092055,0.9968539468107743,0.9953015516172747,283430,50,95545,1739
20,2,vg giraffe,Mid,125,0.9,268500,418,268500,1250,0,90235,44,318,0.9998361534795043,0.9938260637825354,0.9995143327041734,0.9968220496294866,0.9952545285712305,268500,44,90553,1668
20,2,SAFARI,Mid,125,0.9,268523,418,268523,1227,0,90235,46,316,0.9998287218554636,0.9939111959965651,0.9994922569179995,0.9968611771606553,0.9953127382090835,268523,46,90551,1645
20,2,vg giraffe,None,125,0.15,44817,72,44817,11,0,14958,7,51,0.999843833660539,0.9981514476614699,0.9995338305807139,0.99899692389996,0.9984978970558782,44817,7,15009,83
20,2,SAFARI,None,125,0.15,44817,72,44817,11,0,14958,7,51,0.999843833660539,0.9981514476614699,0.9995338305807139,0.99899692389996,0.9984978970558782,44817,7,15009,83
20,2,vg giraffe,None,125,0.1,29872,46,29872,7,0,10014,5,32,0.9998326471867992,0.9982289055973267,0.9995025370609889,0.9990301327714792,0.9985491294776866,29872,5,10046,53
20,2,SAFARI,None,125,0.1,29872,46,29872,7,0,10014,5,32,0.9998326471867992,0.9982289055973267,0.9995025370609889,0.9990301327714792,0.9985491294776866,29872,5,10046,53
20,2,vg giraffe,None,125,0.25,74754,111,74754,18,0,24988,18,96,0.9997592681752527,0.9982773126076679,0.9992829256632938,0.9990177408038489,0.99852977946692,74754,18,25084,129
20,2,SAFARI,None,125,0.25,74754,111,74754,18,0,24988,18,96,0.9997592681752527,0.9982773126076679,0.9992829256632938,0.9990177408038489,0.99852977946692,74754,18,25084,129
20,2,vg giraffe,None,125,0.2,59798,91,59798,14,0,19912,12,70,0.9997993646547401,0.9982471662521075,0.9993998199459838,0.9990226625345618,0.9985356146038024,59798,12,19982,105
20,2,SAFARI,None,125,0.2,59798,91,59798,14,0,19912,12,70,0.9997993646547401,0.9982471662521075,0.9993998199459838,0.9990226625345618,0.9985356146038024,59798,12,19982,105
20,2,vg giraffe,None,125,0.35,104603,154,104603,29,0,35012,22,127,0.99978972520908,0.9982535834939782,0.999374306760331,0.9990210638409635,0.998535159739044,104603,22,35139,183
20,2,SAFARI,None,125,0.35,104603,154,104603,29,0,35012,22,127,0.99978972520908,0.9982535834939782,0.999374306760331,0.9990210638409635,0.998535159739044,104603,22,35139,183
20,2,vg giraffe,None,125,0.3,89500,132,89500,25,0,29887,21,114,0.9997654181700383,0.9982488818497162,0.9993005129571647,0.9990065744678477,0.9985126881073538,89500,21,30001,157
20,2,SAFARI,None,125,0.3,89500,132,89500,25,0,29887,21,114,0.9997654181700383,0.9982488818497162,0.9993005129571647,0.9990065744678477,0.9985126881073538,89500,21,30001,157
20,2,vg giraffe,None,125,0.45,134905,204,134905,34,0,45257,26,169,0.9998073089208559,0.9982389024958748,0.9994279679662061,0.9990224901323341,0.9985381655084582,134905,26,45426,238
20,2,SAFARI,None,125,0.45,134905,204,134905,34,0,45257,26,169,0.9998073089208559,0.9982389024958748,0.9994279679662061,0.9990224901323341,0.9985381655084582,134905,26,45426,238
20,2,vg giraffe,None,125,0.4,119562,178,119562,32,0,40044,25,142,0.9997909471765326,0.9982466686704738,0.9993782795752406,0.9990182111389169,0.99853109392873,119562,25,40186,210
20,2,SAFARI,None,125,0.4,119562,178,119562,32,0,40044,25,142,0.9997909471765326,0.9982466686704738,0.9993782795752406,0.9990182111389169,0.99853109392873,119562,25,40186,210
20,2,vg giraffe,None,125,0.55,164913,250,164913,40,0,55340,31,195,0.9998120574255505,0.998244583936127,0.9994421048842818,0.9990277058401257,0.9985459915114894,164913,31,55535,290
20,2,SAFARI,None,125,0.55,164913,250,164913,40,0,55340,31,195,0.9998120574255505,0.998244583936127,0.9994421048842818,0.9990277058401257,0.9985459915114894,164913,31,55535,290
20,2,vg giraffe,None,125,0.5,149993,229,149993,37,0,50383,30,178,0.9998000306619652,0.9982297233443588,0.9994070091518255,0.9990142599290002,0.9985262633806323,149993,30,50561,266
20,2,SAFARI,None,125,0.5,149993,229,149993,37,0,50383,30,178,0.9998000306619652,0.9982297233443588,0.9994070091518255,0.9990142599290002,0.9985262633806323,149993,30,50561,266
20,2,vg giraffe,None,125,0.65,195077,302,195077,48,0,65464,36,235,0.9998154915356742,0.998209049926571,0.9994523465429376,0.9990116249295846,0.9985219901823389,195077,36,65699,350
20,2,SAFARI,None,125,0.65,195077,302,195077,48,0,65464,36,235,0.9998154915356742,0.998209049926571,0.9994523465429376,0.9990116249295846,0.9985219901823389,195077,36,65699,350
20,2,vg giraffe,None,125,0.6,179984,279,179984,44,0,60360,33,216,0.9998166839798464,0.9982086108692397,0.9994555264069692,0.9990120003108314,0.9985223065300769,179984,33,60576,323
20,2,SAFARI,None,125,0.6,179984,279,179984,44,0,60360,33,216,0.9998166839798464,0.9982086108692397,0.9994555264069692,0.9990120003108314,0.9985223065300769,179984,33,60576,323
20,2,vg giraffe,None,125,0.75,224867,349,224867,56,0,75415,37,270,0.9998354853626437,0.998202173372634,0.9995113705396054,0.9990181617856129,0.9985315321900105,224867,37,75685,405
20,2,SAFARI,None,125,0.75,224867,349,224867,56,0,75415,37,270,0.9998354853626437,0.998202173372634,0.9995113705396054,0.9990181617856129,0.9985315321900105,224867,37,75685,405
20,2,vg giraffe,None,125,0.7,210054,322,210054,53,0,70491,37,258,0.9998238858399455,0.9982179262364028,0.9994772977707457,0.9990202606296966,0.9985349287911385,210054,37,70749,375
20,2,SAFARI,None,125,0.7,210054,322,210054,53,0,70491,37,258,0.9998238858399455,0.9982179262364028,0.9994772977707457,0.9990202606296966,0.9985349287911385,210054,37,70749,375
20,2,vg giraffe,None,125,0.85,254829,402,254829,64,0,85291,44,300,0.9998273650013928,0.9981746606866566,0.9994861913937059,0.9990003293032882,0.9985040917490394,254829,44,85591,466
20,2,SAFARI,None,125,0.85,254829,402,254829,64,0,85291,44,300,0.9998273650013928,0.9981746606866566,0.9994861913937059,0.9990003293032882,0.9985040917490394,254829,44,85591,466
20,2,vg giraffe,None,125,0.8,239710,376,239710,61,0,80299,42,288,0.9998248189796123,0.9981802812444045,0.9994790956107604,0.9990018733108427,0.998506746140609,239710,42,80587,437
20,2,SAFARI,None,125,0.8,239710,376,239710,61,0,80299,42,288,0.9998248189796123,0.9981802812444045,0.9994790956107604,0.9990018733108427,0.998506746140609,239710,42,80587,437
20,2,vg giraffe,None,125,0.95,284649,453,284649,72,0,95218,49,330,0.9998278877968936,0.99815901870437,0.9994874316139628,0.9989927562680743,0.9984925322569208,284649,49,95548,525
20,2,SAFARI,None,125,0.95,284649,453,284649,72,0,95218,49,330,0.9998278877968936,0.99815901870437,0.9994874316139628,0.9989927562680743,0.9984925322569208,284649,49,95548,525
20,2,vg giraffe,None,125,0.9,269675,432,269675,66,0,90238,45,315,0.9998331603144002,0.9981567366095058,0.9995033002936047,0.9989942451559847,0.998494890110347,269675,45,90553,498
20,2,SAFARI,None,125,0.9,269675,432,269675,66,0,90238,45,315,0.9998331603144002,0.9981567366095058,0.9995033002936047,0.9989942451559847,0.998494890110347,269675,45,90553,498
20,2,vg giraffe,Single-stranded,125,0.15,44790,66,44790,44,0,14958,6,51,0.9998660594695955,0.9975501113585746,0.9996003996003996,0.9987067427755977,0.9980639238921806,44790,6,15009,110
20,2,SAFARI,Single-stranded,125,0.15,44790,66,44790,44,0,14958,6,51,0.9998660594695955,0.9975501113585746,0.9996003996003996,0.9987067427755977,0.9980639238921806,44790,6,15009,110
20,2,vg giraffe,Single-stranded,125,0.1,29848,41,29848,36,0,10014,3,27,0.9998995008542427,0.9974269005847953,0.9997013142174432,0.998661670235546,0.9979984487978183,29848,3,10041,77
20,2,SAFARI,Single-stranded,125,0.1,29848,41,29848,36,0,10014,3,27,0.9998995008542427,0.9974269005847953,0.9997013142174432,0.998661670235546,0.9979984487978183,29848,3,10041,77
20,2,vg giraffe,Single-stranded,125,0.25,74700,120,74700,62,0,24987,15,95,0.9997992371009837,0.9975695093613952,0.9994023190022712,0.9986831286723664,0.9980295862131048,74700,15,25082,182
20,2,SAFARI,Single-stranded,125,0.25,74700,120,74700,62,0,24987,15,95,0.9997992371009837,0.9975695093613952,0.9994023190022712,0.9986831286723664,0.9980295862131048,74700,15,25082,182
20,2,vg giraffe,Single-stranded,125,0.2,59752,98,59752,53,0,19911,11,65,0.999815939628198,0.9974792581339833,0.9994496422674739,0.9986462320124345,0.9979722117912129,59752,11,19976,151
20,2,SAFARI,Single-stranded,125,0.2,59752,98,59752,53,0,19911,11,65,0.999815939628198,0.9974792581339833,0.9994496422674739,0.9986462320124345,0.9979722117912129,59752,11,19976,151
20,2,vg giraffe,Single-stranded,125,0.35,104540,161,104540,84,0,35010,19,119,0.9998182844135847,0.997661879085747,0.9994594287014908,0.9987389177621522,0.998113382833213,104540,19,35129,245
20,2,SAFARI,Single-stranded,125,0.35,104540,161,104540,84,0,35010,19,119,0.9998182844135847,0.997661879085747,0.9994594287014908,0.9987389177621522,0.998113382833213,104540,19,35129,245
20,2,vg giraffe,Single-stranded,125,0.3,89445,137,89445,74,0,29885,18,108,0.9997987995037054,0.9976465601855983,0.9994002199193629,0.9987215203300599,0.9980863563054142,89445,18,29993,211
20,2,SAFARI,Single-stranded,125,0.3,89445,137,89445,74,0,29885,18,108,0.9997987995037054,0.9976465601855983,0.9994002199193629,0.9987215203300599,0.9980863563054142,89445,18,29993,211
20,2,vg giraffe,Single-stranded,125,0.45,134823,211,134823,112,0,45255,22,159,0.999836849716341,0.9976099921566306,0.9995158024473986,0.9987221796282099,0.9980895105824501,134823,22,45414,323
20,2,SAFARI,Single-stranded,125,0.45,134823,211,134823,112,0,45255,22,159,0.999836849716341,0.9976099921566306,0.9995158024473986,0.9987221796282099,0.9980895105824501,134823,22,45414,323
20,2,vg giraffe,Single-stranded,125,0.4,119488,186,119488,101,0,40042,21,136,0.9998242810164925,0.9976038405343353,0.9994775989452473,0.9987128265993547,0.9980746871366597,119488,21,40178,287
20,2,SAFARI,Single-stranded,125,0.4,119488,186,119488,101,0,40042,21,136,0.9998242810164925,0.9976038405343353,0.9994775989452473,0.9987128265993547,0.9980746871366597,119488,21,40178,287
20,2,vg giraffe,Single-stranded,125,0.55,164817,252,164817,136,0,55339,27,187,0.9998362087792094,0.9976514028025786,0.9995139776429716,0.9987426109456474,0.998120113427373,164817,27,55526,388
20,2,SAFARI,Single-stranded,125,0.55,164817,252,164817,136,0,55339,27,187,0.9998362087792094,0.9976514028025786,0.9995139776429716,0.9987426109456474,0.998120113427373,164817,27,55526,388
20,2,vg giraffe,Single-stranded,125,0.5,149906,233,149906,122,0,50381,25,174,0.9998332566313838,0.9976374441804593,0.9995057334914986,0.9987341434815051,0.9981079560448315,149906,25,50555,355
20,2,SAFARI,Single-stranded,125,0.5,149906,233,149906,122,0,50381,25,174,0.9998332566313838,0.9976374441804593,0.9995057334914986,0.9987341434815051,0.9981079560448315,149906,25,50555,355
20,2,vg giraffe,Single-stranded,125,0.65,194985,293,194985,153,0,65463,34,233,0.999825658012809,0.9977178646171795,0.9994827323900807,0.9987706492508643,0.9981620532927964,194985,34,65696,446
20,2,SAFARI,Single-stranded,125,0.65,194985,293,194985,153,0,65463,34,233,0.999825658012809,0.9977178646171795,0.9994827323900807,0.9987706492508643,0.9981620532927964,194985,34,65696,446
20,2,vg giraffe,Single-stranded,125,0.6,179893,269,179893,147,0,60359,31,213,0.9998277050310131,0.9976928494972519,0.9994884741679455,0.9987591364477991,0.9981445507073122,179893,31,60572,416
20,2,SAFARI,Single-stranded,125,0.6,179893,269,179893,147,0,60359,31,213,0.9998277050310131,0.9976928494972519,0.9994884741679455,0.9987591364477991,0.9981445507073122,179893,31,60572,416
20,2,vg giraffe,Single-stranded,125,0.75,224745,349,224745,182,0,75414,40,269,0.9998220521831973,0.9976428913865658,0.9994717589107669,0.9987312830927364,0.9981029837308429,224745,40,75683,531
20,2,SAFARI,Single-stranded,125,0.75,224745,349,224745,182,0,75414,40,269,0.9998220521831973,0.9976428913865658,0.9994717589107669,0.9987312830927364,0.9981029837308429,224745,40,75683,531
20,2,vg giraffe,Single-stranded,125,0.7,209934,327,209934,172,0,70490,39,254,0.9998142618336643,0.9976286989207966,0.9994490202449741,0.998720284677193,0.9980868798361402,209934,39,70744,499
20,2,SAFARI,Single-stranded,125,0.7,209934,327,209934,172,0,70490,39,254,0.9998142618336643,0.9976286989207966,0.9994490202449741,0.998720284677193,0.9980868798361402,209934,39,70744,499
20,2,vg giraffe,Single-stranded,125,0.85,254680,399,254680,219,0,85292,44,303,0.9998272640190952,0.9975792994853073,0.9994862153925198,0.9987020167757469,0.9980582922944709,254680,44,85595,618
20,2,SAFARI,Single-stranded,125,0.85,254680,399,254680,219,0,85292,44,303,0.9998272640190952,0.9975792994853073,0.9994862153925198,0.9987020167757469,0.9980582922944709,254680,44,85595,618
20,2,vg giraffe,Single-stranded,125,0.8,239571,375,239571,205,0,80300,42,288,0.9998247173567377,0.9975848528634068,0.9994791020711894,0.9987035292352073,0.9980609824147939,239571,42,80588,580
20,2,SAFARI,Single-stranded,125,0.8,239571,375,239571,205,0,80300,42,288,0.9998247173567377,0.9975848528634068,0.9994791020711894,0.9987035292352073,0.9980609824147939,239571,42,80588,580
20,2,vg giraffe,Single-stranded,125,0.95,284493,449,284493,235,0,95219,47,340,0.9998348211147817,0.9976014896011951,0.9995083990544527,0.998716906815138,0.9980802714406893,284493,47,95559,684
20,2,SAFARI,Single-stranded,125,0.95,284493,449,284493,235,0,95219,47,340,0.9998348211147817,0.9976014896011951,0.9995083990544527,0.998716906815138,0.9980802714406893,284493,47,95559,684
20,2,vg giraffe,Single-stranded,125,0.9,269527,421,269527,228,0,90239,45,319,0.9998330687163355,0.9975978621343125,0.9995033277043807,0.9987142147817129,0.9980763847119705,269527,45,90558,649
20,2,SAFARI,Single-stranded,125,0.9,269527,421,269527,228,0,90239,45,319,0.9998330687163355,0.9975978621343125,0.9995033277043807,0.9987142147817129,0.9980763847119705,269527,45,90558,649
30,15,vg giraffe,High,125,0.15,14837,15,14837,30044,0,14956,2,56,0.9998652200283038,0.3304748752672844,0.9998667909950713,0.4967606930610195,0.49823067935236187,14837,2,15012,30059
30,15,SAFARI,High,125,0.15,16139,15,16139,28742,0,14956,2,56,0.9998760919397807,0.3594752316464718,0.9998667909950713,0.5288267772007144,0.5199632782507094,16139,2,15012,28757
30,15,vg giraffe,High,125,0.1,9870,10,9870,20043,0,10014,2,35,0.9997974068071313,0.3298466062894763,0.9998010148243955,0.49604221635883905,0.4982988942812828,9870,2,10049,20053
30,15,SAFARI,High,125,0.1,10725,10,10725,19188,0,10014,2,35,0.9998135545818961,0.358419944524279,0.9998010148243955,0.5276752767527676,0.5196877970680943,10725,2,10049,19198
30,15,vg giraffe,High,125,0.25,24517,30,24517,50333,0,24986,4,110,0.9998368745157212,0.32741720085470083,0.9998406374501992,0.4932948360680475,0.49622924584916983,24517,4,25096,50363
30,15,SAFARI,High,125,0.25,26641,30,26641,48209,0,24986,4,110,0.9998498780258961,0.35578258547008546,0.9998406374501992,0.5248165476483625,0.5174734946989398,26641,4,25096,48239
30,15,vg giraffe,High,125,0.2,19732,24,19732,40144,0,19910,4,78,0.9997973246858533,0.32941569282136896,0.9997999199679872,0.49555477422271343,0.49717118109447755,19732,4,19988,40168
30,15,SAFARI,High,125,0.2,21462,24,21462,38414,0,19910,4,78,0.9998136588092797,0.3582971619365609,0.9997999199679872,0.5275422166506895,0.5188254143093176,21462,4,19988,38438
30,15,vg giraffe,High,125,0.35,34300,40,34300,70446,0,35010,4,145,0.999883395522388,0.32733380413414004,0.9998862311214767,0.4932058379466532,0.49630211868948515,34300,4,35155,70486
30,15,SAFARI,High,125,0.35,37260,40,37260,67486,0,35010,5,144,0.9998658258419428,0.3555818525375527,0.9998577889018458,0.5246003196035226,0.5174461395548251,37260,5,35154,67526
30,15,vg giraffe,High,125,0.3,29366,34,29366,60256,0,29885,4,131,0.9998638066053797,0.32754082270009816,0.9998667554963357,0.4934384084149682,0.4961897122230021,29366,4,30016,60290
30,15,SAFARI,High,125,0.3,31901,34,31901,57721,0,29885,5,130,0.9998432896633862,0.3558155617025074,0.9998334443704198,0.5248515160987809,0.5173635482469334,31901,5,30015,57755
30,15,vg giraffe,High,125,0.45,44285,45,44285,90815,0,45255,4,191,0.9999096841202104,0.32768507898923377,0.9999119911991199,0.49360767747472606,0.49686314682023314,44285,4,45446,90860
30,15,SAFARI,High,125,0.45,48054,45,48054,87046,0,45255,5,190,0.9998959612143407,0.35557364312405193,0.9998899889988999,0.5245955328486278,0.5177275118358758,48054,5,45445,87091
30,15,vg giraffe,High,125,0.4,39188,42,39188,80543,0,40042,4,163,0.9998979383547663,0.3271855927462784,0.999900519784128,0.4930393482842135,0.49626207948394196,39188,4,40205,80585
30,15,SAFARI,High,125,0.4,42533,42,42533,77198,0,40042,5,162,0.9998824580375194,0.35511342289163667,0.99987564973016,0.5240926369746968,0.5171644309984873,42533,5,40204,77240
30,15,vg giraffe,High,125,0.55,53967,49,53967,111188,0,55338,4,222,0.9999258861240296,0.3266688457906588,0.9999280109423367,0.49245580015968965,0.4961180968256269,53967,4,55560,111237
30,15,SAFARI,High,125,0.55,58516,49,58516,106639,0,55338,5,221,0.9999145605850891,0.35420449868041937,0.999910013677921,0.5231064923455135,0.5167189085374692,58516,5,55559,106688
30,15,vg giraffe,High,125,0.5,49274,47,49274,100941,0,50381,4,204,0.9999188278745079,0.327920565412413,0.9999209314277807,0.49387591460358826,0.4971795012222991,49274,4,50585,100988
30,15,SAFARI,High,125,0.5,53428,47,53428,96787,0,50381,5,203,0.999906424868527,0.35556561206426107,0.999901164284726,0.5245882324062937,0.5178565205052501,53428,5,50584,96834
30,15,vg giraffe,High,125,0.65,63816,64,63816,131541,0,65462,5,266,0.999921655881293,0.3265565113268277,0.9999239347055513,0.492327632096651,0.49604447950251573,63816,5,65728,131605
30,15,SAFARI,High,125,0.65,69190,64,69190,126167,0,65462,6,265,0.9999132897855367,0.35405611474713566,0.9999087216466614,0.5229444820249644,0.516618546911018,69190,6,65727,126231
30,15,vg giraffe,High,125,0.6,58840,57,58840,121409,0,60358,5,244,0.99991503101368,0.32633412088338715,0.9999175012787301,0.4920740452684706,0.4957889362549966,58840,5,60602,121466
30,15,SAFARI,High,125,0.6,63798,57,63798,116451,0,60358,6,243,0.9999059620086514,0.3538318192406243,0.9999010015344763,0.5226987833353817,0.5163648287971176,63798,6,60601,116508
30,15,vg giraffe,High,125,0.75,73487,73,73487,151700,0,75413,5,302,0.9999319653839873,0.32623190979312794,0.9999339672477549,0.4919598864610112,0.49572064589009235,73487,5,75715,151773
30,15,SAFARI,High,125,0.75,79721,73,79721,145466,0,75413,6,301,0.9999247431861227,0.35390659682145076,0.9999207606973058,0.522782938289173,0.5164296631005383,79721,6,75714,145539
30,15,vg giraffe,High,125,0.7,68697,68,68697,141652,0,70489,5,290,0.999927221914937,0.32648027488273285,0.999929362567812,0.49224166036708356,0.49600108107723656,68697,5,70779,141720
30,15,SAFARI,High,125,0.7,74506,68,74506,135843,0,70489,6,289,0.9999194760575478,0.35408735986160816,0.9999152350813744,0.5229794089053765,0.5166553461758671,74506,6,70778,135911
30,15,vg giraffe,High,125,0.85,83352,81,83352,171850,0,85287,5,339,0.999940017035162,0.32650822812329844,0.9999416099309829,0.4922749822820694,0.4956616624720604,83352,5,85626,171931
30,15,SAFARI,High,125,0.85,90438,82,90438,164763,0,85287,6,338,0.9999336606076689,0.3542656581127611,0.9999299319171795,0.5231758005594009,0.5164440298726365,90438,6,85625,164845
30,15,vg giraffe,High,125,0.8,78399,78,78399,161658,0,80297,5,325,0.9999362277434825,0.32647885564370044,0.9999379860344549,0.49224113844772543,0.4957600962707553,78399,5,80622,161736
30,15,SAFARI,High,125,0.8,85042,79,85042,155014,0,80297,6,324,0.9999294516038002,0.35414246153205486,0.999925583241346,0.5230408723703268,0.5164670378660814,85042,6,80621,155093
30,15,vg giraffe,High,125,0.95,93034,91,93034,192039,0,95215,6,373,0.9999355116079106,0.3262473524007238,0.9999372345544699,0.49197787437467605,0.49538552046181566,93034,6,95588,192130
30,15,SAFARI,High,125,0.95,100954,93,100954,184117,0,95215,7,372,0.9999306662968869,0.35402084414582485,0.9999267736468817,0.5229083845904823,0.5161835076347706,100954,7,95587,184210
30,15,vg giraffe,High,125,0.9,88174,88,88174,181901,0,90235,5,355,0.9999432971569194,0.3263733375776846,0.9999448093161875,0.4921220510015572,0.4955233147982858,88174,5,90590,181989
30,15,SAFARI,High,125,0.9,95669,90,95669,174404,0,90235,6,354,0.9999372876927097,0.35411584858030154,0.999933771179425,0.5230129182862361,0.5162962429107602,95669,6,90589,174494
30,15,vg giraffe,Mid,125,0.15,26317,21,26317,18560,0,14956,1,59,0.9999620031917319,0.586150830771972,0.9999334043686734,0.7390754886542351,0.6898554594919385,26317,1,15015,18581
30,15,SAFARI,Mid,125,0.15,26485,21,26485,18392,0,14956,1,59,0.9999622442044854,0.5898926455521404,0.9999334043686734,0.7420430348537487,0.6926594785859732,26485,1,15015,18413
30,15,vg giraffe,Mid,125,0.1,17581,16,17581,12328,0,10014,1,35,0.9999431236491867,0.5875020885547201,0.9999004975124378,0.7401435577914834,0.6911819887429643,17581,1,10049,12344
30,15,SAFARI,Mid,125,0.1,17684,16,17684,12225,0,10014,1,35,0.999943454905287,0.5909440267335004,0.9999004975124378,0.7428691451375761,0.6937585991244528,17684,1,10049,12241
30,15,vg giraffe,Mid,125,0.25,43888,36,43888,30957,0,24986,4,107,0.9999088672195389,0.586103283877085,0.9998406184006057,0.7390231786685526,0.6899617915941507,43888,4,25093,30993
30,15,SAFARI,Mid,125,0.25,44162,36,44162,30683,0,24986,4,107,0.999909432595209,0.589762423044564,0.9998406184006057,0.7419254580123816,0.6927023945267959,44162,4,25093,30719
30,15,vg giraffe,Mid,125,0.2,35065,30,35065,24806,0,19910,3,77,0.9999144519219801,0.5853825478706532,0.9998499249624813,0.73845149469827,0.6890888836039103,35065,3,19987,24836
30,15,SAFARI,Mid,125,0.2,35293,30,35293,24578,0,19910,3,77,0.9999150045330916,0.5891888282332516,0.9998499249624813,0.7414729455760161,0.6919427720268866,35293,3,19987,24608
30,15,vg giraffe,Mid,125,0.35,61459,56,61459,43272,0,35010,6,133,0.9999023834702676,0.5865135942435608,0.9998292981308146,0.7393474965714699,0.69032986508118,61459,6,35143,43328
30,15,SAFARI,Mid,125,0.35,61840,56,61840,42891,0,35010,6,133,0.9999029848332956,0.5901495414507525,0.9998292981308146,0.7422299304459501,0.6930525383032243,61840,6,35143,42947
30,15,vg giraffe,Mid,125,0.3,52574,46,52574,37037,0,29885,5,124,0.9999049050000951,0.586390354350469,0.9998334110748317,0.7392502601310499,0.6900836459961059,52574,5,30009,37083
30,15,SAFARI,Mid,125,0.3,52901,46,52901,36710,0,29885,5,124,0.9999054927607455,0.5900375876953278,0.9998334110748317,0.7421420705232072,0.6928161375771908,52901,5,30009,36756
30,15,vg giraffe,Mid,125,0.45,79239,73,79239,55832,0,45257,7,177,0.9999116674658658,0.5863301367430297,0.9998459540943201,0.7392042539297542,0.6903840296813135,79239,7,45434,55905
30,15,SAFARI,Mid,125,0.45,79734,73,79734,55337,0,45257,7,177,0.9999122157986481,0.5899928964659918,0.9998459540943201,0.7421085697000721,0.693125121134092,79734,7,45434,55410
30,15,vg giraffe,Mid,125,0.4,70257,61,70257,49455,0,40042,7,151,0.999900375725834,0.5865846225777095,0.9998258706467662,0.7394033793419177,0.6904290098954199,70257,7,40193,49516
30,15,SAFARI,Mid,125,0.4,70687,61,70687,49025,0,40042,7,151,0.9999009816957591,0.590174747230177,0.9998258706467662,0.7422493135293778,0.6931169634875886,70687,7,40193,49086
30,15,vg giraffe,Mid,125,0.55,96928,88,96928,68188,0,55340,7,212,0.9999277866611647,0.5867170286433743,0.9998740078115157,0.739516058274427,0.6906954516834796,96928,7,55552,68276
30,15,SAFARI,Mid,125,0.55,97544,88,97544,67572,0,55340,7,212,0.9999282426628123,0.5904457519188397,0.9998740078115157,0.7424711232897566,0.6934857743371852,97544,7,55552,67660
30,15,vg giraffe,Mid,125,0.5,88052,82,88052,62126,0,50383,7,192,0.9999205078413337,0.5859976041528018,0.9998616108497094,0.7389423419870006,0.6902291353402177,88052,7,50575,62208
30,15,SAFARI,Mid,125,0.5,88608,82,88608,61570,0,50383,7,192,0.9999210066015911,0.5896978570477839,0.9998616108497094,0.7418775510204082,0.692997480606646,88608,7,50575,61652
30,15,vg giraffe,Mid,125,0.65,114530,108,114530,80787,0,65462,9,262,0.9999214241437414,0.586056031725726,0.9998630824699922,0.7389890438889677,0.6902105238974108,114530,9,65724,80895
30,15,SAFARI,Mid,125,0.65,115258,108,115258,80059,0,65462,9,262,0.9999219204108721,0.5897812460023026,0.9998630824699922,0.741943789991374,0.692998108424785,115258,9,65724,80167
30,15,vg giraffe,Mid,125,0.6,105773,99,105773,74436,0,60360,8,237,0.9999243720516917,0.5866239989351554,0.9998679976899596,0.7394412228362504,0.6905812471722157,105773,8,60597,74535
30,15,SAFARI,Mid,125,0.6,106443,99,106443,73766,0,60360,8,237,0.9999248480521554,0.5903398629012578,0.9998679976899596,0.7423864638947687,0.6933623341206162,106443,8,60597,73865
30,15,vg giraffe,Mid,125,0.75,132090,127,132090,93049,0,75413,9,299,0.9999318692798583,0.586373442951888,0.9998811426156549,0.7392441901137492,0.690401911045992,132090,9,75712,93176
30,15,SAFARI,Mid,125,0.75,132922,127,132922,92217,0,75413,9,299,0.9999322957022816,0.5900668542966981,0.9998811426156549,0.74217260334397,0.6931661500330579,132922,9,75712,92344
30,15,vg giraffe,Mid,125,0.7,123332,118,123332,86973,0,70489,9,287,0.9999270315629029,0.586114635757498,0.999872854418309,0.7390371639841324,0.6902648573298057,123332,9,70776,87091
30,15,SAFARI,Mid,125,0.7,124118,118,124118,86187,0,70489,9,287,0.99992749361541,0.5898499688722241,0.999872854418309,0.7419997010910179,0.6930599413956928,124118,9,70776,86305
30,15,vg giraffe,Mid,125,0.85,149648,149,149648,105492,0,85287,9,337,0.9999398624855503,0.5861905526677609,0.9998949003304801,0.7391010159379277,0.6901050680214242,149648,9,85624,105641
30,15,SAFARI,Mid,125,0.85,150569,149,150569,104571,0,85287,9,337,0.9999402303125291,0.5897982286741693,0.9998949003304801,0.7419622684278346,0.6928065657247112,150569,9,85624,104720
30,15,vg giraffe,Mid,125,0.8,140772,140,140772,99229,0,80297,9,319,0.9999360709186609,0.5862056042075281,0.9998883720930233,0.7391119441775481,0.6901853687734985,140772,9,80616,99369
30,15,SAFARI,Mid,125,0.8,141652,140,141652,98349,0,80297,9,319,0.9999364680469571,0.5898701179723579,0.9998883720930233,0.7420181141010261,0.6929288016809761,141652,9,80616,98489
30,15,vg giraffe,Mid,125,0.95,167227,165,167227,117777,0,95213,10,372,0.999940204619791,0.5864136704901304,0.999895392018411,0.7392784357413474,0.6902228151821076,167227,10,95585,117942
30,15,SAFARI,Mid,125,0.95,168263,165,168263,116741,0,95213,10,372,0.9999405727597416,0.5900466039436264,0.999895392018411,0.7421588648603349,0.6929436606401865,168263,10,95585,116906
30,15,vg giraffe,Mid,125,0.9,158412,155,158412,111601,0,90235,9,353,0.9999431893498968,0.5863462734298659,0.9999006589622172,0.7392256917466383,0.6901999916843374,158412,9,90588,111756
30,15,SAFARI,Mid,125,0.9,159397,155,159397,110616,0,90235,9,353,0.9999435403937117,0.5899921530307068,0.9999006589622172,0.7421166085470723,0.6929303008883899,159397,9,90588,110771
30,15,vg giraffe,None,125,0.15,27906,28,27906,16966,0,14958,3,55,0.999892507793185,0.6215144766146994,0.9998002131060203,0.7665535854083974,0.7163195139862474,27906,3,15013,16994
30,15,SAFARI,None,125,0.15,27906,28,27906,16966,0,14958,3,55,0.999892507793185,0.6215144766146994,0.9998002131060203,0.7665535854083974,0.7163195139862474,27906,3,15013,16994
30,15,vg giraffe,None,125,0.1,18616,21,18616,11288,0,10014,3,34,0.9998388742682206,0.6220885547201337,0.9997015222365934,0.7669742913645353,0.7170302181308785,18616,3,10048,11309
30,15,SAFARI,None,125,0.1,18616,21,18616,11288,0,10014,3,34,0.9998388742682206,0.6220885547201337,0.9997015222365934,0.7669742913645353,0.7170302181308785,18616,3,10048,11309
30,15,vg giraffe,None,125,0.25,46587,45,46587,28251,0,24988,6,108,0.9998712252913527,0.6221305236168423,0.999760975221098,0.7670157068062826,0.7169375406310947,46587,6,25096,28296
30,15,SAFARI,None,125,0.25,46587,45,46587,28251,0,24988,6,108,0.9998712252913527,0.6221305236168423,0.999760975221098,0.7670157068062826,0.7169375406310947,46587,6,25096,28296
30,15,vg giraffe,None,125,0.2,37219,35,37219,22649,0,19912,5,77,0.9998656780571674,0.6213211358362687,0.9997499249774933,0.7663986327179879,0.7160218781681414,37219,5,19989,22684
30,15,SAFARI,None,125,0.2,37219,35,37219,22649,0,19912,5,77,0.9998656780571674,0.6213211358362687,0.9997499249774933,0.7663986327179879,0.7160218781681414,37219,5,19989,22684
30,15,vg giraffe,None,125,0.35,65248,64,65248,39474,0,35012,7,142,0.9998927285265496,0.6226786021033344,0.9998009157873781,0.7674384413170939,0.7174287408804761,65248,7,35154,39538
30,15,SAFARI,None,125,0.35,65248,64,65248,39474,0,35012,7,142,0.9998927285265496,0.6226786021033344,0.9998009157873781,0.7674384413170939,0.7174287408804761,65248,7,35154,39538
30,15,vg giraffe,None,125,0.3,55838,55,55838,33764,0,29887,7,128,0.9998746530575701,0.6227957660863067,0.9997668376523883,0.7675220959162073,0.7173606062884884,55838,7,30015,33819
30,15,SAFARI,None,125,0.3,55838,55,55838,33764,0,29887,7,128,0.9998746530575701,0.6227957660863067,0.9997668376523883,0.7675220959162073,0.7173606062884884,55838,7,30015,33819
30,15,vg giraffe,None,125,0.45,84303,87,84303,50753,0,45257,8,187,0.9999051132117992,0.6238058944969402,0.999823990143448,0.7682976842527364,0.718441817326061,84303,8,45444,50840
30,15,SAFARI,None,125,0.45,84303,87,84303,50753,0,45257,8,187,0.9999051132117992,0.6238058944969402,0.999823990143448,0.7682976842527364,0.718441817326061,84303,8,45444,50840
30,15,vg giraffe,None,125,0.4,74606,74,74606,45092,0,40044,8,159,0.9998927815155333,0.6229001770029723,0.999801049464077,0.7676067206486064,0.7176324984529606,74606,8,40203,45166
30,15,SAFARI,None,125,0.4,74606,74,74606,45092,0,40044,8,159,0.9998927815155333,0.6229001770029723,0.999801049464077,0.7676067206486064,0.7176324984529606,74606,8,40203,45166
30,15,vg giraffe,None,125,0.55,103068,104,103068,62031,0,55340,8,218,0.999922387364663,0.623886975418122,0.9998560270669115,0.7683642774872428,0.7185157336401397,103068,8,55558,62135
30,15,SAFARI,None,125,0.55,103068,104,103068,62031,0,55340,8,218,0.999922387364663,0.623886975418122,0.9998560270669115,0.7683642774872428,0.7185157336401397,103068,8,55558,62135
30,15,vg giraffe,None,125,0.5,93740,98,93740,56421,0,50383,8,200,0.9999146648461834,0.6238561417286153,0.9998418691071534,0.7683386132365055,0.7185611152601444,93740,8,50583,56519
30,15,SAFARI,None,125,0.5,93740,98,93740,56421,0,50383,8,200,0.9999146648461834,0.6238561417286153,0.9998418691071534,0.7683386132365055,0.7185611152601444,93740,8,50583,56519
30,15,vg giraffe,None,125,0.65,121812,122,121812,73493,0,65464,10,261,0.9999179130206367,0.6233120295557932,0.9998478740397049,0.7679267704547532,0.7180868579655539,121812,10,65725,73615
30,15,SAFARI,None,125,0.65,121812,122,121812,73493,0,65464,10,261,0.9999179130206367,0.6233120295557932,0.9998478740397049,0.7679267704547532,0.7180868579655539,121812,10,65725,73615
30,15,vg giraffe,None,125,0.6,112463,114,112463,67730,0,60360,9,240,0.999919980083932,0.6237306371910131,0.9998515072019007,0.7682449902486176,0.7183541151272643,112463,9,60600,67844
30,15,SAFARI,None,125,0.6,112463,114,112463,67730,0,60360,9,240,0.999919980083932,0.6237306371910131,0.9998515072019007,0.7682449902486176,0.7183541151272643,112463,9,60600,67844
30,15,vg giraffe,None,125,0.75,140398,137,140398,84737,0,75415,10,297,0.9999287789869523,0.6232376859973721,0.9998679379836771,0.7678735506453731,0.7179877339747636,140398,10,75712,84874
30,15,SAFARI,None,125,0.75,140398,137,140398,84737,0,75415,10,297,0.9999287789869523,0.6232376859973721,0.9998679379836771,0.7678735506453731,0.7179877339747636,140398,10,75712,84874
30,15,vg giraffe,None,125,0.7,131087,128,131087,79214,0,70491,10,285,0.9999237206038277,0.6229512091964511,0.9998587291272285,0.7676545855952401,0.7178244403748022,131087,10,70776,79342
30,15,SAFARI,None,125,0.7,131087,128,131087,79214,0,70491,10,285,0.9999237206038277,0.6229512091964511,0.9998587291272285,0.7676545855952401,0.7178244403748022,131087,10,70776,79342
30,15,vg giraffe,None,125,0.85,159195,161,159195,95939,0,85291,10,334,0.99993718790239,0.6235727295873401,0.9998832253167513,0.768130277442702,0.7180946235297568,159195,10,85625,96100
30,15,SAFARI,None,125,0.85,159195,161,159195,95939,0,85291,10,334,0.99993718790239,0.6235727295873401,0.9998832253167513,0.768130277442702,0.7180946235297568,159195,10,85625,96100
30,15,vg giraffe,None,125,0.8,149734,149,149734,90264,0,80299,10,320,0.9999332193610428,0.6235097669344193,0.9998759751454191,0.7680813355527571,0.718111704117515,149734,10,80619,90413
30,15,SAFARI,None,125,0.8,149734,149,149734,90264,0,80299,10,320,0.9999332193610428,0.6235097669344193,0.9998759751454191,0.7680813355527571,0.718111704117515,149734,10,80619,90413
30,15,vg giraffe,None,125,0.95,177776,182,177776,107216,0,95218,11,368,0.9999381282095992,0.6233948396417626,0.9998849336276243,0.7679955763012436,0.7179170682641273,177776,11,95586,107398
30,15,SAFARI,None,125,0.95,177776,182,177776,107216,0,95218,11,368,0.9999381282095992,0.6233948396417626,0.9998849336276243,0.7679955763012436,0.7179170682641273,177776,11,95586,107398
30,15,vg giraffe,None,125,0.9,168431,172,168431,101570,0,90238,10,350,0.9999406320313938,0.6234190685227613,0.9998896222874677,0.7680147008531418,0.7179595920958171,168431,10,90588,101742
30,15,SAFARI,None,125,0.9,168431,172,168431,101570,0,90238,10,350,0.9999406320313938,0.6234190685227613,0.9998896222874677,0.7680147008531418,0.7179595920958171,168431,10,90588,101742
30,15,vg giraffe,Single-stranded,125,0.15,27837,27,27837,17036,0,14958,2,55,0.9999281583390208,0.6199777282850779,0.9998667998667998,0.765394080204567,0.7151798381039807,27837,2,15013,17063
30,15,SAFARI,Single-stranded,125,0.15,27878,27,27878,16995,0,14958,2,55,0.9999282639885222,0.6208908685968819,0.9998667998667998,0.7660895850508382,0.7158641408662272,27878,2,15013,17022
30,15,vg giraffe,Single-stranded,125,0.1,18578,17,18578,11330,0,10014,1,29,0.9999461757898703,0.6208187134502924,0.9999004380724811,0.7660399142338776,0.7160799619705271,18578,1,10043,11347
30,15,SAFARI,Single-stranded,125,0.1,18605,17,18605,11303,0,10014,1,29,0.9999462538965925,0.6217209690893901,0.9999004380724811,0.7667264222867858,0.7167554855012634,18605,1,10043,11320
30,15,vg giraffe,Single-stranded,125,0.25,46379,45,46379,28458,0,24987,4,106,0.9999137615074488,0.6193611281749953,0.9998406184006057,0.7649198037356204,0.7148701227257724,46379,4,25093,28503
30,15,SAFARI,Single-stranded,125,0.25,46444,45,46444,28393,0,24987,4,106,0.9999138821908371,0.6202291605459256,0.9998406184006057,0.765581472018462,0.7155202592544434,46444,4,25093,28438
30,15,vg giraffe,Single-stranded,125,0.2,37040,41,37040,22822,0,19911,4,72,0.9998920203001835,0.6183329716374806,0.999799869915445,0.7641288539098682,0.7137689322818876,37040,4,19983,22863
30,15,SAFARI,Single-stranded,125,0.2,37092,41,37092,22770,0,19911,4,72,0.9998921716627129,0.6192010416840559,0.999799869915445,0.7647913896019547,0.7144198272624859,37092,4,19983,22811
30,15,vg giraffe,Single-stranded,125,0.35,64903,65,64903,39817,0,35010,5,133,0.9999229678930178,0.6193920885622942,0.9998577443951292,0.7649461085607538,0.7149564434407896,64903,5,35143,39882
30,15,SAFARI,Single-stranded,125,0.35,64998,66,64998,39721,0,35010,5,133,0.9999230804732089,0.6202987068759842,0.9998577443951292,0.7656371475015903,0.7156353397697469,64998,5,35143,39787
30,15,vg giraffe,Single-stranded,125,0.3,55617,55,55617,33984,0,29885,4,122,0.9999280847162043,0.6203377353439814,0.9998667155376362,0.7656683439223001,0.7155188982760494,55617,4,30007,34039
30,15,SAFARI,Single-stranded,125,0.3,55695,55,55695,33906,0,29885,4,122,0.9999281854252321,0.6212077273132863,0.9998667155376362,0.7663307075779987,0.7161707070453843,55695,4,30007,33961
30,15,vg giraffe,Single-stranded,125,0.45,83436,82,83436,51628,0,45255,6,175,0.9999280937657294,0.6173767629082622,0.9998679461220178,0.763408787307629,0.7136148674840239,83436,6,45430,51710
30,15,SAFARI,Single-stranded,125,0.45,83556,83,83556,51507,0,45255,6,175,0.9999281970273569,0.6182646915188019,0.9998679461220178,0.764087276185599,0.7142793855423021,83556,6,45430,51590
30,15,vg giraffe,Single-stranded,125,0.4,74082,75,74082,45618,0,40042,6,151,0.9999190152251377,0.6185097056981841,0.999850742555785,0.764271676390028,0.7143348294097791,74082,6,40193,45693
30,15,SAFARI,Single-stranded,125,0.4,74190,76,74190,45509,0,40042,6,151,0.999919133106906,0.6194113963681903,0.999850742555785,0.7649597104721839,0.7150099391151062,74190,6,40193,45585
30,15,vg giraffe,Single-stranded,125,0.55,101971,95,101971,63139,0,55339,6,208,0.9999411632034675,0.6172391876759178,0.9998919950317715,0.7633074084332029,0.7135324654146169,101971,6,55547,63234
30,15,SAFARI,Single-stranded,125,0.55,102067,95,102067,63043,0,55339,6,208,0.9999412185396725,0.6178202838897128,0.9998919950317715,0.7637515994582419,0.7139673307422607,102067,6,55547,63138
30,15,vg giraffe,Single-stranded,125,0.5,92791,90,92791,57380,0,50381,6,193,0.999935342737373,0.6175321607070364,0.9998813760379597,0.7635296925013784,0.713823372717722,92791,6,50574,57470
30,15,SAFARI,Single-stranded,125,0.5,92919,91,92919,57251,0,50381,6,193,0.9999354317998386,0.6183840118194341,0.9998813760379597,0.764180503811897,0.7144606927868313,92919,6,50574,57342
30,15,vg giraffe,Single-stranded,125,0.65,120636,112,120636,74683,0,65463,8,259,0.9999336892012864,0.6172818027846145,0.9998782899741366,0.7633378153919165,0.7135751509605186,120636,8,65722,74795
30,15,SAFARI,Single-stranded,125,0.65,120758,113,120758,74560,0,65463,8,259,0.9999337561896561,0.61790606403283,0.9998782899741366,0.7638149634563264,0.7140422957485996,120758,8,65722,74673
30,15,vg giraffe,Single-stranded,125,0.6,111376,103,111376,68830,0,60359,7,237,0.9999371537846888,0.6176951788318942,0.9998844941669555,0.7636548139818713,0.7138374178123132,111376,7,60596,68933
30,15,SAFARI,Single-stranded,125,0.6,111393,103,111393,68813,0,60359,7,237,0.9999371633752244,0.6177894614245545,0.9998844941669555,0.7637268647864824,0.7139079829979411,111393,7,60596,68916
30,15,vg giraffe,Single-stranded,125,0.75,139103,137,139103,86036,0,75414,10,299,0.9999281159920352,0.617478115733589,0.9998679397276917,0.7634862742838011,0.7136767896238858,139103,10,75713,86173
30,15,SAFARI,Single-stranded,125,0.75,139173,137,139173,85966,0,75414,10,299,0.9999281521450177,0.6177888456826293,0.9998679397276917,0.7637237659105689,0.7139093485360416,139173,10,75713,86103
30,15,vg giraffe,Single-stranded,125,0.7,129893,127,129893,80413,0,70490,10,283,0.9999230194837686,0.6172653528676586,0.9998587231397369,0.7633221287198534,0.7135653732362313,129893,10,70773,80540
30,15,SAFARI,Single-stranded,125,0.7,130026,128,130026,80279,0,70490,10,283,0.9999230982189548,0.6178973830150214,0.9998587231397369,0.7638052216207643,0.7140383192990442,130026,10,70773,80407
30,15,vg giraffe,Single-stranded,125,0.85,157606,158,157606,97534,0,85292,11,336,0.9999302105737325,0.6173413031046072,0.99987155384813,0.7633822941767676,0.7134279940282222,157606,11,85628,97692
30,15,SAFARI,Single-stranded,125,0.85,157633,158,157633,97507,0,85292,11,336,0.9999302225267057,0.6174470618649578,0.99987155384813,0.7634631497885902,0.7135071875449129,157633,11,85628,97665
30,15,vg giraffe,Single-stranded,125,0.8,148156,150,148156,91845,0,80300,11,319,0.9999257594471104,0.6169285158088036,0.9998635743519781,0.7630653227509412,0.7131812669703006,148156,11,80619,91995
30,15,SAFARI,Single-stranded,125,0.8,148291,150,148291,91710,0,80300,11,319,0.9999258270286308,0.6174906621250796,0.9998635743519781,0.763495197617215,0.7136021148384724,148291,11,80619,91860
30,15,vg giraffe,Single-stranded,125,0.95,175971,176,175971,109030,0,95219,11,376,0.9999374936073008,0.6170588792223777,0.9998849444595528,0.763168451662008,0.713177846700089,175971,11,95595,109206
30,15,SAFARI,Single-stranded,125,0.95,176001,176,176001,109000,0,95219,11,376,0.9999375042610731,0.6171640770468867,0.9998849444595528,0.7632489066304704,0.7132566317298829,176001,11,95595,109176
30,15,vg giraffe,Single-stranded,125,0.9,166694,166,166694,103316,0,90239,11,353,0.9999340151765094,0.6169830036716807,0.9998785912166264,0.7631094050782707,0.7131401772276103,166694,11,90592,103482
30,15,SAFARI,Single-stranded,125,0.9,166723,166,166723,103287,0,90239,11,353,0.999934026653232,0.6170903411109795,0.9998785912166264,0.7631915039710696,0.7132205588462743,166723,11,90592,103453
30,5,vg giraffe,High,125,0.15,25872,41,25872,18983,0,14956,2,56,0.9999227023266599,0.5762651461154669,0.9998667909950713,0.7311572700296736,0.6824236354531797,25872,2,15012,19024
30,5,SAFARI,High,125,0.15,33575,45,33575,11276,0,14956,2,56,0.999940435417101,0.7478394511760513,0.9998667909950713,0.8557083328023652,0.8109998330829578,33575,2,15012,11321
30,5,vg giraffe,High,125,0.1,17229,28,17229,12666,0,10014,2,35,0.9998839301259358,0.5757778297630585,0.9998010148243955,0.7307545489247996,0.6823935558112774,17229,2,10049,12694
30,5,SAFARI,High,125,0.1,22362,32,22362,7529,0,10014,2,35,0.9999105705598283,0.7473181164990141,0.9998010148243955,0.8553560158356762,0.810802021313854,22362,2,10049,7561
30,5,vg giraffe,High,125,0.25,42816,66,42816,31998,0,24986,4,110,0.9999065857076133,0.5717948717948718,0.9998406374501992,0.7275446049277824,0.679255851170234,42816,4,25096,32064
30,5,SAFARI,High,125,0.25,55831,74,55831,18975,0,24986,4,110,0.9999283603474524,0.7456063034188034,0.9998406374501992,0.8542401407642581,0.8094318863772755,55831,4,25096,19049
30,5,vg giraffe,High,125,0.2,34419,53,34419,25428,0,19910,4,78,0.9998837986230137,0.5746076794657763,0.9997999199679872,0.7298113927674056,0.681006859260001,34419,4,19988,25481
30,5,SAFARI,High,125,0.2,44745,58,44745,15097,0,19910,4,78,0.9999106125276542,0.7469949916527546,0.9997999199679872,0.8551443396496862,0.8102563460671907,44745,4,19988,15155
30,5,vg giraffe,High,125,0.35,59778,97,59778,44911,0,35010,4,145,0.9999330902278277,0.5704769721145955,0.9998862311214767,0.7264838850809392,0.678359355461074,59778,4,35155,45008
30,5,SAFARI,High,125,0.35,77891,108,77891,26787,0,35010,5,144,0.9999358118516997,0.7433340331723703,0.9998577889018458,0.8527495867135241,0.8077816284969095,77891,5,35154,26895
30,5,vg giraffe,High,125,0.3,51190,76,51190,38390,0,29885,4,131,0.9999218658436535,0.5709601142143303,0.9998667554963357,0.7268725594604188,0.6785487482870417,51190,4,30016,38466
30,5,SAFARI,High,125,0.3,66715,85,66715,22856,0,29885,5,130,0.9999250599520384,0.7441219773355938,0.9998334443704198,0.8532639279684863,0.8082656505899262,66715,5,30015,22941
30,5,vg giraffe,High,125,0.45,77126,118,77126,57901,0,45255,4,191,0.9999481395047323,0.5706907395760109,0.9999119911991199,0.7266611706512778,0.6787120352169218,77126,4,45446,58019
30,5,SAFARI,High,125,0.45,100460,133,100460,34552,0,45255,5,190,0.999950231423879,0.7433497354693107,0.9998899889988999,0.8527651627689826,0.8079127329106565,100460,5,45445,34685
30,5,vg giraffe,High,125,0.4,68354,106,68354,51313,0,40042,4,163,0.9999414845372889,0.5706962337087658,0.999900519784128,0.7266638671989198,0.6785700891350277,68354,4,40205,51419
30,5,SAFARI,High,125,0.4,89015,119,89015,30639,0,40042,5,162,0.9999438328465513,0.7431975486962838,0.99987564973016,0.852662685051702,0.8077096173319498,89015,5,40204,30758
30,5,vg giraffe,High,125,0.55,94175,138,94175,70891,0,55338,4,222,0.9999575276866393,0.5700527832255877,0.9999280109423367,0.7261462778979347,0.6782459414407885,94175,4,55560,71029
30,5,SAFARI,High,125,0.55,122805,158,122805,42241,0,55338,6,220,0.9999511444414588,0.7433536718239268,0.9998920164135051,0.8527680849955731,0.8079205319611538,122805,6,55558,42399
30,5,vg giraffe,High,125,0.5,85752,126,85752,64384,0,50381,4,204,0.9999533560333971,0.5706832066656906,0.9999209314277807,0.7266564414578549,0.6787967199565847,85752,4,50585,64510
30,5,SAFARI,High,125,0.5,111741,144,111741,38377,0,50381,6,202,0.999946307283417,0.7436411068666728,0.9998813971416711,0.8529554328286432,0.8081811890406321,111741,6,50583,38521
30,5,vg giraffe,High,125,0.65,111488,167,111488,83766,0,65462,5,266,0.9999551541352372,0.5705016349317628,0.9999239347055513,0.7265097063020912,0.6785881127610529,111488,5,65728,83933
30,5,SAFARI,High,125,0.65,145330,193,145330,49898,0,65462,7,264,0.9999518360775301,0.7436764728458047,0.9998935085877717,0.8529807077163266,0.8081668287677003,145330,7,65726,50091
30,5,vg giraffe,High,125,0.6,102795,153,102795,77358,0,60358,5,244,0.9999513618677043,0.5701141392965292,0.9999175012787301,0.7261944289418099,0.678240692698194,102795,5,60602,77511
30,5,SAFARI,High,125,0.6,134028,176,134028,46102,0,60358,7,242,0.9999477748349311,0.7433363282419886,0.9998845017902223,0.8527554471099856,0.8078767023780369,134028,7,60600,46278
30,5,vg giraffe,High,125,0.75,128383,195,128383,96682,0,75413,5,302,0.999961055550363,0.5699325224185385,0.9999339672477549,0.7260496312717729,0.6781115024254103,128383,5,75715,96877
30,5,SAFARI,High,125,0.75,167497,222,167497,57541,0,75413,8,299,0.9999522402316349,0.7435718725028856,0.9998943475964078,0.8529120466436673,0.8080570137550668,167497,8,75712,57763
30,5,vg giraffe,High,125,0.7,119950,181,119950,90286,0,70489,5,290,0.9999583177024718,0.5700585028776192,0.999929362567812,0.7261511266087926,0.6782657245173381,119950,5,70779,90467
30,5,SAFARI,High,125,0.7,156457,208,156457,53752,0,70489,8,287,0.9999488703543924,0.7435568418901515,0.9998869801084991,0.8529009327249634,0.8080803411083175,156457,8,70776,53960
30,5,vg giraffe,High,125,0.85,145590,224,145590,109469,0,85287,5,339,0.999965658161338,0.5703082461425163,0.9999416099309829,0.7263556493496774,0.6782238335767965,145590,5,85626,109693
30,5,SAFARI,High,125,0.85,189899,256,189899,65128,0,85287,9,335,0.9999526086315479,0.7438764038341762,0.9998948978757692,0.8531124843044895,0.8081832954938782,189899,9,85622,65384
30,5,vg giraffe,High,125,0.8,136975,210,136975,102950,0,80297,5,325,0.9999634983209228,0.5704083119911716,0.9999379860344549,0.7264362329793298,0.6783752439503432,136975,5,80622,103160
30,5,SAFARI,High,125,0.8,178613,238,178613,61284,0,80297,9,321,0.999949614269239,0.7438024444583256,0.999888374862019,0.8530627547718607,0.8081724144381193,178613,9,80618,61522
30,5,vg giraffe,High,125,0.95,162568,251,162568,122345,0,95215,6,373,0.9999630937296247,0.5700859856082815,0.9999372345544699,0.7261746825152209,0.6780054522820269,162568,6,95588,122596
30,5,SAFARI,High,125,0.95,211989,285,211989,72890,0,95215,10,369,0.9999528299661791,0.7433932754485139,0.9998953909241166,0.8527947574537929,0.8077913005110858,211989,10,95584,73175
30,5,vg giraffe,High,125,0.9,154073,241,154073,115849,0,90235,5,355,0.999967548903802,0.5702964506612674,0.9999448093161875,0.72634658130638,0.6781914746173335,154073,5,90590,116090
30,5,SAFARI,High,125,0.9,200888,274,200888,69001,0,90235,9,351,0.9999552009238565,0.743580727190622,0.9999006567691374,0.8529189487538742,0.8079488188758115,200888,9,90586,69275
30,5,vg giraffe,Mid,125,0.15,42414,50,42414,2434,0,14956,2,58,0.9999528479818937,0.9446745957503675,0.9998668087373468,0.971528048193875,0.9585071936442234,42414,2,15014,2484
30,5,SAFARI,Mid,125,0.15,43433,50,43433,1415,0,14956,3,57,0.9999309328667465,0.9673704842086507,0.9998002131060203,0.9833812574999433,0.9754982141068865,43433,3,15013,1465
30,5,vg giraffe,Mid,125,0.1,28246,36,28246,1643,0,10014,2,34,0.9999291985273294,0.9438930659983291,0.9998009950248756,0.9711034328640433,0.9579487179487179,28246,2,10048,1679
30,5,SAFARI,Mid,125,0.1,28931,36,28931,958,0,10014,3,33,0.9998963157530932,0.9667836257309942,0.9997014925373134,0.983061214087905,0.9750594121325828,28931,3,10047,994
30,5,vg giraffe,Mid,125,0.25,70706,84,70706,4091,0,24986,6,105,0.9999151487724856,0.9442448685247259,0.9997609276009085,0.9712829600324192,0.9581807997759507,70706,6,25091,4175
30,5,SAFARI,Mid,125,0.25,72395,85,72395,2401,0,24986,7,104,0.999903317587912,0.9668006570425074,0.9997210822010599,0.9830734029046122,0.9750645141931225,72395,7,25090,2486
30,5,vg giraffe,Mid,125,0.2,56556,66,56556,3279,0,19910,5,75,0.9999115998656318,0.9441578604697751,0.9997498749374687,0.9712352527004516,0.9580678674694271,56556,5,19985,3345
30,5,SAFARI,Mid,125,0.2,57920,66,57920,1915,0,19910,6,74,0.9998964195697959,0.9669287657968982,0.9996998499249625,0.9831362930397958,0.9751286127348512,57920,6,19984,1981
30,5,vg giraffe,Mid,125,0.35,98922,124,98922,5741,0,35010,8,131,0.9999191347417365,0.944029316613702,0.9997723975077527,0.9711707908520153,0.9580308140864395,98922,8,35141,5865
30,5,SAFARI,Mid,125,0.35,101251,125,101251,3411,0,35010,9,130,0.9999111198893936,0.9662553561033335,0.9997439471962218,0.9827951875057632,0.9746669906242854,101251,9,35140,3536
30,5,vg giraffe,Mid,125,0.3,84676,106,84676,4875,0,29885,7,122,0.9999173387811012,0.944443824798956,0.9997667755047644,0.9713892394172307,0.9583190580842477,84676,7,30007,4981
30,5,SAFARI,Mid,125,0.3,86661,107,86661,2889,0,29885,8,121,0.9999076947928325,0.9665837581003156,0.9997334577197308,0.9829633746583034,0.9748978449248356,86661,8,30006,2996
30,5,vg giraffe,Mid,125,0.45,127697,158,127697,7289,0,45257,9,175,0.9999295256291795,0.9448958148345469,0.9998019409784116,0.9716340117937987,0.9587119638951186,127697,9,45432,7447
30,5,SAFARI,Mid,125,0.45,130665,159,130665,4320,0,45257,11,173,0.9999158223392207,0.9668575741431362,0.9997579278625031,0.9831088706643594,0.9751363623778276,130665,11,45430,4479
30,5,vg giraffe,Mid,125,0.4,113145,137,113145,6491,0,40042,9,149,0.9999204623787051,0.9446619855894066,0.999776119402985,0.9715060941840147,0.9585117488576197,113145,9,40191,6628
30,5,SAFARI,Mid,125,0.4,115781,138,115781,3854,0,40042,10,148,0.9999136375020511,0.9666702846217428,0.9997512437810945,0.9830109863986009,0.9749832784282347,115781,10,40190,3992
30,5,vg giraffe,Mid,125,0.55,156059,191,156059,8954,0,55340,9,210,0.9999423328292796,0.9446441974770586,0.9998380100433774,0.9715070096366941,0.9585347182272391,156059,9,55550,9145
30,5,SAFARI,Mid,125,0.55,159699,192,159699,5313,0,55340,12,207,0.9999248642861168,0.9666775622866275,0.9997840133911697,0.9830201745071788,0.975009399219978,159699,12,55547,5505
30,5,vg giraffe,Mid,125,0.5,141943,176,141943,8141,0,50383,9,190,0.9999365982867449,0.9446492745907095,0.9998220710924834,0.9715069880771494,0.9585445275390606,141943,9,50573,8317
30,5,SAFARI,Mid,125,0.5,145281,177,145281,4802,0,50383,12,187,0.9999174082715616,0.9668641022228138,0.9997627614566447,0.9831130118794261,0.9751496200993816,145281,12,50570,4979
30,5,vg giraffe,Mid,125,0.65,184632,231,184632,10562,0,65462,11,260,0.9999404255780073,0.9447716515287194,0.9998326563522127,0.9715735078985865,0.9586304076459461,184632,11,65722,10793
30,5,SAFARI,Mid,125,0.65,188948,232,188948,6245,0,65462,14,257,0.9999259110297308,0.9668568504541384,0.9997870171755435,0.9831133727207216,0.9751453143307882,188948,14,65719,6477
30,5,vg giraffe,Mid,125,0.6,170354,209,170354,9745,0,60360,10,235,0.999941302153037,0.944794462808084,0.9998349971124495,0.971585983483141,0.9586406711136385,170354,10,60595,9954
30,5,SAFARI,Mid,125,0.6,174319,210,174319,5779,0,60360,13,232,0.9999254296399972,0.966784612995541,0.9997854962461843,0.9830757951725693,0.9750864419935827,174319,13,60592,5989
30,5,vg giraffe,Mid,125,0.75,212841,264,212841,12161,0,75413,12,296,0.9999436230638046,0.9448429856258823,0.9998415234875397,0.971612735352724,0.9586792785070452,212841,12,75709,12425
30,5,SAFARI,Mid,125,0.75,217837,265,217837,7164,0,75413,15,293,0.9999311459155757,0.9670212104800547,0.9998019043594247,0.9832008629755505,0.9752680348320691,217837,15,75706,7429
30,5,vg giraffe,Mid,125,0.7,198809,249,198809,11365,0,70489,12,284,0.9999396442025742,0.9448064137475466,0.9998304725577453,0.9715915199734144,0.958656937213735,198809,12,70773,11614
30,5,SAFARI,Mid,125,0.7,203456,250,203456,6717,0,70489,15,281,0.9999262794206546,0.9668905015136178,0.9997880906971816,0.9831309465708611,0.975171403374015,203456,15,70770,6967
30,5,vg giraffe,Mid,125,0.85,241157,311,241157,13821,0,85287,12,334,0.9999502423611658,0.9446431299429274,0.9998598671073068,0.9715101781016723,0.9585125043265028,241157,12,85621,14132
30,5,SAFARI,Mid,125,0.85,246849,312,246849,8128,0,85287,15,331,0.99993923779895,0.9669394294309587,0.9998248338841335,0.9831625022652458,0.975199605774928,246849,15,85618,8440
30,5,vg giraffe,Mid,125,0.8,226885,291,226885,12965,0,80297,12,316,0.9999471125664949,0.9447990971970633,0.9998511627906976,0.9715911767350836,0.9586365138449836,226885,12,80613,13256
30,5,SAFARI,Mid,125,0.8,232213,292,232213,7636,0,80297,15,313,0.9999354083056307,0.966986062355033,0.9998139534883721,0.9831847559852572,0.9752374004726186,232213,15,80610,7928
30,5,vg giraffe,Mid,125,0.95,269334,344,269334,15491,0,95213,15,367,0.9999443101700768,0.9444715239033696,0.9998430880276165,0.9714166176751702,0.9583731655303548,269334,15,95580,15835
30,5,SAFARI,Mid,125,0.95,275720,345,275720,9104,0,95213,18,364,0.9999347206406081,0.9668652623532011,0.9998117056331398,0.9831219792229372,0.9751368301625154,275720,18,95577,9449
30,5,vg giraffe,Mid,125,0.9,255195,324,255195,14649,0,90235,12,350,0.9999529793461778,0.9445789286666074,0.9998675452829564,0.9714775160599571,0.9584632655606835,255195,12,90585,14973
30,5,SAFARI,Mid,125,0.9,261231,325,261231,8612,0,90235,15,347,0.9999425828529432,0.966920582748512,0.9998344316036955,0.9831543768135578,0.9751860629495656,261231,15,90582,8937
30,5,vg giraffe,None,125,0.15,44665,51,44665,184,0,14958,4,54,0.9999104524390517,0.9947661469933184,0.9997336174746937,0.9973316660898303,0.9960110821817211,44665,4,15012,235
30,5,SAFARI,None,125,0.15,44665,51,44665,184,0,14958,4,54,0.9999104524390517,0.9947661469933184,0.9997336174746937,0.9973316660898303,0.9960110821817211,44665,4,15012,235
30,5,vg giraffe,None,125,0.1,29774,33,29774,118,0,10014,3,34,0.9998992510998421,0.994954051796157,0.9997015222365934,0.9974205219255636,0.9961476886131679,29774,3,10048,151
30,5,SAFARI,None,125,0.1,29774,33,29774,118,0,10014,3,34,0.9998992510998421,0.994954051796157,0.9997015222365934,0.9974205219255636,0.9961476886131679,29774,3,10048,151
30,5,vg giraffe,None,125,0.25,74493,83,74493,307,0,24988,8,106,0.9998926188910215,0.9947918753255078,0.9996813002947972,0.9973357253788894,0.9960194029104366,74493,8,25094,390
30,5,SAFARI,None,125,0.25,74493,83,74493,307,0,24988,8,106,0.9998926188910215,0.9947918753255078,0.9996813002947972,0.9973357253788894,0.9960194029104366,74493,8,25094,390
30,5,vg giraffe,None,125,0.2,59589,66,59589,248,0,19912,7,75,0.9998825424525136,0.9947581924110646,0.9996498949684905,0.9973137850525946,0.9959823272463296,59589,7,19987,314
30,5,SAFARI,None,125,0.2,59589,66,59589,248,0,19912,7,75,0.9998825424525136,0.9947581924110646,0.9996498949684905,0.9973137850525946,0.9959823272463296,59589,7,19987,314
30,5,vg giraffe,None,125,0.35,104238,120,104238,428,0,35012,9,140,0.9999136665803332,0.9947702937415304,0.9997440345837718,0.9973353489640391,0.996019921827549,104238,9,35152,548
30,5,SAFARI,None,125,0.35,104238,120,104238,428,0,35012,9,140,0.9999136665803332,0.9947702937415304,0.9997440345837718,0.9973353489640391,0.996019921827549,104238,9,35152,548
30,5,vg giraffe,None,125,0.3,89186,102,89186,369,0,29887,9,126,0.9998990974830427,0.9947466455491484,0.9997002198387849,0.9973162167602263,0.9959892713007295,89186,9,30013,471
30,5,SAFARI,None,125,0.3,89186,102,89186,369,0,29887,9,126,0.9998990974830427,0.9947466455491484,0.9997002198387849,0.9973162167602263,0.9959892713007295,89186,9,30013,471
30,5,vg giraffe,None,125,0.45,134432,160,134432,551,0,45257,11,184,0.9999181809391341,0.9947389061956594,0.999757986447241,0.9973218193823121,0.9960021041557076,134432,11,45441,711
30,5,SAFARI,None,125,0.45,134432,160,134432,551,0,45257,11,184,0.9999181809391341,0.9947389061956594,0.999757986447241,0.9973218193823121,0.9960021041557076,134432,11,45441,711
30,5,vg giraffe,None,125,0.4,119144,139,119144,489,0,40044,10,157,0.9999160749953842,0.9947567044050363,0.9997513118300962,0.997329717150917,0.9960120762831051,119144,10,40201,628
30,5,SAFARI,None,125,0.4,119144,139,119144,489,0,40044,10,157,0.9999160749953842,0.9947567044050363,0.9997513118300962,0.997329717150917,0.9960120762831051,119144,10,40201,628
30,5,vg giraffe,None,125,0.55,164326,198,164326,679,0,55340,11,215,0.9999330643738172,0.9946913796964946,0.9998020372170032,0.9973053347089883,0.9959776961439333,164326,11,55555,877
30,5,SAFARI,None,125,0.55,164326,198,164326,679,0,55340,11,215,0.9999330643738172,0.9946913796964946,0.9998020372170032,0.9973053347089883,0.9959776961439333,164326,11,55555,877
30,5,vg giraffe,None,125,0.5,149460,180,149460,619,0,50383,11,197,0.9999264071291422,0.9946825148576791,0.999782570022336,0.99729756781103,0.99596713965646,149460,11,50580,799
30,5,SAFARI,None,125,0.5,149460,180,149460,619,0,50383,11,197,0.9999264071291422,0.9946825148576791,0.999782570022336,0.99729756781103,0.99596713965646,149460,11,50580,799
30,5,vg giraffe,None,125,0.65,194403,239,194403,785,0,65464,13,258,0.999933133075467,0.9947601917851678,0.9998022362516163,0.9973399548023179,0.9960292845054027,194403,13,65722,1024
30,5,SAFARI,None,125,0.65,194403,239,194403,785,0,65464,13,258,0.999933133075467,0.9947601917851678,0.9998022362516163,0.9973399548023179,0.9960292845054027,194403,13,65722,1024
30,5,vg giraffe,None,125,0.6,179354,222,179354,731,0,60360,12,237,0.9999330976885251,0.9947145701498,0.9998020096025343,0.9973170073928262,0.9959944544986634,179354,12,60597,953
30,5,SAFARI,None,125,0.6,179354,222,179354,731,0,60360,12,237,0.9999330976885251,0.9947145701498,0.9998020096025343,0.9973170073928262,0.9959944544986634,179354,12,60597,953
30,5,vg giraffe,None,125,0.75,224097,273,224097,902,0,75415,14,293,0.9999375309556425,0.9947840832415924,0.999815113177148,0.9973541500234766,0.9960497551446208,224097,14,75708,1175
30,5,SAFARI,None,125,0.75,224097,273,224097,902,0,75415,14,293,0.9999375309556425,0.9947840832415924,0.999815113177148,0.9973541500234766,0.9960497551446208,224097,14,75708,1175
30,5,vg giraffe,None,125,0.7,209330,252,209330,847,0,70491,14,281,0.9999331244267808,0.9947773358234844,0.99980222077812,0.9973485669635732,0.996042174137226,209330,14,70772,1099
30,5,SAFARI,None,125,0.7,209330,252,209330,847,0,70491,14,281,0.9999331244267808,0.9947773358234844,0.99980222077812,0.9973485669635732,0.996042174137226,209330,14,70772,1099
30,5,vg giraffe,None,125,0.85,253960,315,253960,1020,0,85291,16,328,0.9999370019214414,0.994770755400615,0.9998131605068021,0.9973471884320921,0.996037309711671,253960,16,85619,1335
30,5,SAFARI,None,125,0.85,253960,315,253960,1020,0,85291,16,328,0.9999370019214414,0.994770755400615,0.9998131605068021,0.9973471884320921,0.996037309711671,253960,16,85619,1335
30,5,vg giraffe,None,125,0.8,238886,294,238886,967,0,80299,16,314,0.9999330269315452,0.9947490495404898,0.9998015602326706,0.9973343019190104,0.9960190288550266,238886,16,80613,1261
30,5,SAFARI,None,125,0.8,238886,294,238886,967,0,80299,16,314,0.9999330269315452,0.9947490495404898,0.9998015602326706,0.9973343019190104,0.9960190288550266,238886,16,80613,1261
30,5,vg giraffe,None,125,0.95,283677,355,283677,1142,0,95218,20,359,0.9999295022506407,0.9947505733341749,0.9997907884138624,0.9973333145827438,0.9960159781075765,283677,20,95577,1497
30,5,SAFARI,None,125,0.95,283677,355,283677,1142,0,95218,20,359,0.9999295022506407,0.9947505733341749,0.9997907884138624,0.9973333145827438,0.9960159781075765,283677,20,95577,1497
30,5,vg giraffe,None,125,0.9,268751,340,268751,1082,0,90238,17,343,0.9999367484224312,0.994736705740396,0.9998123578886952,0.9973299489183417,0.9960113202003487,268751,17,90581,1422
30,5,SAFARI,None,125,0.9,268751,340,268751,1082,0,90238,17,343,0.9999367484224312,0.994736705740396,0.9998123578886952,0.9973299489183417,0.9960113202003487,268751,17,90581,1422
30,5,vg giraffe,Single-stranded,125,0.15,44277,52,44277,571,0,14958,3,54,0.9999322493224932,0.9861247216035635,0.9998001998001999,0.9929804888988562,0.9895518651422849,44277,3,15012,623
30,5,SAFARI,Single-stranded,125,0.15,44455,52,44455,393,0,14958,3,54,0.9999325205812227,0.9900890868596882,0.9998001998001999,0.9949864589628237,0.9925227405491113,44455,3,15012,445
30,5,vg giraffe,Single-stranded,125,0.1,29504,34,29504,387,0,10014,2,28,0.9999322171761675,0.9859314954051797,0.9998008761449622,0.9928825023977386,0.9894167980184643,29504,2,10042,421
30,5,SAFARI,Single-stranded,125,0.1,29631,34,29631,260,0,10014,2,28,0.9999325076772517,0.9901754385964913,0.9998008761449622,0.9950300547365594,0.9925942605519278,29631,2,10042,294
30,5,vg giraffe,Single-stranded,125,0.25,73874,93,73874,915,0,24987,7,103,0.9999052530420541,0.9865388210784969,0.9997210822010599,0.9931770668781889,0.989847868052291,73874,7,25090,1008
30,5,SAFARI,Single-stranded,125,0.25,74155,93,74155,634,0,24987,7,103,0.9999056120385102,0.9902913917897492,0.9997210822010599,0.9950752797831512,0.992658458276238,74155,7,25090,727
30,5,vg giraffe,Single-stranded,125,0.2,59088,77,59088,738,0,19911,7,69,0.9998815466621541,0.9863946713854064,0.9996497723520288,0.9930923208793424,0.9897108524220803,59088,7,19980,815
30,5,SAFARI,Single-stranded,125,0.2,59315,77,59315,511,0,19911,7,69,0.9998819999325714,0.9901841310118024,0.9996497723520288,0.9950094359404488,0.9925522593566154,59315,7,19980,588
30,5,vg giraffe,Single-stranded,125,0.35,103369,123,103369,1293,0,35010,8,130,0.999922613347263,0.9864866154506847,0.9997723910322067,0.9931591741047837,0.9898237013427855,103369,8,35140,1416
30,5,SAFARI,Single-stranded,125,0.35,103773,125,103773,887,0,35010,8,130,0.9999229145990114,0.9903421291215345,0.9997723910322067,0.9951094617531142,0.9927107973101413,103773,8,35140,1012
30,5,vg giraffe,Single-stranded,125,0.3,88464,106,88464,1086,0,29885,7,119,0.9999208780278284,0.9867047381101097,0.9997667521908633,0.9932688475076771,0.9899805293021468,88464,7,30004,1192
30,5,SAFARI,Single-stranded,125,0.3,88802,107,88802,747,0,29885,7,119,0.9999211791597699,0.990474703310431,0.9997667521908633,0.9951755246126692,0.9928050339692647,88802,7,30004,854
30,5,vg giraffe,Single-stranded,125,0.45,133269,159,133269,1718,0,45255,10,171,0.9999249694250407,0.9861113166501413,0.999779910203363,0.9929701033808326,0.9895504535335747,133269,10,45426,1877
30,5,SAFARI,Single-stranded,125,0.45,133807,161,133807,1178,0,45255,10,171,0.9999252710791603,0.9900921965873943,0.999779910203363,0.9949844402389919,0.9925297094948555,133807,10,45426,1339
30,5,vg giraffe,Single-stranded,125,0.4,118132,142,118132,1501,0,40042,9,148,0.9999238198423918,0.9862826132331455,0.9997761138336775,0.993056372837472,0.9896733219148112,118132,9,40190,1643
30,5,SAFARI,Single-stranded,125,0.4,118602,144,118602,1029,0,40042,9,148,0.9999241217087791,0.9902066374452098,0.9997761138336775,0.9950416551307544,0.9926112993361421,118602,9,40190,1173
30,5,vg giraffe,Single-stranded,125,0.55,162932,194,162932,2079,0,55339,10,204,0.9999386284690258,0.9862413365212918,0.9998199917196191,0.9930427521811871,0.9896583589269698,162932,10,55543,2273
30,5,SAFARI,Single-stranded,125,0.55,163416,194,163416,1595,0,55339,11,203,0.9999326916604967,0.989171029932508,0.9998019908915811,0.9945227488497772,0.9918462751066779,163416,11,55542,1789
30,5,vg giraffe,Single-stranded,125,0.5,148192,179,148192,1890,0,50381,10,189,0.9999325245273343,0.986230625378508,0.9998022933965994,0.993034312460841,0.9896485279400122,148192,10,50570,2069
30,5,SAFARI,Single-stranded,125,0.5,148781,182,148781,1298,0,50381,11,188,0.9999260712941556,0.9901504715129009,0.9997825227362593,0.9950142616860557,0.9925762170074836,148781,11,50569,1480
30,5,vg giraffe,Single-stranded,125,0.65,192767,221,192767,2443,0,65463,12,255,0.9999377525560357,0.9863685904488029,0.9998174349612049,0.9931068236263877,0.9897534471073399,192767,12,65718,2664
30,5,SAFARI,Single-stranded,125,0.65,193378,225,193378,1828,0,65463,13,254,0.9999327786711895,0.9894950135853575,0.999802221207972,0.9946865146519487,0.9920891710477445,193378,13,65717,2053
30,5,vg giraffe,Single-stranded,125,0.6,177830,205,177830,2274,0,60359,11,233,0.9999381469964744,0.986251379576172,0.9998184908337872,0.9930476057517801,0.9896642757521419,177830,11,60592,2479
30,5,SAFARI,Single-stranded,125,0.6,177899,205,177899,2205,0,60359,11,233,0.9999381709853297,0.9866340559816759,0.9998184908337872,0.993241564517795,0.9899506873879259,177899,11,60592,2410
30,5,vg giraffe,Single-stranded,125,0.75,222163,266,222163,2847,0,75414,15,294,0.9999324865648264,0.9861813952662511,0.9998019095915376,0.9930093372726582,0.989607938896807,222163,15,75708,3113
30,5,SAFARI,Single-stranded,125,0.75,222495,266,222495,2515,0,75414,16,293,0.9999280934425714,0.9876551430245566,0.9997887035643067,0.9937537266602201,0.9907076103242868,222495,16,75707,2781
30,5,vg giraffe,Single-stranded,125,0.7,207535,249,207535,2649,0,70490,15,278,0.999927728258251,0.9862283957364102,0.9997880847096055,0.9930308170427984,0.9896414144287665,207535,15,70768,2898
30,5,SAFARI,Single-stranded,125,0.7,208215,253,208215,1965,0,70490,16,277,0.9999231622573008,0.9894598280687915,0.9997739570235791,0.9946639787514571,0.9920559285389167,208215,16,70767,2218
30,5,vg giraffe,Single-stranded,125,0.85,251761,306,251761,3231,0,85292,17,330,0.9999324802008118,0.986145602394065,0.9998014923107462,0.9929911886975523,0.9895757867289264,251761,17,85622,3537
30,5,SAFARI,Single-stranded,125,0.85,251861,306,251861,3131,0,85292,17,330,0.9999325070073607,0.9865373015064748,0.9998014923107462,0.9931897408394719,0.9898690960500034,251861,17,85622,3437
30,5,vg giraffe,Single-stranded,125,0.8,236813,288,236813,3050,0,80300,17,313,0.9999282185533928,0.9861004118242273,0.999789160362148,0.9929661768498116,0.9895411511280282,236813,17,80613,3338
30,5,SAFARI,Single-stranded,125,0.8,237500,289,237500,2362,0,80300,18,312,0.9999242162699248,0.988961111967054,0.9997767580305097,0.9944124487877589,0.9916796817766639,237500,18,80612,2651
30,5,vg giraffe,Single-stranded,125,0.95,281218,343,281218,3616,0,95219,18,369,0.9999359968140636,0.9861173937589637,0.9998117272974499,0.9929786216064956,0.9895557312169924,281218,18,95588,3959
30,5,SAFARI,Single-stranded,125,0.95,281328,343,281328,3506,0,95219,18,369,0.9999360218378793,0.9865031191154967,0.9998117272974499,0.9931741517996622,0.9898446096595699,281328,18,95588,3849
30,5,vg giraffe,Single-stranded,125,0.9,266426,322,266426,3428,0,90239,17,347,0.9999361964848016,0.9861201587113585,0.9998123682438771,0.9929801218369085,0.9895587049135344,266426,17,90586,3750
30,5,SAFARI,Single-stranded,125,0.9,266531,322,266531,3323,0,90239,17,347,0.9999362216186203,0.9865087942674405,0.9998123682438771,0.9931771264187925,0.9898497418086973,266531,17,90586,3645
29,11,vg giraffe,High,125,0.15,20758,22,20758,24116,0,14956,2,56,0.9999036608863199,0.4623574483250178,0.9998667909950713,0.6323260631168515,0.5970622600567518,20758,2,15012,24138
29,11,SAFARI,High,125,0.15,23253,25,23253,21618,0,14956,2,56,0.9999139969898947,0.5179303278688525,0.9998667909950713,0.6823964431923231,0.6387080620931397,23253,2,15012,21643
29,11,vg giraffe,High,125,0.1,13847,14,13847,16062,0,10014,2,35,0.9998555852408116,0.4627544029676169,0.9998010148243955,0.6326875628255506,0.5977885625656677,13847,2,10049,16076
29,11,SAFARI,High,125,0.1,15527,17,15527,14379,0,10014,2,35,0.9998712087062914,0.5188985061658257,0.9998010148243955,0.6832262606705976,0.6398158803222095,15527,2,10049,14396
29,11,vg giraffe,High,125,0.25,34310,40,34310,40530,0,24986,4,110,0.9998834295039926,0.4581997863247863,0.9998406374501992,0.6284228071139439,0.5941788357671535,34310,4,25096,40570
29,11,SAFARI,High,125,0.25,38538,44,38538,36298,0,24986,4,110,0.999896217113798,0.5146634615384615,0.9998406374501992,0.6795507044488724,0.6364672934586917,38538,4,25096,36342
29,11,vg giraffe,High,125,0.2,27599,31,27599,32270,0,19910,4,78,0.9998550882150491,0.46075125208681134,0.9997999199679872,0.6308126578517308,0.5956416161818455,27599,4,19988,32301
29,11,SAFARI,High,125,0.2,30967,34,30967,28899,0,19910,4,78,0.9998708469213134,0.5169782971619366,0.9997999199679872,0.6815595734612804,0.6377985280128173,30967,4,19988,28933
29,11,vg giraffe,High,125,0.35,47986,54,47986,56746,0,35010,4,145,0.9999166493019379,0.4579428549615407,0.9998862311214767,0.6281876734565639,0.5940976812319125,47986,4,35155,56800
29,11,SAFARI,High,125,0.35,53835,60,53835,50891,0,35010,4,145,0.9999257044150152,0.513761380337068,0.9998862311214767,0.6787706855791962,0.6358926721211905,53835,4,35155,50951
29,11,vg giraffe,High,125,0.3,41097,44,41097,48515,0,29885,4,131,0.99990267876694,0.4583853841349157,0.9998667554963357,0.6286011456365624,0.594212707643972,41097,4,30016,48559
29,11,SAFARI,High,125,0.3,46086,49,46086,43521,0,29885,4,131,0.9999132132783685,0.5140314089408405,0.9998667554963357,0.6790034328820003,0.6359002640462582,46086,4,30016,43570
29,11,vg giraffe,High,125,0.45,61991,64,61991,73090,0,45255,4,191,0.9999354786676344,0.45869991490621187,0.9999119911991199,0.6289033174393832,0.5949057282870511,61991,4,45446,73154
29,11,SAFARI,High,125,0.45,69489,70,69489,65586,0,45255,5,190,0.9999280513425619,0.5141810647822709,0.9998899889988999,0.6791374078254878,0.6364185054957224,69489,5,45445,65656
29,11,vg giraffe,High,125,0.4,54905,58,54905,64810,0,40042,4,163,0.9999271521972718,0.458408823357518,0.999900519784128,0.6286280212042454,0.5945043817429461,54905,4,40205,64868
29,11,SAFARI,High,125,0.4,61583,64,61583,58126,0,40042,5,162,0.9999188153536404,0.5141642941230494,0.99987564973016,0.6791206488715876,0.6362403270367917,61583,5,40204,58190
29,11,vg giraffe,High,125,0.55,75610,74,75610,89520,0,55338,4,222,0.9999470997434338,0.4576765695745866,0.9999280109423367,0.6279430939547708,0.5941531381359617,75610,4,55560,89594
29,11,SAFARI,High,125,0.55,84701,80,84701,80423,0,55338,5,221,0.9999409723042051,0.5127055034987046,0.999910013677921,0.6778520267296226,0.6353275837077837,84701,5,55559,80503
29,11,vg giraffe,High,125,0.5,68912,68,68912,81282,0,50381,4,204,0.9999419583260781,0.4586122905325365,0.9999209314277807,0.6288222358083384,0.594953472972502,68912,4,50585,81350
29,11,SAFARI,High,125,0.5,77187,74,77187,73001,0,50381,5,203,0.9999352264483367,0.5136827674328839,0.999901164284726,0.6787042654778549,0.6361481894538737,77187,5,50584,73075
29,11,vg giraffe,High,125,0.65,89459,90,89459,105872,0,65462,5,266,0.9999441115979611,0.4577757764006939,0.9999239347055513,0.6280358741246468,0.5942355851336759,89459,5,65728,105962
29,11,SAFARI,High,125,0.65,100182,97,100182,95142,0,65462,6,265,0.9999401125883339,0.5126470543083906,0.9999087216466614,0.6778007435497566,0.6352918201520942,100182,6,65727,95239
29,11,vg giraffe,High,125,0.6,82453,81,82453,97772,0,60358,5,244,0.999939363069684,0.4572948210264772,0.9999175012787301,0.627582164984549,0.5938035722439221,82453,5,60602,97853
29,11,SAFARI,High,125,0.6,92356,87,92356,87863,0,60358,6,243,0.9999350382191811,0.5122181180881391,0.9999010015344763,0.6774245602710991,0.6349055468156555,92356,6,60601,87950
29,11,vg giraffe,High,125,0.75,103029,101,103029,122130,0,75413,5,302,0.9999514723295223,0.4573781408150582,0.9999339672477549,0.6276630093757425,0.5938733470662503,103029,5,75715,122231
29,11,SAFARI,High,125,0.75,115437,108,115437,109715,0,75413,7,300,0.9999393645403832,0.512461155997514,0.9999075541468568,0.6776380670611439,0.6350920326932022,115437,7,75713,109823
29,11,vg giraffe,High,125,0.7,96286,95,96286,114036,0,70489,5,290,0.9999480740671506,0.4575961067784447,0.999929362567812,0.62786754828697,0.5941123964708518,96286,5,70779,114131
29,11,SAFARI,High,125,0.7,107876,102,107876,102439,0,70489,7,288,0.9999351148929859,0.5126772076400671,0.9999011075949367,0.6778259503612943,0.6353213537647447,107876,7,70777,102541
29,11,vg giraffe,High,125,0.85,116824,116,116824,138343,0,85287,5,339,0.9999572024069366,0.4576254588045424,0.9999416099309829,0.62789697725416,0.593844781968473,116824,5,85626,138459
29,11,SAFARI,High,125,0.85,130889,125,130889,124269,0,85287,8,336,0.9999388832440774,0.5127211761065171,0.9999065758895727,0.6778652441866488,0.6350927213314795,130889,8,85623,124394
29,11,vg giraffe,High,125,0.8,109929,110,109929,130096,0,80297,5,325,0.9999545181654447,0.45777999875070274,0.9999379860344549,0.6280419003110814,0.59405727611126,109929,5,80622,130206
29,11,SAFARI,High,125,0.8,123144,119,123144,116872,0,80297,8,322,0.9999350396258282,0.5128115435067775,0.999900777655128,0.6779433340581965,0.635246693810364,123144,8,80619,116991
29,11,vg giraffe,High,125,0.95,130421,131,130421,154612,0,95215,6,373,0.9999539972551695,0.4573543645060386,0.9999372345544699,0.6276411183110318,0.5935764974078024,130421,6,95588,154743
29,11,SAFARI,High,125,0.95,146117,140,146117,138907,0,95215,10,369,0.9999315663771925,0.5123963754190571,0.9998953909241166,0.6775796388053541,0.6347890261005679,146117,10,95584,139047
29,11,vg giraffe,High,125,0.9,123588,126,123588,146449,0,90235,5,355,0.9999595446344048,0.45745716474868875,0.9999448093161875,0.6277390058818151,0.5936888440450385,123588,5,90590,146575
29,11,SAFARI,High,125,0.9,138471,135,138471,131557,0,90235,8,352,0.9999422295077232,0.512546129558822,0.9999116949058999,0.6777130104100899,0.634935330609439,138471,8,90587,131692
29,11,vg giraffe,Mid,125,0.15,35215,30,35215,9653,0,14956,1,59,0.9999716038164471,0.7843333778787474,0.9999334043686734,0.8791222507926205,0.8383683279367092,35215,1,15015,9683
29,11,SAFARI,Mid,125,0.15,35512,30,35512,9356,0,14956,1,59,0.999971841297553,0.7909483718651165,0.9999334043686734,0.883262240240763,0.8433254331208065,35512,1,15015,9386
29,11,vg giraffe,Mid,125,0.1,23448,22,23448,6455,0,10014,1,35,0.9999573542581773,0.7835588972431078,0.9999004975124378,0.8786300445909994,0.837948717948718,23448,1,10049,6477
29,11,SAFARI,Mid,125,0.1,23659,22,23659,6244,0,10014,1,35,0.9999577345731192,0.790609857978279,0.9999004975124378,0.8830456284407949,0.8432270168855535,23659,1,10049,6266
29,11,vg giraffe,Mid,125,0.25,58675,52,58675,16154,0,24986,4,107,0.9999318325124832,0.7835766082183732,0.9998406184006057,0.8786313267445344,0.8378643301526336,58675,4,25093,16206
29,11,SAFARI,Mid,125,0.25,59181,53,59181,15647,0,24986,4,107,0.9999324153079328,0.7903339966079512,0.9998406184006057,0.8828636641654111,0.8429254435975915,59181,4,25093,15700
29,11,vg giraffe,Mid,125,0.2,46957,41,46957,12903,0,19910,3,77,0.9999361158432709,0.7839101183619639,0.9998499249624813,0.878842608622416,0.8379416955602008,46957,3,19987,12944
29,11,SAFARI,Mid,125,0.2,47351,41,47351,12509,0,19910,3,77,0.9999366473793132,0.7904876379359276,0.9998499249624813,0.8829611673115472,0.8428734150279756,47351,3,19987,12550
29,11,vg giraffe,Mid,125,0.35,82075,77,82075,22635,0,35010,6,133,0.9999269014753719,0.7832555565098724,0.9998292981308146,0.8784275531391142,0.8376543562771552,82075,6,35143,22712
29,11,SAFARI,Mid,125,0.35,82762,78,82762,21947,0,35010,6,133,0.9999275082157355,0.7898117132850448,0.9998292981308146,0.882535789501746,0.842563743425566,82762,6,35143,22025
29,11,vg giraffe,Mid,125,0.3,70288,66,70288,19303,0,29885,5,124,0.9999288691619365,0.7839655576251715,0.9998334110748317,0.8788746483276024,0.8381061410032505,70288,5,30009,19369
29,11,SAFARI,Mid,125,0.3,70879,67,70879,18711,0,29885,5,124,0.999929462219965,0.7905573463310172,0.9998334110748317,0.8830018499947055,0.8430446808332845,70879,5,30009,18778
29,11,vg giraffe,Mid,125,0.45,105975,97,105975,29072,0,45257,6,178,0.9999433860786368,0.7841635588705381,0.9998679606522743,0.8790046656298601,0.8384417310407841,105975,6,45435,29169
29,11,SAFARI,Mid,125,0.45,106890,98,106890,28156,0,45257,6,178,0.9999438706780422,0.7909341147220742,0.9998679606522743,0.883242439266237,0.8435085970595564,106890,6,45435,28254
29,11,vg giraffe,Mid,125,0.4,93893,84,93893,25796,0,40042,6,152,0.9999361015559272,0.783924590684044,0.9998507462686567,0.8788516979295369,0.8381851937514455,93893,6,40194,25880
29,11,SAFARI,Mid,125,0.4,94697,85,94697,24991,0,40042,6,152,0.9999366440345079,0.7906372888714485,0.9998507462686567,0.8830545142580055,0.8432110418633144,94697,6,40194,25076
29,11,vg giraffe,Mid,125,0.55,129545,118,129545,35541,0,55340,6,213,0.9999536861930822,0.7841517154548316,0.9998920066955849,0.8790012043900867,0.838446659992843,129545,6,55553,35659
29,11,SAFARI,Mid,125,0.55,130655,119,130655,34430,0,55340,6,213,0.999954079641209,0.79087068109731,0.9998920066955849,0.8832068679972285,0.8434746764629942,130655,6,55553,34549
29,11,vg giraffe,Mid,125,0.5,117735,110,117735,32415,0,50383,6,193,0.9999490406910082,0.7835418607746573,0.9998813807283223,0.8786161245666994,0.8380269067226974,117735,6,50576,32525
29,11,SAFARI,Mid,125,0.5,118760,111,118760,31389,0,50383,6,193,0.9999494804910496,0.7903633701583921,0.9998813807283223,0.882888642733416,0.8431304209278936,118760,6,50576,31500
29,11,vg giraffe,Mid,125,0.65,153113,143,153113,42169,0,65462,8,263,0.9999477537372404,0.7834872713317129,0.999878295528882,0.8785813063412001,0.8379525038482452,153113,8,65725,42312
29,11,SAFARI,Mid,125,0.65,154436,144,154436,40845,0,65462,8,263,0.9999482012897879,0.7902571318920302,0.999878295528882,0.8828218561804562,0.8430184026528003,154436,8,65725,40989
29,11,vg giraffe,Mid,125,0.6,141372,130,141372,38806,0,60360,7,238,0.9999504876961925,0.7840583889788584,0.9998844979787146,0.8789413311697396,0.838352434281255,141372,7,60598,38936
29,11,SAFARI,Mid,125,0.6,142590,131,142590,37587,0,60360,7,238,0.9999509106082176,0.7908134969052953,0.9998844979787146,0.8831699725925581,0.8434082013008846,142590,7,60598,37718
29,11,vg giraffe,Mid,125,0.75,176537,168,176537,48561,0,75413,9,299,0.9999490217846907,0.783682402137917,0.9998811426156549,0.8787044687565329,0.8380727406831524,176537,9,75712,48729
29,11,SAFARI,Mid,125,0.75,178091,169,178091,47006,0,75413,9,299,0.9999494665918024,0.7905809132314686,0.9998811426156549,0.8830243500939594,0.8432357543681288,178091,9,75712,47175
29,11,vg giraffe,Mid,125,0.7,164897,157,164897,45369,0,70489,9,287,0.9999454234533613,0.7836453239427249,0.999872854418309,0.8786797716137044,0.8380735967682285,164897,9,70776,45526
29,11,SAFARI,Mid,125,0.7,166333,158,166333,43932,0,70489,9,287,0.999945894602686,0.7904696729920209,0.999872854418309,0.8829535652196994,0.8431801371226992,166333,9,70776,44090
29,11,vg giraffe,Mid,125,0.85,200123,198,200123,54968,0,85287,9,337,0.999955029680411,0.7839076497616427,0.9998949003304801,0.8788483622845674,0.8381594616950505,200123,9,85624,55166
29,11,SAFARI,Mid,125,0.85,201892,199,201892,53198,0,85287,9,337,0.9999554236977528,0.7908370513418126,0.9998949003304801,0.883186421400293,0.8433483318764996,201892,9,85624,53397
29,11,vg giraffe,Mid,125,0.8,188226,185,188226,51730,0,80297,9,319,0.9999521874252929,0.7838145089759766,0.9998883720930233,0.8787887276598129,0.8381249883092348,188226,9,80616,51915
29,11,SAFARI,Mid,125,0.8,189880,186,189880,50075,0,80297,9,319,0.9999526038896408,0.7907021291657818,0.9998883720930233,0.8831011789875125,0.843281395160335,189880,9,80616,50261
29,11,vg giraffe,Mid,125,0.95,223470,217,223470,61482,0,95213,11,371,0.9999507788134114,0.7836405780431954,0.9998849312202521,0.8786788557947508,0.837931106932378,223470,11,95584,61699
29,11,SAFARI,Mid,125,0.95,225463,218,225463,59488,0,95213,11,371,0.9999512138871888,0.7906294162408958,0.9998849312202521,0.8830552851992487,0.8431653202508641,225463,11,95584,59706
29,11,vg giraffe,Mid,125,0.9,211745,206,211745,58217,0,90235,9,353,0.9999574978512803,0.7837530721625063,0.9999006589622172,0.8787521632131342,0.8380330686180755,211745,9,90588,58423
29,11,SAFARI,Mid,125,0.9,213623,207,213623,56338,0,90235,9,353,0.9999578714799281,0.790704302508069,0.9999006589622172,0.8831045886730053,0.8432386733746344,213623,9,90588,56545
29,11,vg giraffe,None,125,0.15,37256,34,37256,7610,0,14958,4,54,0.9998926462694578,0.8297550111358575,0.9997336174746937,0.9069133398247322,0.8723546298150744,37256,4,15012,7644
29,11,SAFARI,None,125,0.15,37256,34,37256,7610,0,14958,4,54,0.9998926462694578,0.8297550111358575,0.9997336174746937,0.9069133398247322,0.8723546298150744,37256,4,15012,7644
29,11,vg giraffe,None,125,0.1,24870,25,24870,5030,0,10014,3,34,0.9998793872874201,0.831077694235589,0.9997015222365934,0.9076973612175628,0.8734740844506704,24870,3,10048,5055
29,11,SAFARI,None,125,0.1,24870,25,24870,5030,0,10014,3,34,0.9998793872874201,0.831077694235589,0.9997015222365934,0.9076973612175628,0.8734740844506704,24870,3,10048,5055
29,11,vg giraffe,None,125,0.25,62134,58,62134,12691,0,24988,7,107,0.9998873529553757,0.8297477398074329,0.9997211377579476,0.9069068192433442,0.8724208631294694,62134,7,25095,12749
29,11,SAFARI,None,125,0.25,62134,58,62134,12691,0,24988,7,107,0.9998873529553757,0.8297477398074329,0.9997211377579476,0.9069068192433442,0.8724208631294694,62134,7,25095,12749
29,11,vg giraffe,None,125,0.2,49714,45,49714,10144,0,19912,6,76,0.9998793242156074,0.8299083518354673,0.9996999099729919,0.9069994435474308,0.8723982126988498,49714,6,19988,10189
29,11,SAFARI,None,125,0.2,49714,45,49714,10144,0,19912,6,76,0.9998793242156074,0.8299083518354673,0.9996999099729919,0.9069994435474308,0.8723982126988498,49714,6,19988,10189
29,11,vg giraffe,None,125,0.35,86984,81,86984,17721,0,35012,8,141,0.9999080375206916,0.8301108926765026,0.9997724751855749,0.9071322049453013,0.872737536353048,86984,8,35153,17802
29,11,SAFARI,None,125,0.35,86984,81,86984,17721,0,35012,8,141,0.9999080375206916,0.8301108926765026,0.9997724751855749,0.9071322049453013,0.872737536353048,86984,8,35153,17802
29,11,vg giraffe,None,125,0.3,74441,71,74441,15145,0,29887,8,127,0.9998925438891053,0.8302865364667567,0.9997335287455865,0.9072306923573789,0.8727930547548024,74441,8,30014,15216
29,11,SAFARI,None,125,0.3,74441,71,74441,15145,0,29887,8,127,0.9998925438891053,0.8302865364667567,0.9997335287455865,0.9072306923573789,0.8727930547548024,74441,8,30014,15216
29,11,vg giraffe,None,125,0.45,112220,108,112220,22815,0,45257,9,186,0.9999198068235483,0.8303796719030953,0.9998019889113791,0.9072975114402599,0.8730197403028876,112220,9,45443,22923
29,11,SAFARI,None,125,0.45,112220,108,112220,22815,0,45257,9,186,0.9999198068235483,0.8303796719030953,0.9998019889113791,0.9072975114402599,0.8730197403028876,112220,9,45443,22923
29,11,vg giraffe,None,125,0.4,99422,92,99422,20258,0,40044,8,159,0.9999195413858997,0.8300938449721137,0.999801049464077,0.9071267597923377,0.8727489795790803,99422,8,40203,20350
29,11,SAFARI,None,125,0.4,99422,92,99422,20258,0,40044,8,159,0.9999195413858997,0.8300938449721137,0.999801049464077,0.9071267597923377,0.8727489795790803,99422,8,40203,20350
29,11,vg giraffe,None,125,0.55,137121,133,137121,27949,0,55340,9,217,0.9999343688470794,0.8300151934286908,0.9998380304502753,0.9070858953537987,0.8727584035802128,137121,9,55557,28082
29,11,SAFARI,None,125,0.55,137121,133,137121,27949,0,55340,9,217,0.9999343688470794,0.8300151934286908,0.9998380304502753,0.9070858953537987,0.8727584035802128,137121,9,55557,28082
29,11,vg giraffe,None,125,0.5,124724,124,124724,25411,0,50383,9,199,0.9999278458787971,0.8300600962338363,0.9998221027455476,0.9071100250189097,0.8728205128205129,124724,9,50582,25535
29,11,SAFARI,None,125,0.5,124724,124,124724,25411,0,50383,9,199,0.9999278458787971,0.8300600962338363,0.9998221027455476,0.9071100250189097,0.8728205128205129,124724,9,50582,25535
29,11,vg giraffe,None,125,0.65,162082,159,162082,33186,0,65464,11,260,0.9999321377234057,0.8293736280043188,0.9998326614436753,0.9067017229805326,0.8722785091246047,162082,11,65724,33345
29,11,SAFARI,None,125,0.65,162082,159,162082,33186,0,65464,11,260,0.9999321377234057,0.8293736280043188,0.9998326614436753,0.9067017229805326,0.8722785091246047,162082,11,65724,33345
29,11,vg giraffe,None,125,0.6,149561,148,149561,30598,0,60360,10,239,0.999933142119796,0.8294797206985863,0.9998350080021119,0.9067655314995241,0.8723372461770907,149561,10,60599,30746
29,11,SAFARI,None,125,0.6,149561,148,149561,30598,0,60360,10,239,0.999933142119796,0.8294797206985863,0.9998350080021119,0.9067655314995241,0.8723372461770907,149561,10,60599,30746
29,11,vg giraffe,None,125,0.75,186704,178,186704,38390,0,75415,11,296,0.9999410866829125,0.8287936361376469,0.9998547317820449,0.9063586957840903,0.8718280098606617,186704,11,75711,38568
29,11,SAFARI,None,125,0.75,186704,178,186704,38390,0,75415,11,296,0.9999410866829125,0.8287936361376469,0.9998547317820449,0.9063586957840903,0.8718280098606617,186704,11,75711,38568
29,11,vg giraffe,None,125,0.7,174448,167,174448,35814,0,70491,11,284,0.9999369479361913,0.8290112104320222,0.9998446020399514,0.9064870819563093,0.8720125171132408,174448,11,70775,35981
29,11,SAFARI,None,125,0.7,174448,167,174448,35814,0,70491,11,284,0.9999369479361913,0.8290112104320222,0.9998446020399514,0.9064870819563093,0.8720125171132408,174448,11,70775,35981
29,11,vg giraffe,None,125,0.85,211751,207,211751,43337,0,85291,12,332,0.9999433328768482,0.829436534205527,0.9998598703801016,0.9067439161731521,0.8722435690610976,211751,12,85623,43544
29,11,SAFARI,None,125,0.85,211751,207,211751,43337,0,85291,12,332,0.9999433328768482,0.829436534205527,0.9998598703801016,0.9067439161731521,0.8722435690610976,211751,12,85623,43544
29,11,vg giraffe,None,125,0.8,199134,194,199134,40819,0,80299,12,318,0.9999397427013347,0.8292171045234794,0.999851170174503,0.9066113049832344,0.872107015487443,199134,12,80617,41013
29,11,SAFARI,None,125,0.8,199134,194,199134,40819,0,80299,12,318,0.9999397427013347,0.8292171045234794,0.999851170174503,0.9066113049832344,0.872107015487443,199134,12,80617,41013
29,11,vg giraffe,None,125,0.95,236447,232,236447,48495,0,95218,14,365,0.9999407936192438,0.8291323893482575,0.9998535518897037,0.9065611011531051,0.8719939281090209,236447,14,95583,48727
29,11,SAFARI,None,125,0.95,236447,232,236447,48495,0,95218,14,365,0.9999407936192438,0.8291323893482575,0.9998535518897037,0.9065611011531051,0.8719939281090209,236447,14,95583,48727
29,11,vg giraffe,None,125,0.9,224077,222,224077,45874,0,90238,12,348,0.9999464498480515,0.8293833950838907,0.9998675467449613,0.9067134434773461,0.8721959359261138,224077,12,90586,46096
29,11,SAFARI,None,125,0.9,224077,222,224077,45874,0,90238,12,348,0.9999464498480515,0.8293833950838907,0.9998675467449613,0.9067134434773461,0.8721959359261138,224077,12,90586,46096
29,11,vg giraffe,Single-stranded,125,0.15,36952,34,36952,7914,0,14958,2,55,0.9999458786599557,0.8229844097995546,0.9998667998667998,0.9028758521269579,0.8673120253692731,36952,2,15013,7948
29,11,SAFARI,Single-stranded,125,0.15,37013,34,37013,7853,0,14958,2,55,0.9999459678508713,0.8243429844097996,0.9998667998667998,0.9036928523469451,0.8683301343570058,37013,2,15013,7887
29,11,vg giraffe,Single-stranded,125,0.1,24596,21,24596,5308,0,10014,1,29,0.9999593446355246,0.8219214703425229,0.9999004380724811,0.9022412970910826,0.8666466511546449,24596,1,10043,5329
29,11,SAFARI,Single-stranded,125,0.1,24634,21,24634,5270,0,10014,1,29,0.9999594073472702,0.8231913116123643,0.9999004380724811,0.9030058651026392,0.8675973879756812,24634,1,10043,5291
29,11,vg giraffe,Single-stranded,125,0.25,61577,57,61577,13248,0,24987,5,105,0.9999188074437335,0.8223204508426591,0.9998007730007571,0.9024651190057451,0.8668720431290571,61577,5,25092,13305
29,11,SAFARI,Single-stranded,125,0.25,61665,57,61665,13160,0,24987,5,105,0.9999189233014432,0.8234956331294571,0.9998007730007571,0.9031724178334993,0.8677522279678732,61665,5,25092,13217
29,11,vg giraffe,Single-stranded,125,0.2,49249,49,49249,10605,0,19911,5,71,0.9998984854022008,0.8221458023805152,0.9997498373943063,0.9023516586201527,0.8665790461885092,49249,5,19982,10654
29,11,SAFARI,Single-stranded,125,0.2,49322,49,49322,10532,0,19911,5,71,0.999898635635656,0.8233644391766689,0.9997498373943063,0.9030852329945985,0.86749280260358,49322,5,19982,10581
29,11,vg giraffe,Single-stranded,125,0.35,86099,78,86099,18608,0,35010,6,132,0.999930317635445,0.8216729493725247,0.999829293274155,0.9020797317827022,0.8664217875697655,86099,6,35142,18686
29,11,SAFARI,Single-stranded,125,0.35,86223,78,86223,18484,0,35010,6,132,0.9999304178408656,0.8228563248556569,0.999829293274155,0.902792465473735,0.8673079259359836,86223,6,35142,18562
29,11,vg giraffe,Single-stranded,125,0.3,73742,67,73742,15847,0,29885,5,121,0.9999322006318901,0.8224993307754083,0.9998333944220452,0.9025782880363273,0.866972515396893,73742,5,30006,15914
29,11,SAFARI,Single-stranded,125,0.3,73850,67,73850,15739,0,29885,5,121,0.9999322997765893,0.8237039350405996,0.9998333944220452,0.9033031416846572,0.8678750198467414,73850,5,30006,15806
29,11,vg giraffe,Single-stranded,125,0.45,110953,101,110953,24092,0,45255,7,174,0.9999369142033165,0.8209861927101061,0.999845937142354,0.9016683867926828,0.8659888582472228,110953,7,45429,24193
29,11,SAFARI,Single-stranded,125,0.45,111115,101,111115,23930,0,45255,7,174,0.999937006173395,0.8221848963343347,0.999845937142354,0.9023908912241948,0.8668859576258985,111115,7,45429,24031
29,11,vg giraffe,Single-stranded,125,0.4,98388,91,98388,21296,0,40042,6,151,0.9999390206719921,0.8214402003757044,0.999850742555785,0.9019429891506126,0.8662720192031205,98388,6,40193,21387
29,11,SAFARI,Single-stranded,125,0.4,98530,91,98530,21154,0,40042,6,151,0.9999391085491597,0.822625756627009,0.999850742555785,0.9026572183719556,0.8671596634453098,98530,6,40193,21245
29,11,vg giraffe,Single-stranded,125,0.55,135695,125,135695,29385,0,55339,7,207,0.9999484163829567,0.8213734451136466,0.9998739942037334,0.9019065691393022,0.8662925012910064,135695,7,55546,29510
29,11,SAFARI,Single-stranded,125,0.55,135832,125,135832,29248,0,55339,7,207,0.999948468407453,0.8222027178354167,0.9998739942037334,0.9024062927678347,0.8669130903523316,135832,7,55546,29373
29,11,vg giraffe,Single-stranded,125,0.5,123440,114,123440,26707,0,50381,7,192,0.9999432955033334,0.821503916518591,0.9998616053776196,0.9019831353120844,0.8664216967651027,123440,7,50573,26821
29,11,SAFARI,Single-stranded,125,0.5,123618,114,123618,26529,0,50381,7,192,0.999943377148635,0.8226885219717691,0.9998616053776196,0.9026967424402854,0.867307969986208,123618,7,50573,26643
29,11,vg giraffe,Single-stranded,125,0.65,160484,147,160484,34800,0,65463,9,258,0.9999439227879098,0.8211798537591273,0.9998630762209036,0.9017880221620346,0.8661515310478977,160484,9,65721,34947
29,11,SAFARI,Single-stranded,125,0.65,160653,147,160653,34631,0,65463,9,258,0.9999439817754042,0.8220446090947701,0.9998630762209036,0.902309228207238,0.8667986414510589,160653,9,65721,34778
29,11,vg giraffe,Single-stranded,125,0.6,148096,134,148096,32079,0,60359,8,236,0.9999459839032031,0.8213455789783095,0.9998679933336634,0.9018887802857987,0.8662540678754068,148096,8,60595,32213
29,11,SAFARI,Single-stranded,125,0.6,148133,134,148133,32042,0,60359,8,236,0.9999459973943743,0.8215507822682173,0.9998679933336634,0.9020124828741056,0.8664076509264794,148133,8,60595,32176
29,11,vg giraffe,Single-stranded,125,0.75,184981,179,184981,40116,0,75414,12,297,0.999935132680696,0.821130524334594,0.9998415276732301,0.9017547024025699,0.8660892561104854,184981,12,75711,40295
29,11,SAFARI,Single-stranded,125,0.75,185093,179,185093,40004,0,75414,12,297,0.9999351719294455,0.8216276922530584,0.9998415276732301,0.9020544323445774,0.8664613503699348,185093,12,75711,40183
29,11,vg giraffe,Single-stranded,125,0.7,172741,166,172741,37526,0,70490,12,281,0.9999305366621708,0.8208836066586515,0.9998304677676844,0.9016039208113031,0.8659251251706873,172741,12,70771,37692
29,11,SAFARI,Single-stranded,125,0.7,172934,166,172934,37333,0,70490,12,281,0.9999306141801487,0.8218007631882832,0.9998304677676844,0.9021568734855065,0.8666114303595812,172934,12,70771,37499
29,11,vg giraffe,Single-stranded,125,0.85,209604,205,209604,45489,0,85292,13,334,0.9999379821293121,0.8210170075754608,0.9998482000023354,0.9016874052246111,0.8659371086153747,209604,13,85626,45694
29,11,SAFARI,Single-stranded,125,0.85,209651,205,209651,45442,0,85292,13,334,0.999937996031746,0.8212011061582934,0.9998482000023354,0.9017984265380826,0.8660749639962808,209651,13,85626,45647
29,11,vg giraffe,Single-stranded,125,0.8,197121,195,197121,42835,0,80300,13,317,0.9999340550082685,0.8208210667455059,0.9998387696887014,0.9015676275198098,0.8658181126687677,197121,13,80617,43030
29,11,SAFARI,Single-stranded,125,0.8,197316,195,197316,42640,0,80300,13,317,0.9999341201749363,0.8216330558690157,0.9998387696887014,0.9020572369022584,0.8664260040339048,197316,13,80617,42835
29,11,vg giraffe,Single-stranded,125,0.95,234083,227,234083,50867,0,95219,13,374,0.9999444672271205,0.8208340784845902,0.9998640252703805,0.9015797085540745,0.8657844494108193,234083,13,95593,51094
29,11,SAFARI,Single-stranded,125,0.95,234139,227,234139,50811,0,95219,13,374,0.9999444805083877,0.8210304477570071,0.9998640252703805,0.9016981528087205,0.8659315147997678,234139,13,95593,51038
29,11,vg giraffe,Single-stranded,125,0.9,221728,214,221728,48234,0,90239,13,351,0.9999413730433253,0.8206798531327727,0.9998565168923766,0.9014854131896235,0.865676771652452,221728,13,90590,48448
29,11,SAFARI,Single-stranded,125,0.9,221779,214,221779,48183,0,90239,13,351,0.9999413865243111,0.8208686189742982,0.9998565168923766,0.9015992910107973,0.8658181324301026,221779,13,90590,48397
10,10,vg giraffe,High,125,0.15,44256,74,44256,566,0,14956,15,43,0.9996611777461544,0.9857448325017819,0.9990009324630345,0.9926542330682876,0.9890669337339343,44256,15,14999,640
10,10,SAFARI,High,125,0.15,44295,74,44295,527,0,14956,15,43,0.9996614759647935,0.9866135067712045,0.9990009324630345,0.9930946348900298,0.9897179101986313,44295,15,14999,601
10,10,vg giraffe,High,125,0.1,29506,48,29506,369,0,10014,10,27,0.9996612007047025,0.9860642315275875,0.9990050741219779,0.9928161644711386,0.989318056736879,29506,10,10041,417
10,10,SAFARI,High,125,0.1,29532,48,29532,343,0,10014,10,27,0.9996614988829463,0.9869331283627979,0.9990050741219779,0.9932565374590095,0.9899684795116825,29532,10,10041,391
10,10,vg giraffe,High,125,0.25,73780,130,73780,970,1,24985,31,83,0.9995664661572644,0.9853098290598291,0.9987250996015936,0.99238694751567,0.9886777355471095,73780,32,25068,1100
10,10,SAFARI,High,125,0.25,73856,129,73856,895,1,24985,31,83,0.9995669120831528,0.9863247863247864,0.9987250996015936,0.99290169929017,0.9894378875775155,73856,32,25068,1024
10,10,vg giraffe,High,125,0.2,59032,95,59032,773,0,19910,23,59,0.9996105325543985,0.98550918196995,0.9988495398159264,0.9925097726030853,0.9888474440494668,59032,23,19969,868
10,10,SAFARI,High,125,0.2,59094,95,59094,711,0,19910,23,59,0.9996109410152748,0.9865442404006678,0.9988495398159264,0.9930346085013065,0.9896234917138137,59094,23,19969,806
10,10,vg giraffe,High,125,0.35,103248,182,103248,1356,3,35007,35,114,0.9996320895377883,0.9853224667417403,0.9989191956540289,0.9924256987965704,0.9887384329558041,103248,38,35121,1538
10,10,SAFARI,High,125,0.35,103342,182,103342,1262,4,35006,35,114,0.9996227546647837,0.9862195331437406,0.998890753434398,0.9928759121282432,0.9894029797420415,103342,39,35120,1444
10,10,vg giraffe,High,125,0.3,88335,150,88335,1171,1,29884,34,101,0.999603937988005,0.9852659052377978,0.998834110592938,0.9923831350476897,0.98866940739998,88335,35,29985,1321
10,10,SAFARI,High,125,0.3,88419,150,88419,1087,1,29884,34,101,0.9996043141067673,0.98620281966628,0.998834110592938,0.9928583459659761,0.9893713025167954,88419,35,29985,1237
10,10,vg giraffe,High,125,0.45,133118,229,133118,1798,4,45251,41,154,0.9996620682922434,0.985001294905472,0.999009900990099,0.9922775317918213,0.9885268141421413,133118,45,45405,2027
10,10,SAFARI,High,125,0.45,133246,229,133246,1670,5,45250,41,154,0.9996548930168352,0.9859484257649191,0.998987898789879,0.9927543520453589,0.9892300451286027,133246,46,45404,1899
10,10,vg giraffe,High,125,0.4,117995,200,117995,1578,4,40038,38,129,0.9996441793674865,0.9851552520184015,0.9989554577333433,0.9923468315041419,0.988623720168519,117995,42,40167,1778
10,10,SAFARI,High,125,0.4,118106,200,118106,1467,5,40037,38,129,0.9996360527808107,0.986082005126364,0.9989305876793753,0.992812770571868,0.9893112975209711,118106,43,40166,1667
10,10,vg giraffe,High,125,0.55,162739,276,162739,2189,5,55333,47,179,0.9996805720217948,0.9850790537759376,0.999064142250378,0.9923261025320509,0.988598891143644,162739,52,55512,2465
10,10,SAFARI,High,125,0.55,162897,276,162897,2031,6,55332,47,179,0.9996747468548635,0.9860354470836057,0.9990461449859621,0.9928082546609214,0.9893100449340484,162897,53,55511,2307
10,10,vg giraffe,High,125,0.5,148014,249,148014,1999,5,50376,45,163,0.9996623081910525,0.9850394644021775,0.9990116428472593,0.9922970173568512,0.9885586828046662,148014,50,50539,2248
10,10,SAFARI,High,125,0.5,148161,249,148161,1852,6,50375,45,163,0.9996558983078293,0.9860177556534586,0.9989918757042044,0.992789991758076,0.9892855898153358,148161,51,50538,2101
10,10,vg giraffe,High,125,0.65,192503,325,192503,2593,5,65457,58,213,0.9996728394420614,0.9850681349496727,0.9990415772899457,0.9923167528808955,0.9885852791839298,192503,63,65670,2918
10,10,SAFARI,High,125,0.65,192687,325,192687,2409,6,65456,58,213,0.9996679654061458,0.986009691895958,0.999026364231056,0.9927918551569923,0.9892860151481502,192687,64,65669,2734
10,10,vg giraffe,High,125,0.6,177612,302,177612,2392,5,60353,52,197,0.9996791786974655,0.9850587334864065,0.9990595145775241,0.9923151058034779,0.9885809400073886,177612,57,60550,2694
10,10,SAFARI,High,125,0.6,177785,302,177785,2219,6,60352,52,197,0.9996738696490725,0.9860182134815259,0.9990430148332701,0.9927990864137552,0.9892948906866794,177785,58,60549,2521
10,10,vg giraffe,High,125,0.75,221888,375,221888,2997,6,75407,63,244,0.9996891289754322,0.9850306312705318,0.9990887480190175,0.9923057486634005,0.9885673466675526,221888,69,75651,3372
10,10,SAFARI,High,125,0.75,222096,375,222096,2789,7,75406,63,244,0.999684920284832,0.9859540087010565,0.9990755414685684,0.9927719891110486,0.989255100006645,222096,70,75650,3164
10,10,vg giraffe,High,125,0.7,207255,353,207255,2809,6,70483,61,234,0.9996768312094231,0.9849726970729551,0.9990534584086799,0.9922702931734887,0.9885171105365913,207255,67,70717,3162
10,10,SAFARI,High,125,0.7,207448,353,207448,2616,7,70482,61,234,0.999672314423948,0.9858899233426957,0.9990393309222423,0.9927332850002273,0.9891998961596865,207448,68,70716,2969
10,10,vg giraffe,High,125,0.85,251470,430,251470,3383,6,85281,71,273,0.9996938941827969,0.9850636352596922,0.9991007929371373,0.9923248426494091,0.9885894976445673,251470,77,85554,3813
10,10,SAFARI,High,125,0.85,251711,430,251711,3142,7,85280,71,273,0.9996902168085182,0.9860076855881512,0.9990891149233339,0.9928018111826329,0.9892934875071132,251711,78,85553,3572
10,10,vg giraffe,High,125,0.8,236540,399,236540,3196,6,80291,68,262,0.999687254346742,0.9850292543777458,0.9990821933099334,0.9923041264900399,0.9885616126598538,236540,74,80553,3595
10,10,SAFARI,High,125,0.8,236761,399,236761,2975,7,80290,68,262,0.9996833251701599,0.9859495700335228,0.9990697905168244,0.9927689524101045,0.9892474794395845,236761,75,80552,3374
10,10,vg giraffe,High,125,0.95,280900,473,280900,3791,6,95209,76,303,0.999708166359411,0.9850472009089506,0.9991422055777559,0.9923235349185545,0.9885859259687255,280900,82,95512,4264
10,10,SAFARI,High,125,0.95,281164,473,281164,3527,8,95207,76,303,0.9997013312094664,0.9859729839671206,0.9991212837625792,0.9927897007831755,0.9892740270723136,281164,84,95510,4000
10,10,vg giraffe,High,125,0.9,266118,456,266118,3589,6,90229,72,288,0.9997069828246856,0.985027557437547,0.9991390253325239,0.9923129844003736,0.9885712860144473,266118,78,90517,4045
10,10,SAFARI,High,125,0.9,266372,456,266372,3335,7,90228,72,288,0.9997035102138855,0.985967730592272,0.9991279871957613,0.9927881121252893,0.9892725871636943,266372,79,90516,3791
10,10,vg giraffe,Mid,125,0.15,44825,61,44825,12,2,14954,23,37,0.9994425863991081,0.9983740923871888,0.9983351092168353,0.998908053661363,0.9983643221951464,44825,25,14991,73
10,10,SAFARI,Mid,125,0.15,44825,61,44825,12,2,14954,23,37,0.9994425863991081,0.9983740923871888,0.9983351092168353,0.998908053661363,0.9983643221951464,44825,25,14991,73
10,10,vg giraffe,Mid,125,0.1,29876,44,29876,5,0,10014,17,19,0.9994313049877898,0.9983625730994152,0.9983084577114428,0.9988966531813167,0.9983489681050657,29876,17,10033,49
10,10,SAFARI,Mid,125,0.1,29876,44,29876,5,0,10014,17,19,0.9994313049877898,0.9983625730994152,0.9983084577114428,0.9988966531813167,0.9983489681050657,29876,17,10033,49
10,10,vg giraffe,Mid,125,0.25,74760,105,74760,16,4,24982,41,70,0.9993984359334269,0.9983841027764052,0.9982069570068136,0.9988910118514758,0.9983396347196383,74760,45,25052,121
10,10,SAFARI,Mid,125,0.25,74760,105,74760,16,4,24982,41,70,0.9993984359334269,0.9983841027764052,0.9982069570068136,0.9988910118514758,0.9983396347196383,74760,45,25052,121
10,10,vg giraffe,Mid,125,0.2,59805,82,59805,14,2,19908,31,49,0.999448510979645,0.9983973556368008,0.9983491745872937,0.9989226567784932,0.9983852999712107,59805,33,19957,96
10,10,SAFARI,Mid,125,0.2,59805,82,59805,14,2,19908,31,49,0.999448510979645,0.9983973556368008,0.9983491745872937,0.9989226567784932,0.9983852999712107,59805,33,19957,96
10,10,vg giraffe,Mid,125,0.35,104607,160,104607,20,5,35005,44,95,0.9995317994190491,0.9982822296658936,0.9986059347349854,0.9989066237592089,0.9983635376171964,104607,49,35100,180
10,10,SAFARI,Mid,125,0.35,104607,160,104607,20,5,35005,44,95,0.9995317994190491,0.9982822296658936,0.9986059347349854,0.9989066237592089,0.9983635376171964,104607,49,35100,180
10,10,vg giraffe,Mid,125,0.3,89504,135,89504,18,4,29881,43,86,0.9994751594063718,0.9982934963248826,0.9984340641034184,0.9988839783938217,0.9983287513265536,89504,47,29967,153
10,10,SAFARI,Mid,125,0.3,89504,135,89504,18,4,29881,43,86,0.9994751594063718,0.9982934963248826,0.9984340641034184,0.9988839783938217,0.9983287513265536,89504,47,29967,153
10,10,vg giraffe,Mid,125,0.45,134910,210,134910,24,6,45251,52,132,0.9995702685080908,0.9982685135855088,0.9987236196386523,0.9989189669470442,0.9983830329207852,134910,58,45383,234
10,10,SAFARI,Mid,125,0.45,134910,210,134910,24,6,45251,52,132,0.9995702685080908,0.9982685135855088,0.9987236196386523,0.9989189669470442,0.9983830329207852,134910,58,45383,234
10,10,vg giraffe,Mid,125,0.4,119570,180,119570,23,6,40036,48,110,0.9995485855681134,0.9983051271989514,0.9986567164179104,0.9989264694210872,0.9983934788995643,119570,54,40146,203
10,10,SAFARI,Mid,125,0.4,119570,180,119570,23,6,40036,48,110,0.9995485855681134,0.9983051271989514,0.9986567164179104,0.9989264694210872,0.9983934788995643,119570,54,40146,203
10,10,vg giraffe,Mid,125,0.55,164921,256,164921,27,6,55334,60,159,0.9995999684823653,0.998286966417278,0.9988120736514337,0.9989430360003755,0.9984191191458713,164921,66,55493,283
10,10,SAFARI,Mid,125,0.55,164921,256,164921,27,6,55334,60,159,0.9995999684823653,0.998286966417278,0.9988120736514337,0.9989430360003755,0.9984191191458713,164921,66,55493,283
10,10,vg giraffe,Mid,125,0.5,150001,235,150001,24,6,50377,57,142,0.9995801791235739,0.9982763210435246,0.9987544976473844,0.9989278246160813,0.9983967496838311,150001,63,50519,259
10,10,SAFARI,Mid,125,0.5,150001,235,150001,24,6,50377,57,142,0.9995801791235739,0.9982763210435246,0.9987544976473844,0.9989278246160813,0.9983967496838311,150001,63,50519,259
10,10,vg giraffe,Mid,125,0.65,195090,307,195090,28,7,65455,70,201,0.9996054660880169,0.9982857873864655,0.9988285944654892,0.9989451908897264,0.9984224109542882,195090,77,65656,335
10,10,SAFARI,Mid,125,0.65,195090,307,195090,28,7,65455,70,201,0.9996054660880169,0.9982857873864655,0.9988285944654892,0.9989451908897264,0.9984224109542882,195090,77,65656,335
10,10,vg giraffe,Mid,125,0.6,180002,279,180002,27,6,60354,64,181,0.9996112666044693,0.9983029039199591,0.9988449797871463,0.9989566568622009,0.9984392706080618,180002,70,60535,306
10,10,SAFARI,Mid,125,0.6,180002,279,180002,27,6,60354,64,181,0.9996112666044693,0.9983029039199591,0.9988449797871463,0.9989566568622009,0.9984392706080618,180002,70,60535,306
10,10,vg giraffe,Mid,125,0.75,224886,349,224886,31,7,75406,76,232,0.9996310602794163,0.9983131053953992,0.9989038707888168,0.998971648139305,0.9984617275829188,224886,83,75638,380
10,10,SAFARI,Mid,125,0.75,224886,349,224886,31,7,75406,76,232,0.9996310602794163,0.9983131053953992,0.9989038707888168,0.998971648139305,0.9984617275829188,224886,83,75638,380
10,10,vg giraffe,Mid,125,0.7,210065,329,210065,29,7,70482,73,223,0.9996193104760999,0.9982986650698831,0.9988698170516352,0.9989585512925379,0.9984424340701544,210065,80,70705,358
10,10,SAFARI,Mid,125,0.7,210065,329,210065,29,7,70482,73,223,0.9996193104760999,0.9982986650698831,0.9988698170516352,0.9989585512925379,0.9984424340701544,210065,80,70705,358
10,10,vg giraffe,Mid,125,0.85,254844,411,254844,34,9,85278,82,264,0.9996430462666954,0.9982568774996181,0.9989373255637429,0.9989494810122613,0.9984277928675768,254844,91,85542,445
10,10,SAFARI,Mid,125,0.85,254844,411,254844,34,9,85278,82,264,0.9996430462666954,0.9982568774996181,0.9989373255637429,0.9989494810122613,0.9984277928675768,254844,91,85542,445
10,10,vg giraffe,Mid,125,0.8,239725,385,239725,31,8,80289,80,248,0.9996330474161117,0.9982676844020805,0.9989085271317829,0.9989498993653557,0.9984287611529901,239725,88,80537,416
10,10,SAFARI,Mid,125,0.8,239725,385,239725,31,8,80289,80,248,0.9996330474161117,0.9982676844020805,0.9989085271317829,0.9989498993653557,0.9984287611529901,239725,88,80537,416
10,10,vg giraffe,Mid,125,0.95,284677,455,284677,37,9,95204,88,294,0.9996593790163428,0.9982747072788417,0.9989853025785868,0.998966563322999,0.9984531100629261,284677,97,95498,492
10,10,SAFARI,Mid,125,0.95,284677,455,284677,37,9,95204,88,294,0.9996593790163428,0.9982747072788417,0.9989853025785868,0.998966563322999,0.9984531100629261,284677,97,95498,492
10,10,vg giraffe,Mid,125,0.9,269704,429,269704,35,9,90226,83,279,0.9996590016160358,0.9982825501169642,0.998984513835999,0.9989703017238185,0.9984588305406566,269704,92,90505,464
10,10,SAFARI,Mid,125,0.9,269704,429,269704,35,9,90226,83,279,0.9996590016160358,0.9982825501169642,0.998984513835999,0.9989703017238185,0.9984588305406566,269704,92,90505,464
10,10,vg giraffe,None,125,0.15,44826,73,44826,1,0,14958,18,40,0.9995986085094996,0.9983518930957683,0.9988012786361214,0.998974861829203,0.9984645169904534,44826,18,14998,74
10,10,SAFARI,None,125,0.15,44826,73,44826,1,0,14958,18,40,0.9995986085094996,0.9983518930957683,0.9988012786361214,0.998974861829203,0.9984645169904534,44826,18,14998,74
10,10,vg giraffe,None,125,0.1,29877,47,29877,1,0,10014,11,26,0.9996319593147751,0.9983959899749374,0.9989055815341757,0.9990135923628641,0.9985241144686812,29877,11,10040,48
10,10,SAFARI,None,125,0.1,29877,47,29877,1,0,10014,11,26,0.9996319593147751,0.9983959899749374,0.9989055815341757,0.9990135923628641,0.9985241144686812,29877,11,10040,48
10,10,vg giraffe,None,125,0.25,74768,114,74768,1,0,24988,36,78,0.9995187423132453,0.9984642709293164,0.9985658513265875,0.9989912283631845,0.9984897734660199,74768,36,25066,115
10,10,SAFARI,None,125,0.25,74768,114,74768,1,0,24988,36,78,0.9995187423132453,0.9984642709293164,0.9985658513265875,0.9989912283631845,0.9984897734660199,74768,36,25066,115
10,10,vg giraffe,None,125,0.2,59810,92,59810,1,0,19912,26,56,0.9995654789758673,0.9984474901090096,0.9986996098829649,0.9990061717569045,0.9985105823748076,59810,26,19968,93
10,10,SAFARI,None,125,0.2,59810,92,59810,1,0,19912,26,56,0.9995654789758673,0.9984474901090096,0.9986996098829649,0.9990061717569045,0.9985105823748076,59810,26,19968,93
10,10,vg giraffe,None,125,0.35,104626,158,104626,2,0,35012,41,108,0.9996082815022882,0.9984730784646804,0.9988339353260715,0.9990403575026378,0.9985637419880383,104626,41,35120,160
10,10,SAFARI,None,125,0.35,104626,158,104626,2,0,35012,41,108,0.9996082815022882,0.9984730784646804,0.9988339353260715,0.9990403575026378,0.9985637419880383,104626,41,35120,160
10,10,vg giraffe,None,125,0.3,89519,136,89519,2,0,29887,40,95,0.9995533670541208,0.9984608006067569,0.9986676437279328,0.9990067851084725,0.9985126881073538,89519,40,29982,138
10,10,SAFARI,None,125,0.3,89519,136,89519,2,0,29887,40,95,0.9995533670541208,0.9984608006067569,0.9986676437279328,0.9990067851084725,0.9985126881073538,89519,40,29982,138
10,10,vg giraffe,None,125,0.45,134933,208,134933,2,3,45254,48,147,0.9996221774432525,0.9984460904375365,0.9988779371644813,0.9990337878109186,0.9985547772640438,134933,51,45401,210
10,10,SAFARI,None,125,0.45,134933,208,134933,2,3,45254,48,147,0.9996221774432525,0.9984460904375365,0.9988779371644813,0.9990337878109186,0.9985547772640438,134933,51,45401,210
10,10,vg giraffe,None,125,0.4,119588,182,119588,2,2,40042,45,122,0.9996071383792369,0.9984637477874628,0.9988311656014524,0.9990351159322827,0.9985560965852622,119588,47,40164,184
10,10,SAFARI,None,125,0.4,119588,182,119588,2,2,40042,45,122,0.9996071383792369,0.9984637477874628,0.9988311656014524,0.9990351159322827,0.9985560965852622,119588,47,40164,184
10,10,vg giraffe,None,125,0.55,164945,256,164945,2,5,55335,57,169,0.9996242583647966,0.9984382850190372,0.9988842097685635,0.9990309197177553,0.998550521132949,164945,62,55504,258
10,10,SAFARI,None,125,0.55,164945,256,164945,2,5,55335,57,169,0.9996242583647966,0.9984382850190372,0.9988842097685635,0.9990309197177553,0.998550521132949,164945,62,55504,258
10,10,vg giraffe,None,125,0.5,150023,234,150023,2,4,50379,53,155,0.9996202025586354,0.9984293786062731,0.9988733173884683,0.9990244357209686,0.9985411999004232,150023,57,50534,236
10,10,SAFARI,None,125,0.5,150023,234,150023,2,4,50379,53,155,0.9996202025586354,0.9984293786062731,0.9988733173884683,0.9990244357209686,0.9985411999004232,150023,57,50534,236
10,10,vg giraffe,None,125,0.65,195115,310,195115,2,5,65459,66,205,0.9996362444027748,0.9984034959345434,0.9989199056819046,0.9990194898787291,0.9985334773052741,195115,71,65664,312
10,10,SAFARI,None,125,0.65,195115,310,195115,2,5,65459,66,205,0.9996362444027748,0.9984034959345434,0.9989199056819046,0.9990194898787291,0.9985334773052741,195115,71,65664,312
10,10,vg giraffe,None,125,0.6,180019,286,180019,2,5,60355,60,189,0.9996390573288021,0.9984027242425418,0.9989275520137273,0.9990205082812834,0.998534759003138,180019,65,60544,288
10,10,SAFARI,None,125,0.6,180019,286,180019,2,5,60355,60,189,0.9996390573288021,0.9984027242425418,0.9989275520137273,0.9990205082812834,0.998534759003138,180019,65,60544,288
10,10,vg giraffe,None,125,0.75,224913,357,224913,2,5,75410,73,234,0.999653319466112,0.998406370964878,0.9989699162726816,0.9990294561178689,0.9985481438168202,224913,78,75644,359
10,10,SAFARI,None,125,0.75,224913,357,224913,2,5,75410,73,234,0.999653319466112,0.998406370964878,0.9989699162726816,0.9990294561178689,0.9985481438168202,224913,78,75644,359
10,10,vg giraffe,None,125,0.7,210097,330,210097,2,5,70486,70,225,0.9996431494204746,0.9984222706946286,0.9989404684542141,0.9990323370605396,0.9985527087815372,210097,75,70711,332
10,10,SAFARI,None,125,0.7,210097,330,210097,2,5,70486,70,225,0.9996431494204746,0.9984222706946286,0.9989404684542141,0.9990323370605396,0.9985527087815372,210097,75,70711,332
10,10,vg giraffe,None,125,0.85,254883,410,254883,2,6,85285,84,260,0.9996470214493299,0.9983861806929238,0.998949027850762,0.9990162032500568,0.9985275569765054,254883,90,85545,412
10,10,SAFARI,None,125,0.85,254883,410,254883,2,6,85285,84,260,0.9996470214493299,0.9983861806929238,0.998949027850762,0.9990162032500568,0.9985275569765054,254883,90,85545,412
10,10,vg giraffe,None,125,0.8,239761,384,239761,2,5,80294,80,250,0.999645605930472,0.9983926511678264,0.9989457887360627,0.9990187356898955,0.998531685662269,239761,85,80544,386
10,10,SAFARI,None,125,0.8,239761,384,239761,2,5,80294,80,250,0.999645605930472,0.9983926511678264,0.9989457887360627,0.9990187356898955,0.998531685662269,239761,85,80544,386
10,10,vg giraffe,None,125,0.95,284710,461,284710,3,6,95212,91,288,0.999659418483394,0.9983729231977669,0.9989853238072325,0.9990157566655731,0.9985266735124261,284710,97,95500,464
10,10,SAFARI,None,125,0.95,284710,461,284710,3,6,95212,91,288,0.999659418483394,0.9983729231977669,0.9989853238072325,0.9990157566655731,0.9985266735124261,284710,97,95500,464
10,10,vg giraffe,None,125,0.9,269730,440,269730,3,6,90232,86,274,0.9996590344745795,0.9983603098755242,0.9989845250447029,0.9990092500856489,0.9985170648416862,269730,92,90506,443
10,10,SAFARI,None,125,0.9,269730,440,269730,3,6,90232,86,274,0.9996590344745795,0.9983603098755242,0.9989845250447029,0.9990092500856489,0.9985170648416862,269730,92,90506,443
10,10,vg giraffe,Single-stranded,125,0.15,44833,67,44833,0,0,14958,20,37,0.999554098945444,0.9985077951002227,0.9986679986679987,0.9990306730694238,0.9985479429191354,44833,20,14995,67
10,10,SAFARI,Single-stranded,125,0.15,44833,67,44833,0,0,14958,20,37,0.999554098945444,0.9985077951002227,0.9986679986679987,0.9990306730694238,0.9985479429191354,44833,20,14995,67
10,10,vg giraffe,Single-stranded,125,0.1,29883,42,29883,0,0,10014,12,18,0.9995985950827898,0.9985964912280701,0.998805256869773,0.9990972918756269,0.9986489529385274,29883,12,10032,42
10,10,SAFARI,Single-stranded,125,0.1,29883,42,29883,0,0,10014,12,18,0.9995985950827898,0.9985964912280701,0.998805256869773,0.9990972918756269,0.9986489529385274,29883,12,10032,42
10,10,vg giraffe,Single-stranded,125,0.25,74761,121,74761,0,0,24987,35,75,0.9995320605379967,0.9983841243556529,0.9986054110052994,0.9989577626638517,0.9984396723311896,74761,35,25062,121
10,10,SAFARI,Single-stranded,125,0.25,74761,121,74761,0,0,24987,35,75,0.9995320605379967,0.9983841243556529,0.9986054110052994,0.9989577626638517,0.9984396723311896,74761,35,25062,121
10,10,vg giraffe,Single-stranded,125,0.2,59804,99,59804,0,0,19911,26,50,0.9995654354003009,0.9983473281805586,0.9986991544503927,0.9989560104565993,0.9984353486043309,59804,26,19961,99
10,10,SAFARI,Single-stranded,125,0.2,59804,99,59804,0,0,19911,26,50,0.9995654354003009,0.9983473281805586,0.9986991544503927,0.9989560104565993,0.9984353486043309,59804,26,19961,99
10,10,vg giraffe,Single-stranded,125,0.35,104621,164,104621,0,2,35008,40,98,0.9995987120567918,0.9984348904900511,0.9988050529190851,0.999016462320003,0.9985278669077344,104621,42,35106,164
10,10,SAFARI,Single-stranded,125,0.35,104621,164,104621,0,2,35008,40,98,0.9995987120567918,0.9984348904900511,0.9988050529190851,0.999016462320003,0.9985278669077344,104621,42,35106,164
10,10,vg giraffe,Single-stranded,125,0.3,89516,140,89516,0,1,29884,39,87,0.9995533520925455,0.9984384759525297,0.998667155376362,0.9989956029730153,0.9984958259169194,89516,40,29971,140
10,10,SAFARI,Single-stranded,125,0.3,89516,140,89516,0,1,29884,39,87,0.9995533520925455,0.9984384759525297,0.998667155376362,0.9989956029730153,0.9984958259169194,89516,40,29971,140
10,10,vg giraffe,Single-stranded,125,0.45,134929,217,134929,0,4,45251,46,135,0.9996295720074975,0.9983943290959407,0.9988995510168148,0.999011568718186,0.9985214473203309,134929,50,45386,217
10,10,SAFARI,Single-stranded,125,0.45,134929,217,134929,0,4,45251,46,135,0.9996295720074975,0.9983943290959407,0.9988995510168148,0.999011568718186,0.9985214473203309,134929,50,45386,217
10,10,vg giraffe,Single-stranded,125,0.4,119584,191,119584,0,4,40038,43,114,0.999607125243457,0.9984053433521185,0.9988308166869823,0.9990058728686834,0.9985122582419643,119584,47,40152,191
10,10,SAFARI,Single-stranded,125,0.4,119584,191,119584,0,4,40038,43,114,0.999607125243457,0.9984053433521185,0.9988308166869823,0.9990058728686834,0.9985122582419643,119584,47,40152,191
10,10,vg giraffe,Single-stranded,125,0.55,164947,258,164947,0,4,55335,56,158,0.9996363790627064,0.998438303925426,0.9989199503177146,0.9990369823022786,0.9985595086021798,164947,60,55493,258
10,10,SAFARI,Single-stranded,125,0.55,164947,258,164947,0,4,55335,56,158,0.9996363790627064,0.998438303925426,0.9989199503177146,0.9990369823022786,0.9985595086021798,164947,60,55493,258
10,10,vg giraffe,Single-stranded,125,0.5,150022,239,150022,0,4,50377,51,148,0.9996335214589844,0.9984094342510698,0.9989126136812969,0.9990211028907431,0.9985361554662644,150022,55,50525,239
10,10,SAFARI,Single-stranded,125,0.5,150022,239,150022,0,4,50377,51,148,0.9996335214589844,0.9984094342510698,0.9989126136812969,0.9990211028907431,0.9985361554662644,150022,55,50525,239
10,10,vg giraffe,Single-stranded,125,0.65,195131,300,195131,0,4,65459,68,199,0.9996311532097355,0.9984649313568472,0.9989046097672296,0.9990477019409473,0.9985755913019172,195131,72,65658,300
10,10,SAFARI,Single-stranded,125,0.65,195131,300,195131,0,4,65459,68,199,0.9996311532097355,0.9984649313568472,0.9989046097672296,0.9990477019409473,0.9985755913019172,195131,72,65658,300
10,10,vg giraffe,Single-stranded,125,0.6,180033,276,180033,0,4,60355,62,182,0.9996335348891443,0.9984692943779845,0.9989109450027226,0.9990510754478259,0.9985803945008966,180033,66,60537,276
10,10,SAFARI,Single-stranded,125,0.6,180033,276,180033,0,4,60355,62,182,0.9996335348891443,0.9984692943779845,0.9989109450027226,0.9990510754478259,0.9985803945008966,180033,66,60537,276
10,10,vg giraffe,Single-stranded,125,0.75,224919,357,224919,0,6,75408,78,231,0.9996266716443781,0.9984152772598945,0.9988906937126104,0.9990206072235215,0.9985348788534181,224919,84,75639,357
10,10,SAFARI,Single-stranded,125,0.75,224919,357,224919,0,6,75408,78,231,0.9996266716443781,0.9984152772598945,0.9988906937126104,0.9990206072235215,0.9985348788534181,224919,84,75639,357
10,10,vg giraffe,Single-stranded,125,0.7,210098,335,210098,0,4,70486,73,220,0.9996336386344713,0.9984080443656651,0.9989121681759745,0.9990204656116859,0.9985349340009103,210098,77,70706,335
10,10,SAFARI,Single-stranded,125,0.7,210098,335,210098,0,4,70486,73,220,0.9996336386344713,0.9984080443656651,0.9989121681759745,0.9990204656116859,0.9985349340009103,210098,77,70706,335
10,10,vg giraffe,Single-stranded,125,0.85,254890,407,254890,1,6,85286,87,260,0.9996352698023006,0.998401867621368,0.9989140461705531,0.9990181880179745,0.9985305203014047,254890,93,85546,408
10,10,SAFARI,Single-stranded,125,0.85,254890,407,254890,1,6,85286,87,260,0.9996352698023006,0.998401867621368,0.9989140461705531,0.9990181880179745,0.9985305203014047,254890,93,85546,408
10,10,vg giraffe,Single-stranded,125,0.8,239767,383,239767,1,6,80294,83,247,0.9996289440330866,0.9984010060337037,0.998896192484187,0.9990145977037834,0.9985254737655909,239767,89,80541,384
10,10,SAFARI,Single-stranded,125,0.8,239767,383,239767,1,6,80294,83,247,0.9996289440330866,0.9984010060337037,0.998896192484187,0.9990145977037834,0.9985254737655909,239767,89,80541,384
10,10,vg giraffe,Single-stranded,125,0.95,284719,457,284719,1,7,95212,91,296,0.9996559194149226,0.9983939798791628,0.9989749597305608,0.999024551135626,0.9985398507811536,284719,98,95508,458
10,10,SAFARI,Single-stranded,125,0.95,284719,457,284719,1,7,95212,91,296,0.9996559194149226,0.9983939798791628,0.9989749597305608,0.999024551135626,0.9985398507811536,284719,98,95508,458
10,10,vg giraffe,Single-stranded,125,0.9,269746,429,269746,1,6,90233,88,276,0.9996516454195079,0.9984084448655691,0.9989625067602618,0.9990296583804925,0.9985475873041391,269746,94,90509,430
10,10,SAFARI,Single-stranded,125,0.9,269746,429,269746,1,6,90233,88,276,0.9996516454195079,0.9984084448655691,0.9989625067602618,0.9990296583804925,0.9985475873041391,269746,94,90509,430
,,BWA BWA ALN (anc),High,125,0.15,41699,0,41699,3203,0,14956,2,48,0.999952039519436,0.9286668745267471,0.9998667199786752,0.9629920441555143,0.9465013019963945,41699,2,15004,3203
,,BWA ALN,High,125,0.15,38007,0,38007,6895,0,14956,2,48,0.999947380883475,0.8464433655516458,0.9998667199786752,0.9168144154575388,0.8848734726580757,38007,2,15004,6895
,,Bowtie2,High,125,0.15,34192,1,34192,10709,0,14956,3,47,0.9999122678754204,0.7614805576589017,0.9998000799680128,0.8645587063984728,0.8211758028977766,34192,3,15003,10710
,,BWA-MEM,High,125,0.15,39448,40,39448,5416,0,14956,3,47,0.9999239563002206,0.878496347764119,0.9998000799680128,0.9352854009839369,0.9088799866466366,39448,3,15003,5456
,,SHRiMP,High,125,0.15,44749,31,44749,122,0,14956,7,43,0.999843596389311,0.9965925793951271,0.9995335199253632,0.9982154408976331,0.9973292381651866,44749,7,14999,153
,,BWA BWA ALN (anc),High,125,0.1,27791,0,27791,2137,0,10014,2,31,0.9999280394343899,0.9285952953755681,0.9998009356026675,0.9629424299648308,0.9464915572232645,27791,2,10045,2137
,,BWA ALN,High,125,0.1,25335,0,25335,4593,0,10014,2,31,0.9999210640565181,0.8465316760224539,0.9998009356026675,0.9168551524472994,0.88505315822389,25335,2,10045,4593
,,Bowtie2,High,125,0.1,22739,1,22739,7188,0,10013,2,31,0.9999120531199156,0.7597901630580058,0.9998009157873781,0.8634680741992443,0.8201080702456597,22739,2,10044,7189
,,BWA-MEM,High,125,0.1,26276,29,26276,3624,0,10014,2,31,0.9999238907070553,0.877944468575629,0.9998009356026675,0.9349725123205296,0.9085701420852511,26276,2,10045,3653
,,SHRiMP,High,125,0.1,29824,22,29824,82,0,10014,4,29,0.9998658978141344,0.9965249933172948,0.999601871205335,0.9981926501104491,0.9972983114446529,29824,4,10043,104
,,BWA BWA ALN (anc),High,125,0.25,69654,0,69654,5230,0,24986,2,95,0.9999712874698519,0.9301586453715079,0.9999202647211258,0.9638024076380242,0.9476627287004712,69654,2,25081,5230
,,BWA ALN,High,125,0.25,63517,0,63517,11367,0,24986,2,95,0.9999685133582078,0.8482052240799103,0.9999202647211258,0.917855826824563,0.886272469915072,63517,2,25081,11367
,,Bowtie2,High,125,0.25,57164,4,57164,17716,0,24986,2,95,0.9999650141692614,0.7633673414881683,0.9999202647211258,0.8657932601287389,0.8227214980943711,57164,2,25081,17720
,,BWA-MEM,High,125,0.25,65806,76,65806,9007,0,24986,4,93,0.9999392189636833,0.8787138298014394,0.9998405294422518,0.9354153192275709,0.9091045492737967,65806,4,25079,9083
,,SHRiMP,High,125,0.25,74615,61,74615,208,0,24986,17,80,0.9997722156715618,0.9964077773623203,0.9993222501295699,0.9980871612402686,0.9971390558884432,74615,17,25066,269
,,BWA BWA ALN (anc),High,125,0.2,55678,0,55678,4226,0,19910,2,73,0.9999640804597701,0.9294537927350427,0.9998999249437078,0.9634205426356589,0.9470765687391255,55678,2,19983,4226
,,BWA ALN,High,125,0.2,50793,0,50793,9111,0,19910,2,73,0.9999606260458707,0.8479066506410257,0.9998999249437078,0.9176776664649184,0.885929226802188,50793,2,19983,9111
,,Bowtie2,High,125,0.2,45707,1,45707,14196,0,19910,3,72,0.9999343688470794,0.7630041399572649,0.9998498874155617,0.8655481280890791,0.822253376559977,45707,3,19982,14197
,,BWA-MEM,High,125,0.2,52692,58,52692,7158,0,19910,3,72,0.9999430686023342,0.8795486412499165,0.9998498874155617,0.9358898075539728,0.9096416457011253,52692,3,19982,7216
,,SHRiMP,High,125,0.2,59691,45,59691,168,0,19910,12,63,0.9997990050751219,0.9964443108974359,0.9993995496622466,0.9981188391983747,0.997183592234225,59691,12,19973,213
,,BWA BWA ALN (anc),High,125,0.35,97441,0,97441,7350,0,35010,5,131,0.9999486895306118,0.9298603887738451,0.9998577363000057,0.9636317785568418,0.9474406339995856,97441,5,35141,7350
,,BWA ALN,High,125,0.35,88836,0,88836,15955,0,35010,5,131,0.999943719678977,0.8477445582158774,0.9998577363000057,0.9175756073376301,0.8859486769046071,88836,5,35141,15955
,,Bowtie2,High,125,0.35,80066,7,80066,24718,0,35009,6,130,0.9999250674393046,0.7640541649569143,0.9998292787025181,0.8662198492938014,0.8232692087811571,80066,6,35139,24725
,,BWA-MEM,High,125,0.35,92106,112,92106,12582,0,35010,9,127,0.9999022960429897,0.8788740458015267,0.9997439253400102,0.9354899322042506,0.9092292741486002,92106,9,35137,12694
,,SHRiMP,High,125,0.35,104419,84,104419,288,0,35010,29,107,0.999722349877451,0.9964500768195742,0.999174870540033,0.9980835312728507,0.9971344247768639,104419,29,35117,372
,,BWA BWA ALN (anc),High,125,0.3,83336,0,83336,6324,0,29885,5,115,0.9999400055194922,0.9294668748605844,0.9998333611064822,0.9634163964370148,0.9471106839928133,83336,5,30000,6324
,,BWA ALN,High,125,0.3,75986,0,75986,13674,0,29885,5,115,0.9999342027345344,0.8474905197412447,0.9998333611064822,0.9174227743871152,0.8856892157272386,75986,5,30000,13674
,,Bowtie2,High,125,0.3,68339,5,68339,21316,0,29884,5,115,0.9999268406882829,0.762201650680348,0.999833355552593,0.8650287334497861,0.8217843294558096,68339,5,29999,21321
,,BWA-MEM,High,125,0.3,78789,96,78789,10784,0,29885,9,111,0.9998857839031448,0.8786648674569807,0.9997000499916681,0.9353641959552909,0.909011146949212,78789,9,29996,10880
,,SHRiMP,High,125,0.3,89327,73,89327,260,0,29885,27,93,0.9996978310987756,0.9962859692170422,0.9991001499750042,0.997988984101802,0.9969916015543392,89327,27,29978,333
,,BWA BWA ALN (anc),High,125,0.45,125584,0,125584,9570,0,45255,9,167,0.9999283399552523,0.9291918848128802,0.9998018973828443,0.9632632398455208,0.9469557272198688,125584,9,45422,9570
,,BWA ALN,High,125,0.45,114513,0,114513,20641,0,45255,9,167,0.9999214124796982,0.8472779200023677,0.9998018973828443,0.9172928114836828,0.8856494171719689,114513,9,45422,20641
,,Bowtie2,High,125,0.45,103374,11,103374,31769,0,45255,8,168,0.9999226170900156,0.7648608254287701,0.9998239087847505,0.8667370962873528,0.823972090705208,103374,8,45423,31780
,,BWA-MEM,High,125,0.45,118822,140,118822,16202,0,45255,15,161,0.9998737766857123,0.8790950253025953,0.9996698289714072,0.9356026157377332,0.9094271712948864,118822,15,45416,16342
,,SHRiMP,High,125,0.45,134675,109,134675,370,0,45255,43,133,0.9996808147389361,0.996455894757092,0.999053509718034,0.9980657496887413,0.9971093944679791,134675,43,45388,479
,,BWA BWA ALN (anc),High,125,0.4,111361,0,111361,8420,0,40042,7,147,0.9999371453200201,0.9297050450405323,0.9998258533187382,0.9635429960761239,0.9473236777786807,111361,7,40189,8420
,,BWA ALN,High,125,0.4,101503,0,101503,18278,0,40042,7,147,0.9999310412767215,0.8474048471794358,0.9998258533187382,0.9173712441988151,0.8857023197084581,101503,7,40189,18278
,,Bowtie2,High,125,0.4,91501,9,91501,28271,0,40042,7,147,0.9999235039559383,0.7639024553142819,0.9998258533187382,0.8661217574033668,0.8231808322446351,91501,7,40189,28280
,,BWA-MEM,High,125,0.4,105298,130,105298,14362,0,40042,11,143,0.9998955454899391,0.8790216211703815,0.9997263409294457,0.9355705711709069,0.909348317977823,105298,11,40185,14492
,,SHRiMP,High,125,0.4,119349,101,119349,331,0,40042,32,122,0.9997319506454125,0.9963934179878278,0.9992039008856602,0.9980598924578319,0.9970995830650656,119349,32,40164,432
,,BWA BWA ALN (anc),High,125,0.55,153613,0,153613,11601,0,55338,12,206,0.9999218877135883,0.9297819797353735,0.9997840017279862,0.9635772286326327,0.9473977442587308,153613,12,55544,11601
,,BWA ALN,High,125,0.55,140107,0,140107,25107,0,55338,12,206,0.9999143585095526,0.8480334596341714,0.9997840017279862,0.9177324429393483,0.8862209539339584,140107,12,55544,25107
,,Bowtie2,High,125,0.55,126539,14,126539,38661,0,55337,9,209,0.9999288807409047,0.7659096686721464,0.9998379983799838,0.8674124800350971,0.8247761234593625,126539,9,55546,38675
,,BWA-MEM,High,125,0.55,145266,174,145266,19788,0,55338,18,200,0.9998761047327992,0.8791851260076985,0.9996760025919793,0.935654660689442,0.9095043119066599,145266,18,55538,19962
,,SHRiMP,High,125,0.55,164615,133,164615,466,0,55338,51,167,0.9996902821468913,0.9963743992639849,0.9990820073439413,0.9980295865163088,0.9970557593875979,164615,51,55505,599
,,BWA BWA ALN (anc),High,125,0.5,139688,0,139688,10583,0,50381,11,186,0.9999212592788782,0.929573903148312,0.9997825141365811,0.9634651860537298,0.9472539071640884,139688,11,50567,10583
,,BWA ALN,High,125,0.5,127412,0,127412,22859,0,50381,11,186,0.9999136733556736,0.8478814941006582,0.9997825141365811,0.9176431611774112,0.8861333638703702,127412,11,50567,22859
,,Bowtie2,High,125,0.5,114907,12,114907,35352,0,50380,10,187,0.9999129806730075,0.764665171589994,0.9998022816695336,0.8666078404754363,0.823876762526886,114907,10,50567,35364
,,BWA-MEM,High,125,0.5,132126,159,132126,17997,0,50381,17,180,0.9998713514904308,0.8791871281989859,0.9996638854838071,0.9356537133752324,0.9095240465996216,132126,17,50561,18156
,,SHRiMP,High,125,0.5,149723,123,149723,425,0,50381,49,148,0.9996728360441204,0.9963532551190849,0.9990311993356795,0.9980102851924558,0.9970276177625977,149723,49,50529,548
,,BWA BWA ALN (anc),High,125,0.65,181622,0,181622,13818,0,65462,15,243,0.9999174177067448,0.929297994269341,0.9997717589774803,0.9633151849622227,0.9470324705161587,181622,15,65705,13818
,,BWA ALN,High,125,0.65,165613,0,165613,29827,0,65462,14,244,0.99991547271882,0.8473853868194843,0.9997869750456482,0.9173532890017642,0.885736713126053,165613,14,65706,29827
,,Bowtie2,High,125,0.65,149631,17,149631,45792,0,65462,14,244,0.9999064452537673,0.7656109291854277,0.9997869750456482,0.8672124259240477,0.8245405115637923,149631,14,65706,45809
,,BWA-MEM,High,125,0.65,171745,212,171745,23498,0,65462,22,236,0.9998719195188831,0.8786933053644062,0.9996652465003043,0.9353742422839589,0.9091337225997894,171745,22,65698,23710
,,SHRiMP,High,125,0.65,194722,168,194722,550,0,65462,64,194,0.9996714342919922,0.9963262382316823,0.9990261716372489,0.997996033068017,0.9970056670240466,194722,64,65656,718
,,BWA BWA ALN (anc),High,125,0.6,167642,0,167642,12677,0,60358,14,223,0.9999164956816339,0.9296968150888149,0.9997689578348049,0.9635289891515195,0.9473214508081722,167642,14,60581,12677
,,BWA ALN,High,125,0.6,152880,0,152880,27439,0,60358,13,224,0.9999149732165632,0.847830788768793,0.9997854608466045,0.917614011500186,0.8860506238740795,152880,13,60582,27439
,,Bowtie2,High,125,0.6,138099,15,138099,42205,0,60358,12,225,0.9999131133653366,0.7658593936301776,0.9998019638584041,0.867374305184813,0.8247009306225458,138099,12,60583,42220
,,BWA-MEM,High,125,0.6,158537,190,158537,21606,0,60358,20,217,0.9998738623964883,0.879134711894107,0.999669939764007,0.9356251290979374,0.9094501261787754,158537,20,60575,21796
,,SHRiMP,High,125,0.6,179673,147,179673,499,0,60358,55,182,0.9996939820172706,0.9964174601678137,0.9990923343510191,0.9980530319652712,0.9970902479723055,179673,55,60540,646
,,BWA BWA ALN (anc),High,125,0.75,209358,0,209358,15928,0,75413,18,291,0.999914030261348,0.929298758023135,0.9997622883706189,0.9633140233100662,0.9470246637963111,209358,18,75704,15928
,,BWA ALN,High,125,0.75,190911,0,190911,34375,0,75413,16,293,0.9999161983375845,0.8474161732198183,0.9997887007738834,0.9173716342353555,0.8857472226651784,190911,16,75706,34375
,,Bowtie2,High,125,0.75,172552,22,172552,52712,0,75413,13,296,0.9999246660678585,0.765924203013059,0.9998283193787803,0.867420215105655,0.8247654547387445,172552,13,75709,52734
,,BWA-MEM,High,125,0.75,197947,245,197947,27109,0,75413,25,284,0.9998737195158911,0.8785890874874057,0.9996698449591929,0.9353159781039659,0.9090468170206263,197947,25,75697,27354
,,SHRiMP,High,125,0.75,224474,197,224474,615,0,75413,74,235,0.9996704490799294,0.9963956925863126,0.9990227410792109,0.9980303845418532,0.9970565566363685,224474,74,75648,812
,,BWA BWA ALN (anc),High,125,0.7,195553,0,195553,14889,0,70489,17,267,0.9999130746024442,0.9292489141901331,0.9997597954022014,0.9632867994049437,0.946994292623082,195553,17,70756,14889
,,BWA ALN,High,125,0.7,178274,0,178274,32168,0,70489,15,269,0.9999158669351447,0.8471407798823429,0.9997880547666483,0.9172101015869586,0.8855573137990506,178274,15,70758,32168
,,Bowtie2,High,125,0.7,161077,21,161077,49344,0,70489,8,276,0.9999503367787194,0.7654223016318036,0.9998869625422124,0.8671079087118838,0.8244297068079584,161077,8,70765,49365
,,BWA-MEM,High,125,0.7,184889,227,184889,25341,0,70489,24,260,0.9998702092335314,0.878512000076025,0.9996608876266373,0.9352707590358398,0.9089997510934111,184889,24,70749,25568
,,SHRiMP,High,125,0.7,209673,183,209673,586,0,70489,71,213,0.9996614921046609,0.9963457864874883,0.9989967925621352,0.9980008853222144,0.9970129616130007,209673,71,70702,769
,,BWA BWA ALN (anc),High,125,0.85,237249,0,237249,18059,0,85287,18,337,0.9999241360998369,0.9292658279411534,0.9997898227505196,0.9633010201492159,0.9469804956738525,237249,18,85624,18059
,,BWA ALN,High,125,0.85,216303,0,216303,39005,0,85287,16,339,0.9999260351610353,0.8472237454368841,0.9998131757782397,0.9172630065708707,0.8855521337439507,216303,16,85626,39005
,,Bowtie2,High,125,0.85,195598,23,195598,59687,0,85287,11,344,0.9999437653686691,0.7661256208187758,0.9998715583475397,0.8675565569716821,0.8248394192696876,195598,11,85631,59710
,,BWA-MEM,High,125,0.85,224263,274,224263,30788,0,85287,26,329,0.9998840781313395,0.8783432879663174,0.9996964106396394,0.9351812082216117,0.9088240210929504,224263,26,85616,31062
,,SHRiMP,High,125,0.85,254404,215,254404,689,0,85287,83,272,0.9996738536742544,0.9964591787174707,0.9990308493496182,0.9980639276571954,0.9971051473823141,254404,83,85559,904
,,BWA BWA ALN (anc),High,125,0.8,223198,0,223198,16964,0,80297,18,313,0.9999193606193104,0.9293643457332967,0.9997767524929305,0.9633517344371119,0.9470619408335671,223198,18,80610,16964
,,BWA ALN,High,125,0.8,203540,0,203540,36622,0,80297,16,315,0.9999213975515338,0.8475112632306526,0.9998015577714938,0.9174295385808104,0.8857882103556844,203540,16,80612,36622
,,Bowtie2,High,125,0.8,183911,22,183911,56229,0,80297,13,318,0.9999293186316087,0.7657789325538594,0.9998387656893387,0.8673287965176876,0.8246079990024626,183911,13,80615,56251
,,BWA-MEM,High,125,0.8,210985,258,210985,28935,0,80297,25,306,0.9998815222027392,0.8784526476196821,0.999689934017959,0.9352420720409231,0.9089231498164,210985,25,80603,29193
,,SHRiMP,High,125,0.8,239303,205,239303,654,0,80297,77,254,0.9996783357005598,0.9964232476411755,0.9990449967753138,0.9980481375979581,0.9970822033105771,239303,77,80551,859
,,BWA BWA ALN (anc),High,125,0.95,265001,0,265001,20191,0,95215,19,367,0.9999283072975624,0.929202081404808,0.9998012573090239,0.9632687036996648,0.946926545393429,265001,19,95582,20191
,,BWA ALN,High,125,0.95,241571,0,241571,43621,0,95215,17,369,0.9999296322665033,0.8470469017363741,0.9998221775922846,0.917160864117848,0.8854023051894336,241571,17,95584,43621
,,Bowtie2,High,125,0.95,218382,26,218382,66784,0,95215,13,373,0.9999404748277204,0.7657367668097281,0.9998640181588059,0.8673059471352518,0.8245162069680902,218382,13,95588,66810
,,BWA-MEM,High,125,0.95,250500,307,250500,34404,0,95215,27,359,0.9998922271850939,0.878297120377545,0.9997175761759814,0.9351586036458119,0.9087791351112885,250500,27,95574,34711
,,SHRiMP,High,125,0.95,284175,243,284175,774,0,95215,86,300,0.9996974611360686,0.996433981317849,0.9991004278197927,0.9980630534916841,0.9971034131404727,284175,86,95515,1017
,,BWA BWA ALN (anc),High,125,0.9,251049,0,251049,19138,0,90235,19,351,0.9999243232909013,0.929167576530329,0.9997902985486452,0.9632483141648521,0.9469029246768221,251049,19,90586,19138
,,BWA ALN,High,125,0.9,228817,0,228817,41370,0,90235,17,353,0.9999257103402467,0.8468838249064536,0.9998123723856299,0.9170636105494558,0.8852884764628928,228817,17,90588,41370
,,Bowtie2,High,125,0.9,206858,24,206858,63305,0,90235,15,355,0.9999274917461438,0.7656104845903022,0.9998344462226146,0.8672200561774199,0.8244306969112397,206858,15,90590,63329
,,BWA-MEM,High,125,0.9,237299,291,237299,32615,0,90235,27,343,0.9998862324397664,0.8782183897411224,0.9997020032007063,0.9351113528040651,0.9087248136138134,237299,27,90578,32906
,,SHRiMP,High,125,0.9,269223,228,269223,736,0,90235,86,284,0.9996806642184257,0.996432100730235,0.9990508250096573,0.9980537390453312,0.9970897359143218,269223,86,90519,964
,,BWA BWA ALN (anc),Mid,125,0.15,44712,0,44712,188,0,14956,2,48,0.9999552712796886,0.9958129175946547,0.9998667199786752,0.9978797955676568,0.9968283644376189,44712,2,15004,188
,,BWA ALN,Mid,125,0.15,44679,0,44679,221,0,14956,2,48,0.999955238244444,0.9950779510022272,0.9998667199786752,0.9975106328350879,0.9962775014188896,44679,2,15004,221
,,Bowtie2,Mid,125,0.15,44435,10,44435,455,0,14956,3,47,0.9999324902110807,0.9896436525612472,0.9998000799680128,0.994761467684524,0.9921877608252929,44435,3,15003,465
,,BWA-MEM,Mid,125,0.15,44669,54,44669,182,0,14956,3,47,0.9999328438395415,0.9947444605277809,0.9998000799680128,0.9973319043951014,0.9960107492780959,44669,3,15003,236
,,SHRiMP,Mid,125,0.15,44779,37,44779,84,0,14956,9,41,0.999799053317853,0.997305122494432,0.9994002399040384,0.9985505307287486,0.9978299335625814,44779,9,14997,121
,,BWA BWA ALN (anc),Mid,125,0.1,29804,0,29804,121,0,10014,2,31,0.9999328994162249,0.9959565580618213,0.9998009356026675,0.997940767775527,0.9969228459921945,29804,2,10045,121
,,BWA ALN,Mid,125,0.1,29782,0,29782,143,0,10014,2,31,0.9999328498522697,0.9952213868003341,0.9998009356026675,0.9975715553769114,0.9963724607225057,29782,2,10045,143
,,Bowtie2,Mid,125,0.1,29623,7,29623,295,0,10014,2,31,0.9999324894514768,0.9899081035923141,0.9998009356026675,0.9948950461796808,0.9923946762733914,29623,2,10045,302
,,BWA-MEM,Mid,125,0.1,29776,37,29776,117,0,10014,2,31,0.999932836322117,0.9948546608753759,0.9998009356026675,0.9973872847859583,0.9960977562098207,29776,2,10045,154
,,SHRiMP,Mid,125,0.1,29847,25,29847,53,0,10014,4,29,0.9998660011389903,0.9973934837092732,0.999601871205335,0.9986282119914347,0.9979485639947964,29847,4,10043,78
,,BWA BWA ALN (anc),Mid,125,0.25,74555,0,74555,327,0,24986,3,94,0.9999597628691757,0.9956331294570123,0.9998803970816887,0.9977917558886509,0.9966988445956084,74555,3,25080,327
,,BWA ALN,Mid,125,0.25,74495,0,74495,387,0,24986,3,94,0.9999597304625627,0.9948318688069229,0.9998803970816887,0.9973892087294148,0.9960986345220827,74495,3,25080,387
,,Bowtie2,Mid,125,0.25,74120,18,74120,744,0,24986,2,95,0.9999730174577048,0.9898239897438637,0.9999202647211258,0.9948726208692384,0.9923573250637723,74120,2,25081,762
,,BWA-MEM,Mid,125,0.25,74476,89,74476,327,0,24986,4,93,0.9999462943071966,0.9944453346151791,0.9998405294422518,0.9971882280480947,0.9957989497374343,74476,4,25079,416
,,SHRiMP,Mid,125,0.25,74676,61,74676,145,0,24986,21,76,0.9997188642114141,0.9972490051013595,0.9991627795718215,0.9984824072897934,0.9977292052218276,74676,21,25062,206
,,BWA BWA ALN (anc),Mid,125,0.2,59644,0,59644,259,0,19910,2,73,0.9999664688327801,0.9956763434218654,0.9998999249437078,0.9978167947870749,0.9967329260965352,59644,2,19983,259
,,BWA ALN,Mid,125,0.2,59598,0,59598,305,0,19910,2,73,0.9999664429530202,0.9949084353037411,0.9998999249437078,0.9974310268361464,0.9961571199679551,59598,2,19983,305
,,Bowtie2,Mid,125,0.2,59268,16,59268,619,0,19909,2,73,0.9999662561160789,0.9893995292389363,0.9998999199359487,0.9946548295335353,0.992026237059847,59268,2,19982,635
,,BWA-MEM,Mid,125,0.2,59579,71,59579,260,0,19910,3,72,0.9999496492229196,0.9944750459021866,0.9998498874155617,0.9972048337964047,0.9958195131109582,59579,3,19982,331
,,SHRiMP,Mid,125,0.2,59734,48,59734,121,0,19910,16,59,0.9997322175732217,0.9971787723486303,0.9991993995496622,0.9984538624188277,0.9976842579611456,59734,16,19969,169
,,BWA BWA ALN (anc),Mid,125,0.35,104315,0,104315,474,0,35010,7,129,0.9999329000594314,0.9954766244548569,0.9998008308200079,0.997699786237931,0.9965626898202737,104315,7,35139,474
,,BWA ALN,Mid,125,0.35,104235,0,104235,554,0,35010,7,129,0.9999328485639186,0.9947131855442842,0.9998008308200079,0.9973161875511288,0.9959909958194876,104235,7,35139,554
,,Bowtie2,Mid,125,0.35,103711,27,103711,1051,0,35009,8,128,0.9999228685197504,0.9897126606800332,0.9997723716033575,0.9947915667504363,0.9922391984792831,103711,8,35137,1078
,,BWA-MEM,Mid,125,0.35,104215,133,104215,455,0,35010,9,127,0.9999136475284004,0.9943894735837715,0.9997439253400102,0.9971439096384678,0.9957341603012526,104215,9,35137,588
,,SHRiMP,Mid,125,0.35,104496,97,104496,196,0,35010,35,101,0.9996651710975691,0.9972039049900275,0.9990041541000398,0.9984330212115421,0.9976560545967771,104496,35,35111,293
,,BWA BWA ALN (anc),Mid,125,0.3,89268,0,89268,390,0,29885,7,113,0.9999215905908709,0.995650137187981,0.9997667055490752,0.9977812924390694,0.9966823495984557,89268,7,29998,390
,,BWA ALN,Mid,125,0.3,89198,0,89198,460,0,29885,7,113,0.9999215290622723,0.9948693925806955,0.9997667055490752,0.9973890631377087,0.9960973734571255,89198,7,29998,460
,,Bowtie2,Mid,125,0.3,88725,20,88725,913,0,29884,7,113,0.9999211107604923,0.9895937897343238,0.9997666977736301,0.9947306463366781,0.9921445404556166,88725,7,29997,933
,,BWA-MEM,Mid,125,0.3,89179,106,89179,387,0,29885,9,111,0.9998990895636184,0.9945021857435989,0.9997000499916681,0.9971933355697193,0.9958053761374366,89179,9,29996,493
,,SHRiMP,Mid,125,0.3,89413,72,89413,173,0,29885,31,89,0.999653414426904,0.9972673938745009,0.99896683886019,0.9984589786825385,0.997693522642755,89413,31,29974,245
,,BWA BWA ALN (anc),Mid,125,0.45,134561,1,134561,588,0,45257,12,164,0.9999108290667519,0.9956418793932668,0.9997358748046574,0.9977717880937109,0.9966718904880304,134561,12,45421,589
,,BWA ALN,Mid,125,0.45,134457,1,134457,692,0,45257,12,164,0.9999107601008411,0.9948723640399556,0.9997358748046574,0.9973851991143058,0.9960959780267246,134457,12,45421,693
,,Bowtie2,Mid,125,0.45,133775,37,133775,1338,0,45257,10,166,0.9999252532047689,0.989826119126896,0.9997798956705478,0.9948500567051518,0.9923303965489553,133775,10,45423,1375
,,BWA-MEM,Mid,125,0.45,134419,175,134419,576,0,45257,16,160,0.9998809833748652,0.9944440334393726,0.9996478330728765,0.9971550972719347,0.9957531159504549,134419,16,45417,751
,,SHRiMP,Mid,125,0.45,134773,125,134773,252,0,45257,52,124,0.9996143148525867,0.9972105068442472,0.9988554574868488,0.9984109639781461,0.9976243610971133,134773,52,45381,377
,,BWA BWA ALN (anc),Mid,125,0.4,119236,1,119236,542,0,40042,9,145,0.9999245251373223,0.9954666510824101,0.999776097124092,0.9976906084744628,0.9965494608532584,119236,9,40187,543
,,BWA ALN,Mid,125,0.4,119143,1,119143,635,0,40042,9,145,0.9999244662280112,0.994690221157298,0.999776097124092,0.9973004758696025,0.9959681200187529,119143,9,40187,636
,,Bowtie2,Mid,125,0.4,118555,32,118555,1192,0,40042,9,145,0.9999240916298371,0.9897811803404604,0.999776097124092,0.9948267832493507,0.9922925457102673,118555,9,40187,1224
,,BWA-MEM,Mid,125,0.4,119116,158,119116,520,0,40042,11,143,0.9999076615712643,0.9943402841544652,0.9997263409294457,0.9971162015896469,0.9956934808425527,119116,11,40185,678
,,SHRiMP,Mid,125,0.4,119436,116,119436,227,0,40042,39,115,0.9996735718769617,0.9971363928568447,0.9990297542043984,0.9984033704765647,0.9976121268948274,119436,39,40157,343
,,BWA BWA ALN (anc),Mid,125,0.55,164477,1,164477,731,0,55340,17,201,0.9998966527654504,0.9955692486486813,0.9996940134634076,0.9977282584629197,0.9966072827913592,164477,17,55541,732
,,BWA ALN,Mid,125,0.55,164355,1,164355,853,0,55340,17,201,0.9998965760591828,0.9948307900901283,0.9996940134634076,0.9973572505696627,0.9960546639669878,164355,17,55541,854
,,Bowtie2,Mid,125,0.55,163526,44,163526,1639,0,55340,14,204,0.9999143940320411,0.9898129036553699,0.9997480110875121,0.9948380071118087,0.9923131627462438,163526,14,55544,1683
,,BWA-MEM,Mid,125,0.55,164318,212,164318,702,0,55340,20,198,0.9998782996020397,0.994468383848165,0.9996400158393031,0.9971660041872744,0.9957697359481861,164318,20,55538,914
,,SHRiMP,Mid,125,0.55,164745,155,164745,309,0,55340,60,158,0.9996359333758078,0.9971914363018964,0.9989200475179092,0.9984121885738182,0.9976264568526999,164745,60,55498,464
,,BWA BWA ALN (anc),Mid,125,0.5,149602,1,149602,662,0,50383,16,181,0.9998930609953348,0.9955877948956843,0.9996836694345591,0.9977357836222794,0.996619283527098,149602,16,50564,663
,,BWA ALN,Mid,125,0.5,149490,1,149490,774,0,50383,16,181,0.9998929808837104,0.9948424450138089,0.9996836694345591,0.9973613191402769,0.9960616395728049,149490,16,50564,775
,,Bowtie2,Mid,125,0.5,148730,41,148730,1494,0,50382,13,184,0.9999126009291194,0.9897847136725119,0.9997429763340517,0.9948228809931506,0.9922925255422118,148730,13,50566,1535
,,BWA-MEM,Mid,125,0.5,149449,193,149449,645,0,50383,19,178,0.9998728824898975,0.9944240020760279,0.999624357453539,0.9971409984820938,0.9957334952978837,149449,19,50561,838
,,SHRiMP,Mid,125,0.5,149842,138,149842,285,0,50383,58,139,0.999613075383589,0.9971849732139886,0.9988533017002768,0.9983975480152582,0.9976051183748662,149842,58,50522,423
,,BWA BWA ALN (anc),Mid,125,0.65,194579,1,194579,855,0,65462,22,236,0.999886948165734,0.995620027118991,0.9996652465003043,0.9977489257401881,0.9966380119086367,194579,22,65698,856
,,BWA ALN,Mid,125,0.65,194426,1,194426,1008,0,65462,21,237,0.9998920014194099,0.9948371581344181,0.9996804625684723,0.9973581750375755,0.9960559820796079,194426,21,65699,1009
,,Bowtie2,Mid,125,0.65,193457,54,193457,1924,0,65461,14,244,0.9999276377338205,0.9898789878987899,0.9997869718041966,0.9948779396563695,0.9923723167173392,193457,14,65705,1978
,,BWA-MEM,Mid,125,0.65,194386,258,194386,820,0,65462,26,232,0.9998662633993787,0.9944849179388532,0.9996043822276324,0.9971683304435256,0.9957730948296986,194386,26,65694,1078
,,SHRiMP,Mid,125,0.65,194890,187,194890,358,0,65462,74,184,0.9996204427484048,0.9972113490418809,0.998874010955569,0.9984144426599453,0.9976297601041527,194890,74,65646,545
,,BWA BWA ALN (anc),Mid,125,0.6,179517,1,179517,795,0,60360,19,218,0.9998941716424561,0.9955854541824494,0.9996864531247421,0.9977351611370324,0.9966169938981362,179517,19,60578,796
,,BWA ALN,Mid,125,0.6,179379,1,179379,933,0,60360,19,218,0.9998940902351197,0.9948201183497585,0.9996864531247421,0.9973506509392263,0.9960441658710721,179379,19,60578,934
,,Bowtie2,Mid,125,0.6,178473,47,178473,1793,0,60360,16,221,0.9999103586215397,0.9897955222307876,0.9997359605260987,0.9948272306174435,0.9922958781287617,178473,16,60581,1840
,,BWA-MEM,Mid,125,0.6,179337,232,179337,770,0,60360,23,214,0.9998717662801071,0.9944437975146807,0.9996204432562669,0.9971503951915353,0.9957457582096491,179337,23,60574,1002
,,SHRiMP,Mid,125,0.6,179811,168,179811,334,0,60360,64,173,0.9996441973592772,0.997215952260791,0.9989438421043946,0.998428598398614,0.997650574903491,179811,64,60533,502
,,BWA BWA ALN (anc),Mid,125,0.75,224282,1,224282,998,0,75413,27,282,0.9998796303313733,0.9955655381501325,0.9996434325559282,0.9977179207722592,0.9965913960990422,224282,27,75695,999
,,BWA ALN,Mid,125,0.75,224110,1,224110,1170,0,75413,25,284,0.9998884600798625,0.9948020472210262,0.9996698449591929,0.9973387685351656,0.9960266176749069,224110,25,75697,1171
,,Bowtie2,Mid,125,0.75,222992,66,222992,2223,0,75412,21,288,0.999905835085847,0.9898393561818352,0.9997226661031946,0.9948471315699071,0.9923256323878247,222992,21,75700,2289
,,BWA-MEM,Mid,125,0.75,224087,295,224087,934,0,75413,31,278,0.999861680007853,0.9945454384065047,0.9995906077493991,0.9971964737870299,0.9958144818926514,224087,31,75691,1229
,,SHRiMP,Mid,125,0.75,224655,214,224655,412,0,75413,89,220,0.9996039938774783,0.997221248130113,0.9988246480547265,0.9984111993778123,0.9976246083926074,224655,89,75633,626
,,BWA BWA ALN (anc),Mid,125,0.7,209507,1,209507,930,0,70489,25,259,0.9998806864822557,0.9955758940875697,0.9996467579444138,0.9977236469271615,0.9966004174801127,209507,25,70748,931
,,BWA ALN,Mid,125,0.7,209347,1,209347,1090,0,70489,24,260,0.9998853709444001,0.9948155751337686,0.9996608876266373,0.9973440302613809,0.9960350057430186,209347,24,70749,1091
,,Bowtie2,Mid,125,0.7,208297,61,208297,2080,0,70489,15,269,0.9999279926264449,0.9898259819994488,0.9997880547666483,0.9948513432835823,0.992333159086949,208297,15,70758,2141
,,BWA-MEM,Mid,125,0.7,209323,275,209323,872,0,70489,30,254,0.9998567013608594,0.9945502922031644,0.9995761095332966,0.9971964375462993,0.9958150069512841,209323,30,70743,1147
,,SHRiMP,Mid,125,0.7,209846,200,209846,392,0,70489,83,201,0.9996046282314497,0.9971868198709358,0.9988272363754539,0.9983942602535404,0.9975996671538453,209846,83,70690,592
,,BWA BWA ALN (anc),Mid,125,0.85,254178,2,254178,1122,0,85287,27,328,0.9998937865108869,0.9955973709567493,0.9996847341257794,0.9977409535099616,0.9966240790276409,254178,27,85615,1124
,,BWA ALN,Mid,125,0.85,253990,1,253990,1311,0,85287,25,330,0.999901580615318,0.9948609881630383,0.9997080871534995,0.9973749158186356,0.9960785348913604,253990,25,85617,1312
,,Bowtie2,Mid,125,0.85,252708,73,252708,2521,0,85287,18,337,0.9999287766197383,0.9898394842186901,0.9997898227505196,0.9948585511034824,0.9923389178281478,252708,18,85624,2594
,,BWA-MEM,Mid,125,0.85,253938,334,253938,1065,0,85287,33,322,0.999870063904934,0.9945209664090986,0.9996146750426192,0.9971883418285203,0.9958003278794295,253938,33,85609,1399
,,SHRiMP,Mid,125,0.85,254603,250,254603,449,0,85287,98,257,0.9996152351188256,0.9972620661021065,0.9988557016417179,0.9984372640945249,0.9976623727063682,254603,98,85544,699
,,BWA BWA ALN (anc),Mid,125,0.8,239087,1,239087,1067,0,80297,27,304,0.9998870831486236,0.9955528721034332,0.9996651287393957,0.9977152705474379,0.9965864774629578,239087,27,80601,1068
,,BWA ALN,Mid,125,0.8,238908,1,238908,1246,0,80297,25,306,0.9998953681576007,0.9948075201432408,0.999689934017959,0.997344955415289,0.9960347025871071,238908,25,80603,1247
,,Bowtie2,Mid,125,0.8,237697,68,237697,2390,0,80296,19,312,0.9999200726917835,0.9897649434740063,0.9997643469309289,0.994816592762482,0.9922782450386867,237697,19,80608,2458
,,BWA-MEM,Mid,125,0.8,238869,314,238869,1007,0,80297,31,300,0.9998702385935538,0.9945001873516799,0.9996155181822692,0.9971779832599303,0.9957857726187433,238869,31,80597,1321
,,SHRiMP,Mid,125,0.8,239489,230,239489,436,0,80297,92,239,0.9996159962601375,0.9972267910307926,0.9988589571860892,0.9984199643137058,0.9976370318876,239489,92,80536,666
,,BWA BWA ALN (anc),Mid,125,0.95,283942,2,283942,1237,0,95213,28,358,0.9999013980350037,0.9956553907869038,0.9997071099070074,0.9977738772311742,0.9966726193602605,283942,28,95571,1239
,,BWA ALN,Mid,125,0.95,283734,1,283734,1446,0,95213,26,360,0.9999083732731886,0.9949260294339385,0.9997280306279355,0.9974109793458372,0.9961316245601135,283734,26,95573,1447
,,Bowtie2,Mid,125,0.95,282288,74,282288,2819,0,95212,21,365,0.9999256134235891,0.989855565412843,0.9997803301324295,0.9948651077552028,0.992347267049916,282288,21,95577,2893
,,BWA-MEM,Mid,125,0.95,283645,357,283645,1220,0,95213,34,352,0.9998801462216096,0.9944709734873186,0.9996443477442233,0.9971682243483488,0.9957696660635836,283645,34,95565,1577
,,SHRiMP,Mid,125,0.95,284413,265,284413,503,0,95213,105,281,0.9996309548077802,0.9973069734659742,0.9989016621512777,0.9984676118441493,0.9977073375702505,284413,105,95494,768
,,BWA BWA ALN (anc),Mid,125,0.9,269002,2,269002,1176,0,90235,28,342,0.9998959223878378,0.9956399437412096,0.999690966282214,0.9977633945957974,0.9966572889671134,269002,28,90577,1178
,,BWA ALN,Mid,125,0.9,268803,1,268803,1376,0,90235,26,344,0.9999032842438874,0.9949033977348435,0.9997130401191987,0.9973970750024582,0.9961112573970647,268803,26,90579,1377
,,Bowtie2,Mid,125,0.9,267442,72,267442,2666,0,90234,21,349,0.9999214844670103,0.9898660152490932,0.9997682221535473,0.9948683420038948,0.992352765089361,267442,21,90583,2738
,,BWA-MEM,Mid,125,0.9,268730,343,268730,1146,0,90235,34,336,0.9998734949621229,0.9944896546874942,0.9996247447712598,0.9971743079095259,0.9957791056027315,268730,34,90571,1489
,,SHRiMP,Mid,125,0.9,269448,256,269448,476,0,90235,102,268,0.999621591541458,0.9972906950921607,0.9988742343137796,0.9984547829470292,0.9976883739623321,269448,102,90503,732
,,BWA BWA ALN (anc),None,125,0.15,44715,0,44715,187,0,14958,2,48,0.999955274280475,0.9958353748162665,0.9998667377398721,0.9978910722056705,0.9968452679018528,44715,2,15006,187
,,BWA ALN,None,125,0.15,44715,0,44715,187,0,14958,2,48,0.999955274280475,0.9958353748162665,0.9998667377398721,0.9978910722056705,0.9968452679018528,44715,2,15006,187
,,Bowtie2,None,125,0.15,44721,10,44721,171,0,14958,3,47,0.9999329219211162,0.9959689991537125,0.9998001066098081,0.997947024300984,0.9969287264229678,44721,3,15005,181
,,BWA-MEM,None,125,0.15,44795,56,44795,57,0,14958,3,47,0.9999330327246753,0.9974837445444019,0.9998001066098081,0.9987068869417877,0.9980639562053542,44795,3,15005,113
,,SHRiMP,None,125,0.15,44782,41,44782,79,0,14958,11,39,0.9997544259147635,0.9973275132510802,0.9992670575692963,0.9985394949551257,0.9978133867467869,44782,11,14997,120
,,BWA BWA ALN (anc),None,125,0.1,29807,0,29807,121,0,10014,2,31,0.9999329061692778,0.9959569633787757,0.9998009356026675,0.9979409746053534,0.9969230769230769,29807,2,10045,121
,,BWA ALN,None,125,0.1,29807,0,29807,121,0,10014,2,31,0.9999329061692778,0.9959569633787757,0.9998009356026675,0.9979409746053534,0.9969230769230769,29807,2,10045,121
,,Bowtie2,None,125,0.1,29811,7,29811,110,0,10013,2,31,0.9999329151712341,0.9960906174819567,0.9998009157873781,0.9980080681608946,0.9970230649922449,29811,2,10044,117
,,BWA-MEM,None,125,0.1,29855,32,29855,44,0,10014,2,31,0.9999330140335599,0.9974608265677726,0.9998009356026675,0.9986953903793404,0.9980489269098004,29855,2,10045,76
,,SHRiMP,None,125,0.1,29853,21,29853,54,0,10014,6,27,0.9997990555611374,0.9974939855653568,0.9994028068080024,0.9986451904260123,0.9979737335834897,29853,6,10041,75
,,BWA BWA ALN (anc),None,125,0.25,74571,1,74571,312,0,24988,3,94,0.9999597715021321,0.995820201912291,0.9998804066175006,0.9978856936396848,0.9968390200962298,74571,3,25082,313
,,BWA ALN,None,125,0.25,74571,0,74571,313,0,24988,3,94,0.9999597715021321,0.995820201912291,0.9998804066175006,0.9978856936396848,0.9968390200962298,74571,3,25082,313
,,Bowtie2,None,125,0.25,74583,27,74583,274,0,24988,2,95,0.9999731849567608,0.995980449762299,0.9999202710783337,0.9979728237962386,0.9969690604087267,74583,2,25083,301
,,BWA-MEM,None,125,0.25,74712,92,74712,90,0,24988,4,93,0.999946463943466,0.9975698987902902,0.9998405421566673,0.9987567675957489,0.9981396093179568,74712,4,25081,182
,,SHRiMP,None,125,0.25,74690,73,74690,121,0,24988,23,74,0.9996921553143362,0.9974093264248705,0.9990831174008371,0.9985494361517946,0.9978293270913984,74690,23,25062,194
,,BWA BWA ALN (anc),None,125,0.2,59650,0,59650,254,0,19912,2,73,0.9999664722054583,0.9957598824786325,0.9998999349577226,0.9978587440195389,0.996795634051395,59650,2,19985,254
,,BWA ALN,None,125,0.2,59650,0,59650,254,0,19912,2,73,0.9999664722054583,0.9957598824786325,0.9998999349577226,0.9978587440195389,0.996795634051395,59650,2,19985,254
,,Bowtie2,None,125,0.2,59657,18,59657,229,0,19912,3,72,0.9999497150519611,0.9958767361111112,0.9998499024365838,0.9979090696196179,0.9968707363783155,59657,3,19984,247
,,BWA-MEM,None,125,0.2,59762,77,59762,72,0,19912,3,72,0.9999498033966369,0.9975129775834154,0.9998499024365838,0.998729904074334,0.9980975744073693,59762,3,19984,149
,,SHRiMP,None,125,0.2,59740,59,59740,105,0,19912,18,57,0.999698785099903,0.9972622863247863,0.9990994146195027,0.9984790493222577,0.9977218960834137,59740,18,19969,164
,,BWA BWA ALN (anc),None,125,0.35,104346,1,104346,444,0,35012,8,128,0.9999233378691761,0.9957534521094369,0.9997723910322067,0.9978340385856703,0.9967628752527887,104346,8,35140,445
,,BWA ALN,None,125,0.35,104346,0,104346,445,0,35012,8,128,0.9999233378691761,0.9957534521094369,0.9997723910322067,0.9978340385856703,0.9967628752527887,104346,8,35140,445
,,Bowtie2,None,125,0.35,104363,32,104363,396,0,35011,8,128,0.9999233503559418,0.9959156797816606,0.9997723845562921,0.9979154913416395,0.9968843344909889,104363,8,35139,428
,,BWA-MEM,None,125,0.35,104554,127,104554,127,0,35012,9,127,0.999913927488691,0.997576520876269,0.9997439399112324,0.9987438565990515,0.9981208379776502,104554,9,35139,254
,,SHRiMP,None,125,0.35,104526,95,104526,170,0,35012,37,99,0.9996461463423965,0.997471156874159,0.9989473085239559,0.9985574672564174,0.9978419168351925,104526,37,35111,265
,,BWA BWA ALN (anc),None,125,0.3,89287,1,89287,372,0,29887,8,112,0.999910409317431,0.9958398393932635,0.9997333955410405,0.9978709731496745,0.9968161648574795,89287,8,29999,373
,,BWA ALN,None,125,0.3,89287,0,89287,373,0,29887,8,112,0.999910409317431,0.9958398393932635,0.9997333955410405,0.9978709731496745,0.9968161648574795,89287,8,29999,373
,,Bowtie2,None,125,0.3,89302,28,89302,330,0,29886,8,112,0.9999104243645728,0.9960071380771804,0.9997333866560021,0.9979549645191932,0.9969414871392042,89302,8,29998,358
,,BWA-MEM,None,125,0.3,89462,106,89462,108,0,29887,9,111,0.9998994087469683,0.9976136312948838,0.9997000699836704,0.9987552122000368,0.9981367445668976,89462,9,29998,214
,,SHRiMP,None,125,0.3,89432,79,89432,149,0,29887,33,87,0.9996311406695356,0.9974570600044613,0.9989002566067917,0.998542916957432,0.9978189475795332,89432,33,29974,228
,,BWA BWA ALN (anc),None,125,0.45,134574,1,134574,579,0,45257,14,162,0.9998959788391238,0.9957085990795685,0.999691853938767,0.9977978957670663,0.9967107266857526,134574,14,45419,580
,,BWA ALN,None,125,0.45,134574,0,134574,580,0,45257,13,163,0.9999034082043585,0.9957085990795685,0.9997138643717122,0.9978015948632206,0.9967162641829146,134574,13,45420,580
,,Bowtie2,None,125,0.45,134600,36,134600,518,0,45257,11,165,0.999918283052648,0.9959009722242775,0.9997578852376027,0.9979055844902045,0.9968713141034515,134600,11,45422,554
,,BWA-MEM,None,125,0.45,134846,165,134846,162,0,45257,16,160,0.9998813602052469,0.9975808778380297,0.9996478330728765,0.9987297942859258,0.9981008382888719,134846,16,45417,327
,,SHRiMP,None,125,0.45,134803,120,134803,231,0,45257,54,122,0.9995995758470083,0.9974029625464286,0.9988114366209583,0.9985000611086216,0.9977573136493768,134803,54,45379,351
,,BWA BWA ALN (anc),None,125,0.4,119269,1,119269,511,0,40044,10,144,0.9999161629456987,0.9957255324300182,0.9997512314045475,0.9978164477537019,0.996737071740666,119269,10,40188,512
,,BWA ALN,None,125,0.4,119269,0,119269,512,0,40044,10,144,0.9999161629456987,0.9957255324300182,0.9997512314045475,0.9978164477537019,0.996737071740666,119269,10,40188,512
,,Bowtie2,None,125,0.4,119291,32,119291,458,0,40044,10,144,0.9999161784058809,0.9959092009584157,0.9997512314045475,0.9979086673191624,0.99687458978991,119291,10,40188,490
,,BWA-MEM,None,125,0.4,119513,145,119513,142,0,40044,11,143,0.9999079682741542,0.9976043405676127,0.9997263545450022,0.9987548260934969,0.998137476718459,119513,11,40187,287
,,SHRiMP,None,125,0.4,119477,104,119477,200,0,40044,41,113,0.9996569554376746,0.9974620348803233,0.9989800487586447,0.9985582890024614,0.9978434669550379,119477,41,40157,304
,,BWA BWA ALN (anc),None,125,0.55,164491,2,164491,721,0,55340,19,199,0.9998845055011853,0.9956238575423391,0.9996580150473379,0.99774963302641,0.9966390665482942,164491,19,55539,723
,,BWA ALN,None,125,0.55,164491,1,164491,722,0,55340,18,200,0.9998905834939121,0.9956238575423391,0.9996760142553728,0.9977526590501725,0.9966435961082021,164491,18,55540,723
,,Bowtie2,None,125,0.55,164525,49,164525,640,0,55339,15,203,0.9999088367570196,0.9958296512402096,0.9997300070198175,0.9978650751772534,0.9968111753808244,164525,15,55542,689
,,BWA-MEM,None,125,0.55,164811,211,164811,217,0,55340,20,198,0.9998786636009003,0.9974098124534765,0.9996400158393031,0.9986427121519678,0.9979709869246411,164811,20,55538,428
,,SHRiMP,None,125,0.55,164754,153,164754,307,0,55340,63,155,0.9996177578769181,0.9972157323229266,0.9988660498938047,0.9984153003808732,0.9976310401681373,164754,63,55495,460
,,BWA BWA ALN (anc),None,125,0.5,149622,2,149622,647,0,50383,18,179,0.9998797113071372,0.995681136080814,0.999644128113879,0.9977760068820417,0.9966791303005711,149622,18,50562,649
,,BWA ALN,None,125,0.5,149622,1,149622,648,0,50383,17,180,0.9998863932530958,0.995681136080814,0.999663898774219,0.9977793338001401,0.9966841091157126,149622,17,50563,649
,,Bowtie2,None,125,0.5,149649,43,149649,579,0,50382,14,183,0.9999064565056159,0.9958608114672824,0.9997232052828249,0.9978795334973695,0.9968334578043316,149649,14,50565,622
,,BWA-MEM,None,125,0.5,149916,186,149916,189,0,50383,19,178,0.999873278420649,0.9975048406092181,0.999624357453539,0.9986876552996742,0.9980385421489414,149916,19,50561,375
,,SHRiMP,None,125,0.5,149861,136,149861,274,0,50383,60,137,0.9995997892223237,0.9972715959832569,0.9988137603795967,0.9984343353587037,0.9976599568834609,149861,60,50520,410
,,BWA BWA ALN (anc),None,125,0.65,194575,2,194575,863,0,65464,24,234,0.9998766694587331,0.9955740892345477,0.9996348254770092,0.9977207407464382,0.9965959825702054,194575,24,65698,865
,,BWA ALN,None,125,0.65,194575,1,194575,864,0,65464,22,236,0.9998869458419195,0.9955740892345477,0.9996652566872585,0.9977258567776903,0.9966036406521622,194575,22,65700,865
,,Bowtie2,None,125,0.65,194615,57,194615,768,0,65464,17,241,0.9999126556784085,0.9957787556283259,0.9997413347128815,0.9978414241473369,0.9967759474961901,194615,17,65705,825
,,BWA-MEM,None,125,0.65,194973,252,194973,248,0,65464,27,231,0.9998615384615385,0.9974421019782783,0.9995891786616353,0.9986503548260699,0.9979823503512701,194973,27,65695,500
,,SHRiMP,None,125,0.65,194896,182,194896,362,0,65464,79,179,0.9995948198486986,0.9972165370446173,0.9987979671951553,0.9984042621313219,0.997614507470459,194896,79,65643,544
,,BWA BWA ALN (anc),None,125,0.6,179527,2,179527,790,0,60360,21,216,0.9998830396328559,0.9956077839828305,0.9996534481905045,0.997740832029611,0.9966253798004283,179527,21,60576,792
,,BWA ALN,None,125,0.6,179527,1,179527,791,0,60360,20,217,0.9998886085537492,0.9956077839828305,0.9996699506576233,0.997743604563921,0.9966295306247821,179527,20,60577,792
,,Bowtie2,None,125,0.6,179564,52,179564,703,0,60360,17,220,0.9999053351969306,0.9958129758927234,0.9997194580589798,0.9978549597110308,0.9967955635989307,179564,17,60580,755
,,BWA-MEM,None,125,0.6,179880,235,179880,234,0,60360,23,214,0.9998721533270707,0.997399486551076,0.9996204432562669,0.9986342893308018,0.997958048691408,179880,23,60574,469
,,SHRiMP,None,125,0.6,179813,171,179813,335,0,60360,68,169,0.999621972303912,0.9971938619890306,0.9988778322359193,0.9984064408661856,0.9976174268209667,179813,68,60529,506
,,BWA BWA ALN (anc),None,125,0.75,224291,2,224291,991,0,75415,29,280,0.9998707203994294,0.9955922302515935,0.9996170302678147,0.9977268885508136,0.9966047414022219,224291,29,75695,993
,,BWA ALN,None,125,0.75,224291,1,224291,992,0,75415,26,283,0.9998840926010958,0.9955922302515935,0.9996566478263166,0.9977335459663123,0.9966147079147398,224291,26,75698,993
,,Bowtie2,None,125,0.75,224332,70,224332,882,0,75415,18,291,0.9999197682193002,0.9957742227588289,0.9997622946489885,0.9978426898321746,0.9967774942858662,224332,18,75706,952
,,BWA-MEM,None,125,0.75,224752,284,224752,282,0,75415,32,277,0.9998576411132465,0.9974879947452046,0.9995774127093128,0.9986714122576661,0.9980135662133522,224752,32,75692,566
,,SHRiMP,None,125,0.75,224663,210,224663,411,0,75415,96,213,0.9995728758358954,0.997243479341631,0.9987322381279383,0.9984068189039714,0.9976180035082124,224663,96,75628,621
,,BWA BWA ALN (anc),None,125,0.7,209505,2,209505,935,0,70491,27,257,0.9998711414008361,0.9955474667604376,0.99961850936065,0.9977046198097977,0.9965720422307328,209505,27,70748,937
,,BWA ALN,None,125,0.7,209505,1,209505,936,0,70491,25,259,0.9998806853433876,0.9955474667604376,0.9996467679265277,0.9977093711009306,0.9965791541763123,209505,25,70750,937
,,Bowtie2,None,125,0.7,209547,63,209547,832,0,70491,17,267,0.9999188791968087,0.9957470466922003,0.9997598021900389,0.9978286024485366,0.996756952815797,209547,17,70758,895
,,BWA-MEM,None,125,0.7,209943,268,209943,265,0,70491,31,253,0.9998523626734739,0.9974676447670994,0.9995619922288944,0.9986585800927578,0.9979946737967154,209943,31,70744,533
,,SHRiMP,None,125,0.7,209853,196,209853,393,0,70491,89,195,0.9995760733916986,0.9972011290521854,0.9987424938184387,0.9983871888559032,0.9975890504485859,209853,89,70686,589
,,BWA BWA ALN (anc),None,125,0.85,254175,2,254175,1129,0,85291,29,326,0.9998859183962486,0.9955700218561256,0.9996613969128739,0.9977233027811033,0.9965977615617447,254175,29,85617,1131
,,BWA ALN,None,125,0.85,254175,1,254175,1130,0,85291,26,329,0.9998977187343874,0.9955700218561256,0.9996964248184387,0.9977291774205261,0.9966065604542574,254175,26,85620,1131
,,Bowtie2,None,125,0.85,254218,79,254218,1009,0,85291,20,335,0.9999213335535994,0.9957384471966974,0.9997664806295682,0.997825506727584,0.9967502756986321,254218,20,85626,1088
,,BWA-MEM,None,125,0.85,254692,329,254692,322,0,85291,34,321,0.9998665232445844,0.9974504881668971,0.999603017070266,0.9986570444390858,0.9979911375440264,254692,34,85612,651
,,SHRiMP,None,125,0.85,254599,244,254599,463,0,85291,107,248,0.999579907815285,0.9972307740515303,0.99875067136819,0.9984039591225303,0.9976125671648796,254599,107,85539,707
,,BWA BWA ALN (anc),None,125,0.8,239095,2,239095,1063,0,80299,29,302,0.9998787240093007,0.9955654563624251,0.999640332382488,0.9977174284975088,0.9965896692540291,239095,29,80601,1065
,,BWA ALN,None,125,0.8,239095,1,239095,1064,0,80299,26,305,0.9998912684373183,0.9955654563624251,0.999677539377403,0.9977236735860592,0.9965990211664952,239095,26,80604,1065
,,Bowtie2,None,125,0.8,239137,76,239137,947,0,80299,20,311,0.9999163729265712,0.9957403397734843,0.999751953367233,0.9978239870482373,0.9967486517659528,239137,20,80610,1023
,,BWA-MEM,None,125,0.8,239583,308,239583,304,0,80299,32,299,0.9998664524341131,0.9974520701929682,0.9996031253875729,0.9986578020466435,0.997992675134419,239583,32,80598,612
,,SHRiMP,None,125,0.8,239495,230,239495,435,0,80299,100,231,0.9995826290198042,0.9972310126582279,0.9987597668361652,0.9984054361080135,0.9976152623211447,239495,100,80530,665
,,BWA BWA ALN (anc),None,125,0.95,283943,2,283943,1246,0,95218,30,356,0.999894356153578,0.9956239853291303,0.9996862055980922,0.9977546014856877,0.9966438634961068,283943,30,95574,1248
,,BWA ALN,None,125,0.95,283943,1,283943,1247,0,95218,27,359,0.9999049195337536,0.9956239853291303,0.9997175850382829,0.9977598605666937,0.9966517417508108,283943,27,95577,1248
,,Bowtie2,None,125,0.95,283990,84,283990,1117,0,95218,21,365,0.9999260592019323,0.9957887871636903,0.9997803439186644,0.9978531347395125,0.996790924250581,283990,21,95583,1201
,,BWA-MEM,None,125,0.95,284514,362,284514,355,0,95218,35,351,0.9998769983377204,0.9974862479884725,0.9996339065311075,0.998680192354944,0.9980253915737787,284514,35,95569,717
,,SHRiMP,None,125,0.95,284415,268,284415,508,0,95218,114,272,0.9995993378530835,0.9972790165187541,0.99880758127275,0.998437829109036,0.9976627844378209,284415,114,95490,776
,,BWA BWA ALN (anc),None,125,0.9,268998,2,268998,1186,0,90238,30,340,0.9998884874436862,0.9956030290244499,0.9996689034080876,0.9977411565723442,0.9966241123743743,268998,30,90578,1188
,,BWA ALN,None,125,0.9,268998,1,268998,1187,0,90238,27,343,0.9998996375801505,0.9956030290244499,0.9997020130672788,0.9977467076895686,0.9966324273685261,268998,27,90581,1188
,,Bowtie2,None,125,0.9,269043,81,269043,1062,0,90238,22,348,0.9999182353706354,0.9957695809553418,0.9997571958325976,0.9978395960322745,0.9967710106043892,269043,22,90586,1143
,,BWA-MEM,None,125,0.9,269541,346,269541,338,0,90238,35,335,0.9998701664836632,0.9974687760199833,0.9996137206427689,0.9986680276620458,0.9980073884594812,269541,35,90573,684
,,SHRiMP,None,125,0.9,269448,257,269448,481,0,90238,111,259,0.9995882163088601,0.9972685483333703,0.998774942609924,0.9984270349887446,0.9976468566550442,269448,111,90497,738
,,BWA BWA ALN (anc),Single-stranded,125,0.15,44716,0,44716,184,0,14958,2,48,0.9999552752806476,0.995902004454343,0.9998667377398721,0.9979245240911424,0.9968952393670294,44716,2,15006,184
,,BWA ALN,Single-stranded,125,0.15,44715,0,44715,185,0,14958,2,48,0.999955274280475,0.995879732739421,0.9998667377398721,0.9979133423346017,0.9968785471055619,44715,2,15006,185
,,Bowtie2,Single-stranded,125,0.15,44714,15,44714,171,0,14958,3,47,0.9999329114207125,0.9958574610244989,0.9998001066098081,0.9978910251403192,0.9968451625826267,44714,3,15005,186
,,BWA-MEM,Single-stranded,125,0.15,44786,54,44786,66,0,14958,3,47,0.9999330192681238,0.9973277513027212,0.9998001066098081,0.9986286861029042,0.9979470574490102,44786,3,15005,120
,,SHRiMP,Single-stranded,125,0.15,44785,40,44785,75,0,14958,11,39,0.999754442360925,0.9974387527839643,0.9992670575692963,0.9985952550838387,0.9978967750550845,44785,11,14997,115
,,BWA BWA ALN (anc),Single-stranded,125,0.1,29807,0,29807,119,0,10014,2,31,0.9999329061692778,0.9960235246942458,0.9998009356026675,0.9979743868753662,0.9969729567458034,29807,2,10045,119
,,BWA ALN,Single-stranded,125,0.1,29806,0,29806,120,0,10014,2,31,0.9999329039184112,0.9959901089353739,0.9998009356026675,0.9979576120802223,0.9969479398594051,29806,2,10045,120
,,Bowtie2,Single-stranded,125,0.1,29807,7,29807,112,0,10013,2,31,0.9999329061692778,0.9960235246942458,0.9998009157873781,0.9979743868753662,0.9969728810167117,29807,2,10044,119
,,BWA-MEM,Single-stranded,125,0.1,29851,31,29851,47,0,10014,2,31,0.9999330050581181,0.9973938320692305,0.9998009356026675,0.9986618045565555,0.9979987992795677,29851,2,10045,78
,,SHRiMP,Single-stranded,125,0.1,29856,26,29856,44,0,10014,6,27,0.9997990757484428,0.9976608968789681,0.9994028068080024,0.9987288419080752,0.9980987166337277,29856,6,10041,70
,,BWA BWA ALN (anc),Single-stranded,125,0.25,74564,1,74564,317,0,24987,3,94,0.9999597677256695,0.9957533185545258,0.9998804018497848,0.9978521100843766,0.9967889082287978,74564,3,25081,318
,,BWA ALN,Single-stranded,125,0.25,74563,0,74563,319,0,24987,3,94,0.999959767186117,0.9957399642103576,0.9998804018497848,0.9978454044216049,0.9967789048276414,74563,3,25081,319
,,Bowtie2,Single-stranded,125,0.25,74557,27,74557,298,0,24986,2,95,0.999973175605896,0.9956598381453486,0.9999202647211258,0.9978118454774794,0.9967288550992848,74557,2,25081,325
,,BWA-MEM,Single-stranded,125,0.25,74675,96,74675,118,0,24987,4,93,0.9999464374188192,0.9971424374741283,0.999840535799713,0.9985424689773214,0.9978194112410351,74675,4,25080,214
,,SHRiMP,Single-stranded,125,0.25,74677,73,74677,132,0,24987,23,74,0.9996921017402945,0.9972623594455277,0.9990830808483495,0.9984757524301053,0.9977192245363423,74677,23,25061,205
,,BWA BWA ALN (anc),Single-stranded,125,0.2,59648,0,59648,254,0,19911,2,73,0.9999664710813077,0.9957597409101533,0.9998999299509657,0.9978586723768738,0.9967955137192069,59648,2,19984,254
,,BWA ALN,Single-stranded,125,0.2,59647,0,59647,255,0,19911,2,73,0.9999664705192041,0.9957430469767287,0.9998999299509657,0.997850289834464,0.9967829961946726,59647,2,19984,255
,,Bowtie2,Single-stranded,125,0.2,59646,20,59646,236,0,19910,3,72,0.999949705778806,0.995726353043304,0.9998498874155617,0.9978335605724753,0.996757920562795,59646,3,19982,256
,,BWA-MEM,Single-stranded,125,0.2,59743,75,59743,91,0,19911,3,72,0.9999497874334683,0.9972291308484534,0.9998498949264485,0.9985876060340144,0.997884723699856,59743,3,19983,166
,,SHRiMP,Single-stranded,125,0.2,59740,55,59740,107,0,19911,18,57,0.999698785099903,0.9972955827852159,0.999099369558691,0.9984957379241184,0.9977468455838173,59740,18,19968,162
,,BWA BWA ALN (anc),Single-stranded,125,0.35,104342,1,104342,446,0,35010,8,128,0.9999233349305223,0.9957342850871752,0.9997723780800091,0.9978244134283897,0.9967484903705291,104342,8,35138,447
,,BWA ALN,Single-stranded,125,0.35,104340,0,104340,449,0,35010,8,128,0.999923333461111,0.9957151991144109,0.9997723780800091,0.9978148295136681,0.9967341980205096,104340,8,35138,449
,,Bowtie2,Single-stranded,125,0.35,104332,33,104332,424,0,35009,7,129,0.9999329109920547,0.9956388552233536,0.9998008251529378,0.9977812631498412,0.9966841510998042,104332,7,35138,457
,,BWA-MEM,Single-stranded,125,0.35,104516,128,104516,153,0,35010,9,127,0.999913896197082,0.9973186255331736,0.9997439253400102,0.998614574674425,0.9979277277177137,104516,9,35137,281
,,SHRiMP,Single-stranded,125,0.35,104504,95,104504,190,0,35010,37,99,0.999646071876106,0.9972802488810848,0.9989472486200421,0.9984617589452062,0.997698931646836,104504,37,35109,285
,,BWA BWA ALN (anc),Single-stranded,125,0.3,89274,1,89274,383,0,29885,8,112,0.9999103962724849,0.9957170581543198,0.9997333777703716,0.9978093215602994,0.9967241336085507,89274,8,29997,384
,,BWA ALN,Single-stranded,125,0.3,89273,0,89273,385,0,29885,8,112,0.9999103952688702,0.9957059046599299,0.9997333777703716,0.997803720821062,0.9967157768065317,89273,8,29997,385
,,Bowtie2,Single-stranded,125,0.3,89259,29,89259,370,0,29884,7,113,0.9999215826854569,0.9955497557384728,0.9997666977736301,0.9977308801502314,0.9966071100265749,89259,7,29997,399
,,BWA-MEM,Single-stranded,125,0.3,89420,108,89420,137,0,29885,9,111,0.9998993615046573,0.9972676072045948,0.9997000499916681,0.9985817503657297,0.9978774964485669,89420,9,29996,245
,,SHRiMP,Single-stranded,125,0.3,89410,83,89410,165,0,29885,33,87,0.9996310499424215,0.9972339333913315,0.9989001833027829,0.9984310528696098,0.9976517386326601,89410,33,29972,248
,,BWA BWA ALN (anc),Single-stranded,125,0.45,134547,1,134547,604,0,45255,14,162,0.9998959579670187,0.9955235586598793,0.9996918403733134,0.9977049678732579,0.996572213331266,134547,14,45417,605
,,BWA ALN,Single-stranded,125,0.45,134545,0,134545,607,0,45255,13,163,0.9999033873868518,0.9955087605066888,0.9997138517752195,0.9977012346594492,0.9965666757114457,134545,13,45418,607
,,Bowtie2,Single-stranded,125,0.45,134532,45,134532,575,0,45255,10,166,0.9999256737672995,0.9954125725109506,0.9997798859809381,0.9976640192217847,0.9965112995132432,134532,10,45421,620
,,BWA-MEM,Single-stranded,125,0.45,134793,175,134793,198,0,45255,16,160,0.9998813135621509,0.9972404302857227,0.999647817569501,0.9985591258449857,0.9978460328798374,134793,16,45415,373
,,SHRiMP,Single-stranded,125,0.45,134773,127,134773,252,0,45255,54,122,0.9995994867496867,0.9971957499704037,0.9988113842970658,0.9983961715540839,0.9976022106178323,134773,54,45377,379
,,BWA BWA ALN (anc),Single-stranded,125,0.4,119253,1,119253,525,0,40042,10,144,0.9999161516983474,0.9956085791332371,0.9997512190267688,0.9977577162172337,0.9966494764807001,119253,10,40186,526
,,BWA ALN,Single-stranded,125,0.4,119251,0,119251,528,0,40042,10,144,0.9999161502922163,0.9955918817154927,0.9997512190267688,0.9977493306559572,0.9966369745272698,119251,10,40186,528
,,Bowtie2,Single-stranded,125,0.4,119240,40,119240,499,0,40042,9,145,0.9999245276689951,0.9955000459178988,0.999776097124092,0.9977073815619927,0.9965744647601188,119240,9,40187,539
,,BWA-MEM,Single-stranded,125,0.4,119467,152,119467,170,0,40042,11,143,0.9999079328411925,0.9973119401614505,0.9997263409294457,0.998608249361592,0.9979185548645185,119467,11,40185,322
,,SHRiMP,Single-stranded,125,0.4,119449,113,119449,217,0,40042,41,113,0.9996568750523056,0.997244926072183,0.9989799980097522,0.9984494439313074,0.9976808876386936,119449,41,40155,330
,,BWA BWA ALN (anc),Single-stranded,125,0.55,164478,1,164478,733,0,55339,19,199,0.9998844963737941,0.9955572234462388,0.9996580088917688,0.997716167893506,0.9965891950409704,164478,19,55538,734
,,BWA ALN,Single-stranded,125,0.55,164475,0,164475,737,0,55339,18,200,0.9998905728511244,0.9955390649589618,0.999676008423781,0.9977100741572011,0.9965801357980514,164475,18,55539,737
,,Bowtie2,Single-stranded,125,0.55,164454,55,164454,703,0,55339,14,204,0.9999148770581511,0.9954119555480232,0.9997480065518296,0.9976583353554963,0.9965031322332393,164454,14,55543,758
,,BWA-MEM,Single-stranded,125,0.55,164777,213,164777,238,0,55339,20,198,0.9998786385674496,0.9972704384244802,0.9996400093597566,0.9985728353912583,0.9978667029010123,164777,20,55537,451
,,SHRiMP,Single-stranded,125,0.55,164751,158,164751,303,0,55339,64,154,0.9996116858295665,0.9972096457884415,0.9988480299512212,0.9984092210637312,0.9976219487337443,164751,64,55493,461
,,BWA BWA ALN (anc),Single-stranded,125,0.5,149586,1,149586,682,0,50381,18,179,0.9998796823614342,0.9954548176936028,0.9996441140416782,0.9976623437255103,0.9965097810771383,149586,18,50560,683
,,BWA ALN,Single-stranded,125,0.5,149583,0,149583,686,0,50381,17,180,0.9998863636363636,0.9954348534960638,0.9996638854838071,0.9976556429640944,0.9964998232485425,149583,17,50561,686
,,Bowtie2,Single-stranded,125,0.5,149568,51,149568,650,0,50380,13,184,0.9999130905663153,0.9953350325083683,0.9997429661703937,0.9976188094047024,0.9964450374914113,149568,13,50564,701
,,BWA-MEM,Single-stranded,125,0.5,149865,199,149865,221,0,50381,19,178,0.9998732353019668,0.9972053099111687,0.9996243425995492,0.9985374905469918,0.9978144307313941,149865,19,50559,420
,,SHRiMP,Single-stranded,125,0.5,149837,147,149837,285,0,50381,61,136,0.9995930566118294,0.9971251555543725,0.9987939420301317,0.9983575809466064,0.9975453952511115,149837,61,50517,432
,,BWA BWA ALN (anc),Single-stranded,125,0.65,194576,1,194576,861,0,65463,24,234,0.9998766700924975,0.9955893940789406,0.9996348199205733,0.9977284264610115,0.9966074307222803,194576,24,65697,862
,,BWA ALN,Single-stranded,125,0.65,194573,0,194573,865,0,65463,22,236,0.9998869446799764,0.9955740439423244,0.9996652515938589,0.9977258334551178,0.9966036016373168,194573,22,65699,865
,,Bowtie2,Single-stranded,125,0.65,194547,59,194547,832,0,65462,17,241,0.999912625151621,0.9954410094249839,0.9997413268411443,0.9976718068112471,0.9965231775400333,194547,17,65703,891
,,BWA-MEM,Single-stranded,125,0.65,194931,248,194931,283,0,65463,27,231,0.9998615086326286,0.9972833594253615,0.999589172410645,0.9985707699400646,0.9978635669243404,194931,27,65694,531
,,SHRiMP,Single-stranded,125,0.65,194895,185,194895,358,0,65463,80,178,0.9995896909860239,0.9972216252724649,0.9987827330685778,0.9984042539567074,0.9976144800676983,194895,80,65641,543
,,BWA BWA ALN (anc),Single-stranded,125,0.6,179526,1,179526,790,0,60359,21,216,0.9998830389814366,0.9956132810550309,0.9996534424714503,0.9977435920236534,0.9966294886535804,179526,21,60575,791
,,BWA ALN,Single-stranded,125,0.6,179523,0,179523,794,0,60359,20,217,0.999888606072083,0.995596643688615,0.999669945210905,0.99773800922581,0.9966211869014956,179523,20,60576,794
,,Bowtie2,Single-stranded,125,0.6,179495,56,179495,766,0,60358,17,220,0.9999052988101074,0.9954413616020674,0.9997194487994059,0.997668336904474,0.9965174005445971,179495,17,60578,822
,,BWA-MEM,Single-stranded,125,0.6,179849,228,179849,261,0,60359,23,214,0.9998721312933642,0.9972884250684825,0.9996204369925408,0.9985786069237389,0.9978749367046577,179849,23,60573,489
,,SHRiMP,Single-stranded,125,0.6,179821,167,179821,329,0,60359,69,168,0.9996164322641614,0.9972492887525857,0.9988613109776223,0.9984314574675117,0.9976547550360504,179821,69,60527,496
,,BWA BWA ALN (anc),Single-stranded,125,0.75,224301,1,224301,981,0,75414,29,280,0.9998707261623501,0.995641038160891,0.9996170252103059,0.997751399536935,0.9966412629648579,224301,29,75694,982
,,BWA ALN,Single-stranded,125,0.75,224298,0,224298,985,0,75414,26,283,0.9998840962179705,0.9956277215768611,0.9996566432919984,0.997751369529389,0.9966412629648579,224298,26,75697,985
,,Bowtie2,Single-stranded,125,0.75,224262,66,224262,955,0,75414,21,288,0.999906368293629,0.9954679225685027,0.9997226734281526,0.9976822090638526,0.9965382749845518,224262,21,75702,1021
,,BWA-MEM,Single-stranded,125,0.75,224708,275,224708,325,0,75414,32,277,0.9998576132419685,0.9973369787135832,0.9995774071286135,0.9985957053469853,0.9979005484484986,224708,32,75691,600
,,SHRiMP,Single-stranded,125,0.75,224670,208,224670,405,0,75414,97,212,0.9995684419865906,0.9972789779965643,0.9987190153586096,0.9984223975113877,0.9976412430317003,224670,97,75626,613
,,BWA BWA ALN (anc),Single-stranded,125,0.7,209511,1,209511,929,0,70490,27,257,0.9998711450906279,0.9955807090823556,0.9996185039703847,0.9977213146371605,0.9965969098376687,209511,27,70747,930
,,BWA ALN,Single-stranded,125,0.7,209508,0,209508,933,0,70490,25,259,0.9998806870516816,0.9955664533052019,0.9996467629355413,0.9977189064084919,0.9965933538395889,209508,25,70749,933
,,Bowtie2,Single-stranded,125,0.7,209481,65,209481,895,0,70490,22,262,0.9998949895705551,0.9954381513108187,0.9996891513832763,0.9976615929743013,0.9965080098856747,209481,22,70752,960
,,BWA-MEM,Single-stranded,125,0.7,209902,264,209902,300,0,70490,31,253,0.9998523338398442,0.9973202322465387,0.9995619860400712,0.9985846778893385,0.9978843692220167,209902,31,70743,564
,,SHRiMP,Single-stranded,125,0.7,209855,199,209855,387,0,70490,90,194,0.9995713162971255,0.9972153715293123,0.9987283465679487,0.9983919540612676,0.9975961452980815,209855,90,70684,586
,,BWA BWA ALN (anc),Single-stranded,125,0.85,254197,2,254197,1106,0,85292,29,326,0.9998859282685485,0.9956600928301443,0.9996614008663467,0.9977685361636486,0.9966652197376756,254197,29,85618,1108
,,BWA ALN,Single-stranded,125,0.85,254193,1,254193,1111,0,85292,26,329,0.9998977259764219,0.9956444252952351,0.9996964283629316,0.9977665428910121,0.9966622867735048,254193,26,85621,1112
,,Bowtie2,Single-stranded,125,0.85,254143,78,254143,1084,0,85292,20,335,0.9999213103402147,0.9954485811088698,0.9997664833561012,0.9976799327926386,0.9965332363499847,254143,20,85627,1162
,,BWA-MEM,Single-stranded,125,0.85,254638,312,254638,385,0,85292,34,321,0.9998664949425143,0.9972702528051384,0.9996030217053721,0.9985666863395992,0.9978561918224422,254638,34,85613,697
,,SHRiMP,Single-stranded,125,0.85,254608,235,254608,462,0,85292,108,247,0.9995759983668085,0.9972699320420674,0.9987390101229465,0.9984216336190079,0.9976389638424177,254608,108,85539,697
,,BWA BWA ALN (anc),Single-stranded,125,0.8,239109,2,239109,1048,0,80300,29,302,0.999878731109234,0.9956278965185564,0.9996403368431497,0.9977487862431853,0.9966364288163596,239109,29,80602,1050
,,BWA ALN,Single-stranded,125,0.8,239105,1,239105,1053,0,80300,26,305,0.9998912729842638,0.9956112408862462,0.999677543376617,0.9977466669448559,0.9966333115122042,239105,26,80605,1054
,,Bowtie2,Single-stranded,125,0.8,239065,71,239065,1023,0,80300,19,312,0.9999205300229208,0.9954446845631436,0.9997643586213739,0.997677587361735,0.9965304404750771,239065,19,80612,1094
,,BWA-MEM,Single-stranded,125,0.8,239536,292,239536,359,0,80300,32,299,0.9998664262338877,0.9972896118441048,0.9996031303096824,0.9985763566820565,0.9978710670847646,239536,32,80599,651
,,SHRiMP,Single-stranded,125,0.8,239499,221,239499,439,0,80300,101,230,0.9995784641068447,0.9972518206688069,0.998747380039935,0.9984137869221839,0.9976277315377662,239499,101,80530,660
,,BWA BWA ALN (anc),Single-stranded,125,0.95,283953,2,283953,1235,0,95219,30,356,0.9998943598736544,0.9956625407622988,0.9996862088802887,0.9977739632765434,0.9966727504300213,283953,30,95575,1237
,,BWA ALN,Single-stranded,125,0.95,283948,1,283948,1241,0,95219,27,359,0.9999049212078528,0.9956450085907641,0.9997175879922598,0.9977704180685742,0.9966674982602187,283948,27,95578,1242
,,Bowtie2,Single-stranded,125,0.95,283885,83,283885,1222,0,95219,21,365,0.9999260318556141,0.995424103229426,0.999780346216202,0.997669988894668,0.9965178114208433,283885,21,95584,1305
,,BWA-MEM,Single-stranded,125,0.95,284444,351,284444,431,0,95219,35,351,0.999876968071457,0.9972583144594112,0.9996339103603368,0.9985659244696817,0.9978546914510636,284444,35,95570,782
,,SHRiMP,Single-stranded,125,0.95,284411,262,284411,517,0,95219,115,271,0.9995958190112678,0.9972684876748834,0.9987971340411066,0.9984307970989054,0.9976522800982156,284411,115,95490,779
,,BWA BWA ALN (anc),Single-stranded,125,0.9,269013,2,269013,1170,0,90239,30,340,0.9998884936608646,0.9956622314340174,0.9996689070622123,0.9977708872684653,0.9966684590098505,269013,30,90579,1172
,,BWA ALN,Single-stranded,125,0.9,269008,1,269008,1176,0,90239,27,343,0.9998996413106102,0.9956437255954254,0.9997020163559911,0.9977671451355663,0.996662915680416,269008,27,90582,1177
,,Bowtie2,Single-stranded,125,0.9,268954,80,268954,1151,0,90239,20,350,0.9999256433707348,0.9954438625386309,0.9997792713748083,0.997679719711625,0.9965326474387046,268954,20,90589,1231
,,BWA-MEM,Single-stranded,125,0.9,269478,333,269478,407,0,90239,35,335,0.9998701361344351,0.9972614703683692,0.9996137249059144,0.9985640995236515,0.9978521562965077,269478,35,90574,740
,,SHRiMP,Single-stranded,125,0.9,269445,251,269445,489,0,90239,112,258,0.9995845034630895,0.9972611358883727,0.9987639196989262,0.9984214680347278,0.9976385416608924,269445,112,90497,740
